radio,1 Con personas presentes,2 Con todas las personas temporalmente ausentes,3 En alquiler o venta,4 En construcción,"5 Se usa como comercio, oficina o consultorio","6 Se usa para vacaciones, fin de semana u otro uso temporal",7 Por otra razón,TOTAL
020010101,38,10,4,0,1,1,0,54
020010201,134,5,0,0,0,0,9,148
020010202,114,6,0,0,0,0,0,120
020010203,98,5,0,0,0,0,1,104
020010204,110,3,0,0,0,0,6,119
020010205,81,1,0,0,0,0,0,82
020010206,174,4,0,0,0,0,2,180
020010207,67,7,0,0,0,0,3,77
020010208,132,3,0,0,0,0,0,135
020010209,97,0,0,1,0,0,1,99
020010210,56,3,0,0,0,0,0,59
020010211,169,1,0,0,0,0,1,171
020010212,320,10,2,1,0,0,8,341
020010213,119,1,0,0,0,0,2,122
020010214,165,2,0,0,0,0,0,167
020010215,144,6,0,0,0,0,4,154
020010216,363,8,0,0,0,0,5,376
020010217,150,4,0,0,0,0,8,162
020010218,122,0,2,2,0,0,0,126
020010219,93,2,0,0,0,0,4,99
020010301,158,6,0,4,0,0,0,168
020010302,145,6,0,0,0,0,3,154
020010303,162,2,1,0,0,0,9,174
020010304,118,5,1,0,0,0,5,129
020010305,206,20,0,0,0,0,4,230
020010306,245,3,0,0,0,0,3,251
020010307,106,2,0,0,0,0,0,108
020010308,233,42,2,0,0,0,8,285
020010309,339,7,12,3,5,0,6,372
020010310,228,4,10,8,1,0,10,261
020010311,204,11,0,1,0,0,6,222
020010312,159,6,0,0,0,0,4,169
020010313,91,0,0,0,0,0,0,91
020010314,130,1,0,0,0,0,1,132
020010315,244,16,2,0,0,0,1,263
020010316,198,0,0,2,0,0,2,202
020010317,164,11,0,0,0,0,4,179
020010318,172,2,0,0,0,0,1,175
020010319,297,6,1,1,0,0,6,311
020010320,104,1,0,3,0,0,1,109
020010321,97,5,2,1,1,0,2,108
020010322,188,3,1,0,0,0,5,197
020010323,260,15,1,3,0,0,1,280
020010401,588,255,62,5,76,88,170,1244
020010402,513,205,93,3,55,18,51,938
020010403,316,83,49,7,27,11,48,541
020010404,436,126,40,1,6,2,48,659
020010405,293,98,10,2,18,3,59,483
020010406,363,95,27,5,1,10,15,516
020010407,419,85,50,3,32,4,77,670
020010408,337,81,11,1,28,8,33,499
020010501,236,58,12,0,15,14,27,362
020010502,239,42,12,1,57,6,73,430
020010503,385,131,46,2,16,10,50,640
020010504,483,94,29,0,16,14,61,697
020010505,237,77,15,0,30,13,15,387
020010506,353,122,55,1,53,34,20,638
020010507,270,60,25,4,13,6,185,563
020010601,324,101,17,5,35,6,21,509
020010602,210,66,84,1,44,5,13,423
020010603,408,105,25,8,37,37,64,684
020010604,392,104,86,0,65,13,44,704
020010605,167,36,23,4,87,2,11,330
020010606,235,72,31,1,41,1,13,394
020010607,224,29,31,1,17,32,53,387
020010608,292,66,47,0,69,2,29,505
020010609,410,60,41,2,38,32,19,602
020010610,182,60,41,0,49,4,16,352
020010701,260,81,37,3,179,16,42,618
020010702,110,31,44,0,63,4,23,275
020010703,124,81,14,0,50,10,14,293
020010704,268,94,47,1,126,28,30,594
020010705,147,78,41,1,125,16,47,455
020010706,80,18,25,1,260,6,6,396
020010707,243,121,29,1,118,35,92,639
020010708,236,104,32,2,67,10,16,467
020010709,183,56,30,3,207,10,81,570
020010710,229,64,56,0,392,5,106,852
020010711,135,42,18,3,118,10,36,362
020010712,173,45,54,2,96,14,16,400
020010713,64,34,21,2,126,0,2,249
020010801,187,80,13,1,59,10,13,363
020010802,562,177,41,2,59,25,41,907
020010803,438,121,44,3,84,7,111,808
020010804,292,96,54,1,159,41,58,701
020010805,214,95,38,0,75,14,20,456
020010806,564,252,39,2,96,9,60,1022
020010807,546,136,33,0,138,16,83,952
020010808,188,37,16,1,60,4,39,345
020010809,257,56,21,2,83,19,39,477
020010810,181,51,19,2,118,4,17,392
020010901,161,29,27,0,181,6,6,410
020010902,189,66,15,3,331,4,134,742
020010903,189,63,7,2,329,4,118,712
020010904,133,41,8,2,333,7,43,567
020010905,187,49,19,1,85,7,107,455
020010906,173,85,23,1,218,3,53,556
020010907,280,169,89,1,218,13,94,864
020010908,145,87,33,0,89,7,44,405
020010909,224,111,47,0,419,4,42,847
020010910,106,18,13,1,158,4,59,359
020010911,116,49,26,5,175,4,5,380
020010912,74,45,12,0,90,0,13,234
020010913,191,90,30,1,46,0,89,447
020010914,121,73,17,0,186,9,29,435
020010915,100,20,5,0,454,13,15,607
020010916,276,70,49,3,199,2,33,632
020010917,206,119,20,1,135,4,31,516
020010918,161,67,46,2,298,15,135,724
020010919,58,7,7,0,282,1,49,404
020011001,118,40,4,0,336,5,20,523
020011002,273,44,7,1,211,8,24,568
020011003,506,128,33,0,115,11,45,838
020011004,222,67,13,1,53,10,56,422
020011005,233,43,16,3,144,2,14,455
020011006,265,1,38,0,260,12,29,605
020011007,126,30,15,4,256,1,10,442
020011008,152,48,38,3,392,1,81,715
020011009,160,36,9,0,444,6,4,659
020011010,287,131,43,5,113,2,36,617
020011011,345,129,37,6,169,4,35,725
020011012,275,57,46,11,198,1,17,605
020011013,334,76,33,1,312,8,26,790
020011014,110,10,1,0,273,0,142,536
020011101,202,79,6,0,23,1,68,379
020011102,258,112,48,1,154,9,73,655
020011103,195,10,9,1,89,5,9,318
020011104,306,54,49,3,519,25,25,981
020011105,210,35,10,0,205,4,16,480
020011106,206,86,35,2,151,13,27,520
020011107,282,63,18,5,72,11,46,497
020011108,348,79,20,0,114,3,44,608
020011109,193,71,48,0,73,12,34,431
020011110,267,93,12,0,51,0,26,449
020011111,115,11,11,0,37,0,6,180
020011112,375,52,15,2,78,0,11,533
020011113,284,65,31,0,31,2,19,432
020011114,286,86,25,1,69,12,24,503
020011201,114,61,10,2,157,4,13,361
020011202,129,61,11,1,226,0,17,445
020011203,310,99,13,1,263,2,50,738
020011204,166,27,10,0,111,0,25,339
020011205,257,13,12,0,188,5,29,504
020011206,184,56,73,5,155,1,28,502
020011207,342,87,32,0,57,4,20,542
020011208,129,1,45,1,72,9,12,269
020011209,327,79,25,1,374,49,21,876
020011210,97,26,4,1,458,22,18,626
020011211,132,50,32,0,144,3,8,369
020011212,89,24,16,0,252,5,79,465
020011301,162,63,68,9,50,5,45,402
020011302,59,21,62,8,5,10,18,183
020011303,20,20,392,1,4,0,35,472
020011304,136,118,7,1,78,1,299,640
020011305,150,67,38,0,5,9,33,302
020011306,95,17,9,2,0,90,47,260
020011307,236,1,277,0,0,3,44,561
020011308,155,84,13,0,51,2,42,347
020011309,154,49,13,0,0,6,29,251
020011310,229,132,32,1,0,0,247,641
020011311,137,78,33,0,98,26,10,382
020011312,138,97,6,1,0,0,8,250
020011313,102,74,36,1,19,15,15,262
020011314,561,6,1,1,270,1,11,851
020011315,0,2,0,3,0,0,1,6
020011401,193,82,6,0,219,4,23,527
020011402,210,24,2,2,116,6,15,375
020011403,175,29,4,1,114,1,21,345
020011404,37,0,1,1,61,0,48,148
020011405,193,22,3,1,57,0,11,287
020011406,289,70,4,0,35,3,21,422
020011407,208,32,7,0,75,3,36,361
020011408,188,15,6,0,95,1,67,372
020011409,246,23,31,0,29,1,24,354
020011410,212,87,21,0,17,1,3,341
020011411,253,57,24,0,62,2,14,412
020011412,216,25,26,3,23,2,11,306
020011501,165,41,37,4,148,4,21,420
020011502,242,54,31,0,159,2,10,498
020011503,199,42,83,1,79,11,20,435
020011504,319,99,10,29,208,0,18,683
020011505,155,22,2,0,26,1,11,217
020011506,300,50,24,2,74,3,22,475
020011507,245,49,15,0,24,2,29,364
020011508,306,41,21,1,15,8,26,418
020011509,330,74,47,10,33,4,27,525
020011510,270,38,34,1,19,7,14,383
020011511,237,16,5,2,4,4,2,270
020011601,186,40,21,2,74,9,7,339
020011602,163,50,15,0,51,4,8,291
020011603,404,63,40,2,104,27,32,672
020011604,331,129,39,1,45,18,45,608
020011605,200,57,20,0,5,0,9,291
020011606,194,27,9,0,1,0,9,240
020011607,447,111,13,1,63,23,27,685
020011608,215,64,3,2,9,3,1,297
020011609,156,21,1,1,9,5,10,203
020011610,281,38,7,1,72,6,33,438
020011611,213,36,22,0,20,2,6,299
020011612,132,21,7,0,28,0,15,203
020011701,356,41,30,3,57,10,45,542
020011702,281,48,25,0,11,91,11,467
020011703,294,23,30,0,23,12,40,422
020011704,280,41,24,1,8,5,17,376
020011705,251,34,5,4,4,0,20,318
020011706,350,67,20,1,1,4,11,454
020011707,318,65,6,2,65,6,15,477
020011708,243,27,7,1,15,0,19,312
020011709,238,25,5,1,12,14,14,309
020011710,274,48,15,0,8,1,17,363
020011711,215,30,1,0,6,0,22,274
020011801,349,95,13,1,13,0,24,495
020011802,348,79,13,0,15,7,25,487
020011803,278,34,8,0,10,1,20,351
020011804,337,46,17,1,10,1,22,434
020011805,265,42,15,2,22,2,11,359
020011806,476,73,34,0,10,0,23,616
020011807,308,48,9,0,10,4,36,415
020011808,297,33,25,0,1,0,11,367
020011809,297,72,16,0,2,5,136,528
020011901,419,36,27,1,0,0,10,493
020011902,488,88,25,0,8,12,17,638
020011903,140,23,6,0,3,0,4,176
020011904,287,87,3,1,5,1,15,399
020011905,251,25,26,4,20,8,28,362
020011906,202,13,0,1,0,0,11,227
020011907,317,35,13,2,10,8,15,400
020011908,156,24,0,0,0,0,4,184
020011909,219,34,6,1,4,0,27,291
020012001,255,43,11,1,11,12,10,343
020012002,296,48,14,1,1,0,10,370
020012003,234,49,9,2,2,1,14,311
020012004,342,62,9,5,3,0,26,447
020012005,346,53,26,1,9,0,34,469
020012006,311,48,7,0,4,0,17,387
020012007,205,40,52,1,3,2,17,320
020012008,216,18,69,0,12,0,16,331
020012009,237,46,20,0,0,2,11,316
020012010,306,35,7,4,3,2,24,381
020012101,265,25,8,1,4,4,17,324
020012102,249,33,17,5,3,1,11,319
020012103,126,25,11,1,3,0,16,182
020012104,462,47,9,0,6,0,24,548
020012105,271,47,17,0,7,1,29,372
020012106,257,30,7,1,2,8,12,317
020012107,325,43,6,4,3,2,6,389
020012108,238,32,24,0,9,0,26,329
020012109,322,34,34,1,3,3,32,429
020012110,357,84,77,1,18,1,6,544
020012201,228,73,12,4,23,1,20,361
020012202,417,85,24,5,4,3,24,562
020012203,354,56,13,5,4,2,27,461
020012204,196,35,10,0,7,4,15,267
020012205,184,19,24,0,6,2,15,250
020012206,242,49,41,0,4,1,16,353
020012207,257,38,6,3,6,6,16,332
020012208,272,35,17,0,9,4,21,358
020012209,368,40,8,1,9,1,14,441
020012210,574,84,39,1,11,1,26,736
020012301,261,52,14,10,11,1,12,361
020012302,210,56,16,4,8,9,9,312
020012303,369,49,25,3,18,8,30,502
020012304,131,25,4,2,4,0,2,168
020012305,219,19,3,0,2,2,5,250
020012306,208,41,17,0,1,3,3,273
020012307,249,23,23,5,6,0,8,314
020012308,286,35,10,3,9,9,11,363
020012309,400,71,18,0,3,3,13,508
020012310,145,27,7,1,5,4,1,190
020012401,113,32,16,0,33,0,20,214
020012402,141,44,19,0,19,7,5,235
020012403,159,54,22,0,0,0,14,249
020012404,166,46,16,4,10,0,17,259
020012405,161,30,26,1,2,4,8,232
020012406,346,102,47,3,12,5,21,536
020012407,256,51,106,1,72,6,17,509
020012408,179,43,5,0,0,1,18,246
020012501,171,38,16,3,5,0,3,236
020012502,174,49,26,4,8,5,30,296
020012503,221,71,25,2,1,0,14,334
020012504,409,35,20,1,9,9,27,510
020012505,220,66,8,0,6,1,16,317
020012506,336,29,20,2,7,2,8,404
020012507,191,26,15,1,5,3,29,270
020012508,316,28,27,2,1,2,42,418
020012509,150,4,4,0,3,0,26,187
020012510,211,14,17,1,0,0,3,246
020012511,249,25,15,2,6,2,8,307
020012601,241,16,4,0,4,2,19,286
020012602,298,53,31,1,7,0,15,405
020012603,213,56,24,0,4,3,8,308
020012604,239,23,7,0,6,1,15,291
020012605,299,42,10,5,8,1,26,391
020012606,214,36,14,0,0,0,24,288
020012607,141,24,5,1,5,0,26,202
020012608,212,38,14,0,8,0,9,281
020012609,311,37,15,0,10,3,22,398
020012701,230,27,14,1,3,2,30,307
020012702,138,17,1,2,1,2,27,188
020012703,271,43,7,1,1,1,9,333
020012704,316,29,3,0,0,0,11,359
020012705,282,47,20,1,9,0,5,364
020012706,354,13,3,1,3,2,7,383
020012707,228,13,0,0,0,0,8,249
020012708,244,73,8,0,12,0,15,352
020012709,300,23,1,0,2,1,17,344
020012710,241,46,38,2,17,0,22,366
020012801,214,29,15,0,0,0,17,275
020012802,340,17,5,0,1,0,6,369
020012803,232,10,0,1,4,0,13,260
020012804,271,26,3,0,3,0,17,320
020012805,348,57,18,0,7,1,29,460
020012806,273,30,3,2,3,0,9,320
020012807,293,20,10,1,3,0,20,347
020012808,93,0,0,0,0,0,0,93
020012809,255,11,24,0,0,0,10,300
020012810,337,33,5,5,5,7,19,411
020012811,236,0,8,1,3,0,2,250
020012812,229,19,1,0,0,0,14,263
020012813,241,19,3,1,3,0,8,275
020012901,395,37,3,1,3,1,13,453
020012902,226,14,2,1,4,0,3,250
020012903,273,12,4,1,1,1,7,299
020012904,242,25,8,0,3,0,16,294
020012905,258,36,16,8,2,0,14,334
020012906,319,22,3,0,0,0,5,349
020012907,324,28,18,0,5,0,11,386
020012908,224,16,14,4,2,0,18,278
020012909,342,51,24,2,2,0,11,432
020020101,9,0,0,0,0,0,0,9
020020102,119,0,0,0,0,0,3,122
020020201,229,54,5,2,10,1,31,332
020020202,361,77,6,6,10,5,58,523
020020203,224,42,5,0,3,2,15,291
020020204,185,33,8,1,0,0,13,240
020020205,259,45,28,1,11,4,12,360
020020206,190,52,11,0,15,3,18,289
020020207,129,26,6,0,14,6,15,196
020020208,278,86,24,1,8,5,25,427
020020301,397,100,17,4,33,8,51,610
020020302,398,166,54,0,33,22,62,735
020020303,87,11,2,0,1,0,10,111
020020304,187,51,17,0,4,4,4,267
020020305,288,86,24,3,58,25,16,500
020020306,272,127,42,0,68,3,40,552
020020307,331,103,17,2,32,5,21,511
020020308,229,67,10,0,11,2,27,346
020020401,307,80,48,2,8,17,10,472
020020402,109,58,54,2,9,13,6,251
020020403,146,53,14,0,25,3,18,259
020020404,193,55,32,1,12,11,17,321
020020405,281,122,27,3,1,9,16,459
020020406,186,72,13,0,6,4,20,301
020020407,226,102,27,3,58,12,17,445
020020408,424,125,57,4,50,12,43,715
020020409,314,79,61,9,16,8,42,529
020020410,414,187,43,1,21,14,41,721
020020501,256,87,6,3,7,22,24,405
020020502,276,74,26,2,7,19,28,432
020020503,248,35,7,2,2,14,29,337
020020504,224,108,10,41,10,10,10,413
020020505,318,100,26,5,13,36,25,523
020020506,326,98,12,0,44,5,39,524
020020507,320,62,32,2,8,6,41,471
020020508,322,114,35,1,18,3,30,523
020020509,249,87,13,1,21,9,13,393
020020601,167,26,16,1,2,7,19,238
020020602,560,137,18,2,47,42,36,842
020020603,220,26,2,1,27,10,30,316
020020604,315,93,22,0,22,6,24,482
020020605,178,45,15,0,11,2,34,285
020020606,313,74,9,0,149,8,50,603
020020607,174,28,11,1,77,10,32,333
020020608,219,36,3,0,14,3,54,329
020020609,269,66,13,0,112,5,62,527
020020610,226,31,26,1,166,4,58,512
020020701,560,119,37,7,33,19,32,807
020020702,473,117,27,2,59,12,83,773
020020703,355,117,9,3,21,19,23,547
020020704,264,71,16,5,14,6,14,390
020020705,241,86,22,0,79,7,10,445
020020706,271,59,35,1,157,16,21,560
020020707,400,144,80,0,15,40,13,692
020020708,154,30,11,0,94,0,22,311
020020709,276,90,14,0,10,9,28,427
020020801,335,134,15,1,22,22,9,538
020020802,302,82,7,1,12,5,47,456
020020803,451,87,49,4,42,7,73,713
020020804,474,86,20,3,20,28,45,676
020020805,397,167,43,5,12,9,20,653
020020806,618,169,44,2,11,15,31,890
020020807,681,180,66,1,13,23,26,990
020020808,350,62,23,1,13,27,17,493
020020901,372,93,29,2,60,8,28,592
020020902,215,67,6,3,12,2,12,317
020020903,446,140,25,0,27,15,28,681
020020904,455,82,22,0,23,5,30,617
020020905,461,128,82,0,9,12,21,713
020020906,437,139,24,2,24,27,25,678
020020907,458,125,60,4,16,16,34,713
020020908,636,132,34,0,26,16,54,898
020020909,519,114,23,5,52,31,37,781
020021001,515,131,13,0,21,11,45,736
020021002,353,82,40,2,18,10,47,552
020021003,206,85,12,1,11,2,9,326
020021004,341,89,21,1,9,9,21,491
020021005,421,137,21,0,42,22,29,672
020021006,315,63,4,0,11,1,8,402
020021007,474,124,19,4,28,18,46,713
020021008,429,123,28,2,17,7,18,624
020021009,277,61,24,5,19,4,17,407
020021101,600,159,42,1,32,14,52,900
020021102,228,27,10,1,11,7,23,307
020021103,644,167,45,3,57,11,43,970
020021104,657,120,34,0,33,8,30,882
020021105,152,41,10,0,18,1,9,231
020021106,302,122,25,1,17,17,15,499
020021201,431,67,15,2,38,10,28,591
020021202,387,90,6,0,32,7,46,568
020021203,414,77,35,0,15,16,38,595
020021204,684,181,45,2,34,7,50,1003
020021205,567,170,18,1,17,5,50,828
020021206,471,90,26,1,15,2,50,655
020021301,558,199,36,0,22,6,65,886
020021302,409,97,26,3,4,12,22,573
020021303,494,107,16,0,19,9,73,718
020021304,529,126,38,4,22,5,18,742
020021305,605,128,32,3,23,27,70,888
020021306,378,96,21,1,32,10,25,563
020021307,592,135,43,3,58,12,45,888
020021401,246,54,26,0,14,10,20,370
020021402,294,98,3,1,9,5,15,425
020021403,174,58,14,0,3,6,6,261
020021404,356,107,13,2,38,8,15,539
020021405,455,116,12,0,12,5,21,621
020021406,522,97,41,0,33,9,32,734
020021407,337,80,16,3,28,13,12,489
020021408,373,83,43,2,20,11,34,566
020021409,571,168,41,2,54,21,36,893
020021410,523,155,15,0,73,16,32,814
020021501,264,46,21,1,16,5,12,365
020021502,383,93,30,1,42,12,27,588
020021503,625,202,54,5,13,9,22,930
020021504,309,57,8,1,24,14,44,457
020021505,264,50,58,0,31,8,5,416
020021506,284,73,13,3,25,14,29,441
020021507,362,76,15,2,10,6,52,523
020021508,329,66,23,0,38,10,21,487
020021601,317,81,11,18,19,11,37,494
020021602,288,58,39,5,8,3,32,433
020021603,301,120,16,2,42,4,21,506
020021604,278,105,71,1,70,71,82,678
020021605,358,67,28,0,52,30,37,572
020021606,317,72,16,1,25,14,21,466
020021607,337,51,12,2,3,15,33,453
020021608,196,60,27,0,81,19,11,394
020021701,564,116,30,3,90,18,46,867
020021702,366,89,15,1,44,28,21,564
020021703,445,150,27,1,69,19,53,764
020021704,162,63,25,1,70,38,33,392
020021705,275,92,30,2,105,25,63,592
020021706,441,137,46,2,38,8,18,690
020021707,520,165,75,6,126,12,35,939
020021708,470,126,24,1,42,10,51,724
020021709,356,114,22,2,27,9,30,560
020021801,441,106,31,2,39,6,31,656
020021802,518,199,37,4,61,29,20,868
020021803,391,130,53,1,81,8,67,731
020021804,262,56,11,1,66,5,41,442
020021805,243,34,9,0,33,3,12,334
020021806,358,85,15,0,18,10,30,516
020021807,263,38,7,0,34,0,19,361
020021808,328,34,17,0,147,3,19,548
020021901,391,121,29,1,17,4,7,570
020021902,297,63,9,1,14,14,27,425
020021903,303,50,14,3,13,5,12,400
020021904,487,113,22,3,22,0,43,690
020021905,352,95,38,0,17,5,16,523
020021906,418,86,22,0,10,18,17,571
020021907,313,95,23,0,9,4,7,451
020021908,366,74,18,0,25,8,23,514
020022001,441,64,33,1,10,13,33,595
020022002,445,111,27,3,11,6,48,651
020022003,370,87,15,0,13,1,26,512
020022004,369,68,10,0,9,5,65,526
020022005,243,41,3,0,3,0,12,302
020022006,323,38,2,1,6,1,55,426
020022007,243,74,24,2,7,4,24,378
020022008,284,86,10,1,4,4,16,405
020022101,445,66,42,6,50,2,46,657
020022102,431,78,21,4,19,14,38,605
020022103,358,65,11,2,18,2,16,472
020022104,508,176,39,0,15,2,33,773
020022105,465,92,28,0,30,4,32,651
020022106,455,93,54,0,19,3,44,668
020022201,364,112,28,0,27,12,12,555
020022202,279,52,10,0,11,18,8,378
020022203,203,60,14,0,11,3,14,305
020022204,475,121,27,0,24,5,42,694
020022205,522,125,31,3,35,7,21,744
020022206,556,173,50,2,72,17,48,918
020022301,429,101,7,1,44,8,39,629
020022302,509,107,20,0,61,14,86,797
020022303,433,96,94,0,22,23,44,712
020022304,377,63,30,2,17,6,20,515
020022305,293,68,29,1,28,11,11,441
020022306,198,61,13,3,19,10,8,312
020022307,228,45,12,1,27,11,47,371
020022308,181,25,3,0,13,10,19,251
020022309,446,70,28,0,40,15,61,660
020022401,444,95,14,1,27,2,27,610
020022402,371,3,12,0,17,3,123,529
020022403,331,74,14,1,8,7,15,450
020022404,451,81,19,1,32,15,42,641
020022405,494,106,40,0,26,9,55,730
020022406,459,81,18,1,26,11,25,621
020022501,309,93,6,3,13,6,28,458
020022502,344,65,12,2,44,6,19,492
020022503,177,46,5,0,4,1,6,239
020022504,425,114,31,0,25,10,27,632
020022505,453,89,24,0,10,11,32,619
020022506,348,63,19,0,6,7,10,453
020022507,373,96,25,0,9,6,19,528
020022508,505,142,23,0,21,7,45,743
020022509,405,84,120,0,21,9,38,677
020022510,297,83,23,1,18,1,12,435
020022511,431,118,26,6,16,3,57,657
020030101,474,83,57,0,19,8,26,667
020030102,409,35,11,1,16,1,62,535
020030103,443,108,24,4,13,3,26,621
020030104,241,56,16,1,1,0,30,345
020030105,361,52,22,3,11,12,32,493
020030106,252,58,30,3,12,0,16,371
020030107,328,26,5,2,3,0,6,370
020030108,169,45,15,5,6,0,1,241
020030109,217,30,23,0,5,0,14,289
020030110,174,13,1,0,4,1,2,195
020030111,222,50,6,1,1,2,5,287
020030201,320,38,25,1,13,0,47,444
020030202,331,15,16,1,3,0,72,438
020030203,316,66,12,1,4,1,26,426
020030204,283,41,16,1,1,1,18,361
020030205,336,59,19,1,5,3,49,472
020030206,349,35,16,1,31,2,21,455
020030207,394,95,17,2,5,4,33,550
020030208,338,12,49,2,138,2,54,595
020030209,275,61,18,10,6,2,21,393
020030210,168,54,3,0,5,1,3,234
020030211,253,21,14,0,5,11,2,306
020030212,298,47,12,3,26,6,31,423
020030301,452,111,17,1,39,5,32,657
020030302,367,85,18,2,20,1,34,527
020030303,244,45,7,0,17,5,30,348
020030304,205,35,9,2,10,2,10,273
020030305,234,58,25,10,5,0,22,354
020030306,293,66,6,1,5,3,14,388
020030307,300,58,9,0,5,0,18,390
020030308,260,54,5,1,15,1,22,358
020030309,154,11,0,1,11,0,13,190
020030310,263,25,7,1,28,0,14,338
020030311,305,4,0,0,0,0,96,405
020030401,308,52,23,1,25,4,36,449
020030402,208,35,2,1,3,0,20,269
020030403,273,57,14,2,8,1,61,416
020030404,286,47,26,0,22,2,20,403
020030405,266,41,8,0,76,1,15,407
020030406,295,53,5,0,20,1,50,424
020030407,264,68,25,0,49,3,13,422
020030408,234,26,2,1,86,4,18,371
020030501,369,119,18,0,52,2,23,583
020030502,283,82,12,0,17,2,22,418
020030503,449,126,25,1,19,14,38,672
020030504,248,64,30,2,14,0,16,374
020030505,324,120,4,7,39,0,30,524
020030506,203,105,29,2,22,1,14,376
020030507,350,80,23,0,74,41,40,608
020030601,351,72,24,4,87,12,74,624
020030602,141,51,9,0,10,1,12,224
020030603,293,80,47,0,24,5,52,501
020030604,297,42,49,1,20,20,16,445
020030605,303,67,8,1,50,29,16,474
020030606,250,51,19,0,47,9,37,413
020030607,304,41,35,0,25,0,30,435
020030701,133,22,0,0,2,0,19,176
020030702,384,141,19,0,45,5,22,616
020030703,432,96,39,1,15,4,35,622
020030704,356,78,27,2,137,3,55,658
020030705,264,118,17,1,79,6,9,494
020030706,279,62,29,0,38,8,50,466
020030707,468,109,22,0,29,2,37,667
020030708,159,20,16,1,0,1,5,202
020030709,390,93,34,0,101,4,42,664
020030801,314,98,6,0,22,11,31,482
020030802,206,29,2,0,47,0,6,290
020030803,329,41,18,0,25,9,23,445
020030804,210,34,16,0,84,1,24,369
020030805,197,19,5,0,100,2,26,349
020030806,197,24,4,0,11,0,27,263
020030807,165,37,11,0,6,0,7,226
020030808,197,17,1,0,48,7,10,280
020030809,295,41,26,0,5,1,9,377
020030810,214,26,14,0,5,6,6,271
020030901,380,64,13,1,3,1,24,486
020030902,199,51,1,0,2,0,18,271
020030903,329,50,11,4,6,1,34,435
020030904,375,53,8,0,4,9,19,468
020030905,206,41,7,1,1,1,13,270
020030906,193,44,13,1,2,0,13,266
020030907,214,41,1,1,0,1,10,268
020030908,210,46,5,9,0,1,27,298
020030909,355,59,27,1,4,0,13,459
020030910,291,33,4,0,19,1,26,374
020031001,376,48,27,0,22,5,39,517
020031002,320,49,21,0,5,3,37,435
020031003,231,31,15,0,8,1,27,313
020031004,278,67,17,1,22,3,28,416
020031005,199,8,42,1,22,0,28,300
020031006,371,33,3,0,78,1,23,509
020031007,329,44,18,0,5,1,18,415
020031008,270,16,18,1,4,2,18,329
020031101,345,29,19,1,14,8,40,456
020031102,432,38,21,27,9,9,31,567
020031103,338,74,12,0,6,0,24,454
020031104,360,69,13,0,140,10,36,628
020031105,314,51,26,0,43,4,13,451
020031106,396,51,17,0,51,4,14,533
020031107,426,68,22,0,40,6,22,584
020031108,265,23,26,0,16,6,33,369
020031201,350,57,48,0,32,0,26,513
020031202,396,86,14,0,13,1,34,544
020031203,264,30,8,0,43,0,23,368
020031204,227,31,15,0,0,2,12,287
020031205,473,94,32,1,19,15,40,674
020031206,49,12,2,0,1,0,19,83
020031207,431,113,13,0,18,3,25,603
020031208,285,52,17,0,2,5,18,379
020031209,205,43,8,0,8,2,14,280
020031210,298,53,4,0,6,8,16,385
020031301,298,47,2,1,9,1,7,365
020031302,327,63,6,0,3,1,9,409
020031303,369,39,16,0,5,9,27,465
020031304,206,15,11,0,10,1,8,251
020031305,321,64,14,0,16,3,15,433
020031306,313,42,26,0,7,1,49,438
020031307,248,39,3,0,6,2,21,319
020031308,238,51,15,0,3,0,27,334
020031309,345,51,17,1,6,17,35,472
020031310,162,28,1,0,1,0,12,204
020031311,260,65,25,2,17,6,10,385
020031401,335,29,15,11,8,1,12,411
020031402,385,57,12,0,7,2,45,508
020031403,446,52,39,1,1,8,28,575
020031404,286,51,24,1,15,3,20,400
020031405,361,32,8,0,1,0,26,428
020031406,505,60,24,3,10,4,27,633
020031407,246,38,8,12,1,5,12,322
020031408,308,50,24,0,3,0,11,396
020031409,32,1,1,4,0,0,17,55
020031410,303,17,23,1,8,3,37,392
020031501,268,68,9,0,9,1,31,386
020031502,367,52,23,0,4,1,38,485
020031503,269,27,11,0,8,1,17,333
020031504,322,65,17,0,25,32,12,473
020031505,370,77,18,0,17,9,15,506
020031506,352,74,20,1,18,3,18,486
020031507,586,92,24,0,11,7,40,760
020031508,587,146,40,0,17,3,50,843
020031509,113,33,1,0,0,0,2,149
020031601,366,61,6,0,1,4,30,468
020031602,486,54,25,2,6,3,32,608
020031603,338,23,21,0,3,0,31,416
020031604,174,33,2,0,10,0,31,250
020031605,235,35,15,0,3,0,5,293
020031606,262,40,4,1,10,1,21,339
020031607,306,34,6,0,3,2,16,367
020031608,322,25,2,7,6,6,28,396
020031609,492,68,16,0,11,3,6,596
020031701,257,43,15,0,5,0,6,326
020031702,320,45,11,1,1,0,11,389
020031703,202,31,15,0,1,0,7,256
020031704,325,23,2,0,1,0,10,361
020031705,261,28,3,2,2,2,12,310
020031706,318,48,7,3,3,0,11,390
020031707,338,35,23,1,1,0,11,409
020031708,349,48,10,1,5,0,22,435
020031709,242,46,14,0,4,0,16,322
020031801,249,23,3,1,3,1,11,291
020031802,289,40,8,3,4,0,11,355
020031803,186,24,18,0,2,0,16,246
020031804,354,85,7,0,11,7,9,473
020031805,169,33,0,0,0,0,7,209
020031806,242,28,17,3,4,0,5,299
020031807,272,31,23,0,2,2,6,336
020031808,245,26,18,0,4,2,17,312
020031809,381,70,25,0,11,2,10,499
020031810,194,38,10,2,5,0,7,256
020031811,240,34,52,1,6,0,20,353
020031901,473,59,39,2,5,2,45,625
020031902,138,26,1,0,0,0,1,166
020031903,293,60,31,0,5,1,15,405
020031904,289,28,14,3,5,1,20,360
020031905,298,27,13,0,4,0,19,361
020031906,323,53,11,1,6,5,17,416
020031907,309,50,20,2,2,0,15,398
020031908,453,68,32,3,3,0,45,604
020031909,292,25,13,4,8,0,23,365
020031910,231,34,3,0,1,2,8,279
020032001,275,14,16,0,9,10,17,341
020032002,404,29,19,0,10,1,15,478
020032003,312,62,22,0,19,1,29,445
020032004,286,52,8,0,0,2,30,378
020032005,225,21,5,0,1,0,16,268
020032006,185,42,3,0,4,0,2,236
020032007,333,36,16,1,11,3,31,431
020032008,253,32,14,1,2,8,11,321
020032009,453,53,17,0,7,3,17,550
020032010,286,44,0,1,3,1,33,368
020032011,238,44,7,1,1,0,16,307
020032101,374,59,17,4,6,0,17,477
020032102,386,60,13,1,2,4,24,490
020032103,284,56,17,0,2,0,23,382
020032104,339,25,22,0,5,0,18,409
020032105,208,11,1,2,1,0,13,236
020032106,366,31,8,2,14,0,8,429
020032107,198,9,6,0,6,6,14,239
020032108,304,54,5,1,8,0,28,400
020032109,186,38,12,0,0,2,18,256
020032110,400,35,26,1,10,0,29,501
020032201,289,60,10,3,11,1,11,385
020032202,291,41,2,0,1,2,14,351
020032203,173,25,5,1,3,0,12,219
020032204,208,34,4,1,1,2,18,268
020032205,357,56,20,3,9,1,15,461
020032206,221,31,18,0,3,9,6,288
020032207,305,83,4,0,7,2,9,410
020032208,363,46,23,2,5,2,12,453
020032209,368,39,26,1,10,0,20,464
020032301,303,20,11,1,9,1,10,355
020032302,329,48,14,0,1,0,16,408
020032303,344,32,7,1,5,2,36,427
020032304,185,14,5,0,4,1,4,213
020032305,291,55,1,0,0,0,16,363
020032306,224,19,7,0,2,0,11,263
020032307,243,33,9,1,14,0,15,315
020032308,332,25,14,2,16,1,10,400
020032309,314,29,6,3,2,2,18,374
020032310,362,43,6,1,3,2,11,428
020032401,292,26,26,2,4,2,15,367
020032402,289,28,2,4,1,0,13,337
020032403,272,37,29,0,1,2,21,362
020032404,301,39,11,5,2,1,15,374
020032405,220,23,10,2,3,0,19,277
020032406,359,54,6,7,10,1,32,469
020032407,292,35,21,0,3,1,39,391
020032408,299,32,12,4,5,3,11,366
020032409,183,21,8,0,1,2,1,216
020032501,507,131,9,0,0,0,6,653
020032502,259,41,21,0,9,0,7,337
020032503,176,43,6,1,7,4,8,245
020032504,258,24,29,4,12,0,0,327
020032505,202,0,0,0,0,0,0,202
020032506,317,20,5,0,2,0,4,348
020032507,223,24,5,0,4,1,12,269
020032508,694,109,24,0,3,1,31,862
020032509,312,38,12,0,1,0,8,371
020032601,362,59,20,2,2,3,13,461
020032602,405,40,9,1,1,1,9,466
020032603,327,32,17,2,5,1,24,408
020032604,223,36,6,1,7,1,20,294
020032605,322,45,6,1,4,1,17,396
020032606,221,45,6,2,0,1,15,290
020032607,296,39,31,3,7,0,29,405
020032608,240,32,5,0,1,0,10,288
020032609,264,23,10,0,7,0,11,315
020032701,374,39,9,0,7,0,36,465
020032702,286,13,4,1,1,3,10,318
020032703,322,33,5,0,6,1,20,387
020032704,304,56,10,3,13,0,5,391
020032705,296,44,15,3,7,0,14,379
020032706,256,37,5,0,2,0,3,303
020032707,318,61,11,1,0,1,13,405
020040101,184,17,6,0,4,0,20,231
020040102,196,24,4,0,4,0,13,241
020040103,160,14,4,1,0,0,4,183
020040104,175,13,4,0,1,0,3,196
020040105,163,6,0,0,1,0,0,170
020040106,118,3,0,1,0,0,4,126
020040107,151,5,0,0,0,2,4,162
020040108,218,18,3,1,2,0,10,252
020040109,176,11,4,2,3,0,24,220
020040110,148,22,3,6,11,0,11,201
020040111,167,28,1,1,0,0,9,206
020040112,171,16,7,3,10,0,7,214
020040113,127,25,4,1,3,0,8,168
020040114,204,9,3,0,4,0,1,221
020040201,269,34,6,1,2,0,4,316
020040202,272,43,16,1,1,0,8,341
020040203,357,55,8,1,8,4,22,455
020040204,239,17,1,0,2,1,3,263
020040205,212,10,14,3,22,1,12,274
020040206,248,17,14,0,3,0,10,292
020040207,293,51,5,1,4,0,20,374
020040208,176,9,5,1,4,0,14,209
020040209,204,6,0,1,0,0,7,218
020040210,273,15,3,1,7,0,11,310
020040301,319,27,4,2,6,0,9,367
020040302,281,15,3,0,2,0,8,309
020040303,206,13,2,0,2,2,4,229
020040304,290,20,1,1,1,0,15,328
020040305,319,24,6,3,1,0,12,365
020040306,272,11,9,0,5,4,20,321
020040307,212,29,7,0,1,0,8,257
020040308,263,17,1,3,6,0,14,304
020040309,172,5,6,2,3,0,12,200
020040310,271,29,10,2,3,1,11,327
020040311,291,27,7,1,10,0,16,352
020040312,321,19,5,2,2,0,10,359
020040313,170,7,1,0,2,0,12,192
020040401,233,34,6,2,3,0,4,282
020040402,293,36,6,0,1,2,17,355
020040403,301,13,24,3,6,0,43,390
020040404,320,19,6,4,0,0,16,365
020040405,358,32,25,4,3,1,16,439
020040406,273,23,9,1,1,0,4,311
020040407,321,50,12,1,3,1,12,400
020040408,261,62,8,0,1,0,8,340
020040409,255,35,6,0,3,0,22,321
020040410,261,44,8,0,7,0,7,327
020040411,277,24,4,5,5,1,17,333
020040501,360,47,13,0,3,0,16,439
020040502,238,21,9,2,6,0,7,283
020040503,319,42,10,1,4,0,12,388
020040504,250,30,3,1,4,0,15,303
020040505,198,20,5,1,0,0,3,227
020040506,343,20,21,2,17,7,9,419
020040507,232,25,10,0,9,0,7,283
020040508,241,18,6,4,7,1,21,298
020040509,590,26,7,6,13,1,22,665
020040510,357,21,11,0,2,3,4,398
020040511,304,19,14,0,2,0,20,359
020040601,404,36,44,7,14,2,10,517
020040602,292,26,17,1,3,1,16,356
020040603,258,28,8,0,0,0,15,309
020040604,297,40,14,4,0,0,11,366
020040605,256,16,3,5,5,0,30,315
020040606,369,46,1,0,0,0,13,429
020040607,286,8,9,0,3,1,5,312
020040608,301,18,8,1,3,1,24,356
020040609,269,18,5,2,7,0,8,309
020040610,211,29,2,0,12,0,0,254
020040611,239,25,3,1,3,1,0,272
020040701,294,37,9,1,7,0,15,363
020040702,263,33,12,1,3,1,11,324
020040703,238,17,4,0,0,0,5,264
020040704,750,96,21,1,2,2,45,917
020040705,293,33,9,2,1,0,11,349
020040706,273,45,11,4,2,0,8,343
020040707,312,40,18,1,0,0,4,375
020040708,281,27,21,2,0,0,17,348
020040709,243,32,3,2,1,0,8,289
020040710,274,54,9,0,4,2,13,356
020040711,188,26,8,1,2,1,5,231
020040712,234,27,6,1,18,0,15,301
020040801,297,52,11,0,1,1,18,380
020040802,306,44,30,1,3,0,16,400
020040803,237,26,15,1,13,0,12,304
020040804,253,27,7,1,4,4,11,307
020040805,266,40,21,3,0,1,18,349
020040806,273,43,4,2,1,0,7,330
020040807,774,114,31,10,11,0,53,993
020040808,96,11,1,0,6,0,0,114
020040809,272,24,3,4,4,0,14,321
020040810,206,21,5,1,2,0,12,247
020040811,254,9,23,4,11,0,21,322
020040901,260,26,3,2,2,1,18,312
020040902,225,15,2,0,8,0,13,263
020040903,159,9,2,2,1,0,3,176
020040904,145,15,1,1,7,0,17,186
020040905,189,29,8,0,4,0,3,233
020040906,276,25,5,0,1,0,11,318
020040907,249,31,5,0,0,1,7,293
020041001,11,0,0,0,0,0,0,11
020041002,533,4,0,0,0,0,14,551
020041003,466,10,0,3,0,0,12,491
020041004,105,0,0,0,0,0,12,117
020041005,436,7,4,0,0,0,12,459
020041006,259,15,0,0,0,0,2,276
020041007,232,11,0,0,0,0,6,249
020041008,402,5,1,1,0,0,21,430
020041009,559,13,1,3,1,1,10,588
020041101,209,25,8,0,3,1,9,255
020041102,306,37,5,2,12,3,19,384
020041103,274,39,6,1,14,1,11,346
020041104,247,33,4,1,11,0,21,317
020041105,161,25,3,0,16,1,4,210
020041106,267,24,6,1,6,0,21,325
020041107,296,42,1,0,2,0,20,361
020041108,285,23,0,1,6,0,33,348
020041109,230,11,4,1,12,0,19,277
020041201,141,19,2,0,3,0,5,170
020041202,188,11,4,0,0,0,2,205
020041203,301,9,10,0,3,0,13,336
020041204,233,10,13,0,1,0,9,266
020041205,215,13,6,1,2,1,18,256
020041206,197,11,1,0,7,0,21,237
020041207,113,10,6,3,5,0,8,145
020041208,182,46,17,0,7,1,2,255
020041209,302,33,15,0,11,8,19,388
020041210,265,20,4,1,3,1,5,299
020041211,256,17,8,0,2,0,13,296
020041212,210,36,11,0,5,0,7,269
020041301,348,103,10,2,12,0,24,499
020041302,240,22,22,0,3,0,13,300
020041303,245,30,4,3,8,0,8,298
020041304,219,23,14,0,6,0,11,273
020041305,358,26,33,0,0,1,44,462
020041306,170,9,7,6,1,0,7,200
020041307,396,82,22,1,11,5,13,530
020041308,174,8,10,0,3,0,1,196
020041309,169,29,3,0,1,3,4,209
020041310,200,31,12,0,6,0,6,255
020041311,445,58,11,2,7,2,20,545
020041401,263,21,36,1,4,0,14,339
020041402,255,39,3,1,3,2,10,313
020041403,273,50,9,5,4,0,19,360
020041404,493,95,16,5,4,8,33,654
020041405,288,34,6,0,7,3,6,344
020041406,207,59,18,1,6,0,6,297
020041407,281,30,6,1,3,1,13,335
020041408,353,48,15,0,3,0,21,440
020041409,250,36,35,2,15,2,23,363
020041501,255,42,13,1,5,0,12,328
020041502,616,99,22,1,3,2,50,793
020041503,481,53,19,1,12,3,10,579
020041504,291,20,12,3,2,4,20,352
020041505,216,27,2,1,0,2,10,258
020041506,238,48,10,2,1,3,13,315
020041507,268,32,2,1,5,0,9,317
020041508,270,33,22,0,4,0,11,340
020041509,243,22,2,0,0,1,22,290
020041510,181,10,7,0,1,1,4,204
020041601,253,22,4,0,2,0,9,290
020041602,879,197,193,13,2,8,112,1404
020041603,426,34,3,0,0,0,7,470
020041604,247,19,4,1,0,0,28,299
020041605,381,39,12,1,5,1,23,462
020041606,242,25,8,1,0,0,13,289
020041607,147,21,2,0,2,0,14,186
020041608,212,28,3,0,1,1,13,258
020041609,424,62,9,0,11,1,7,514
020041610,273,26,9,1,1,0,7,317
020041701,217,19,7,0,1,0,5,249
020041702,237,27,1,0,4,1,27,297
020041703,215,28,3,0,4,0,10,260
020041704,291,29,4,0,0,0,16,340
020041705,328,46,8,0,0,0,12,394
020041706,276,5,26,0,1,0,34,342
020041707,255,16,14,1,1,1,15,303
020041708,346,40,1,1,11,0,10,409
020041709,331,33,13,1,2,0,58,438
020041710,261,15,4,2,1,0,18,301
020041801,42,0,0,0,0,0,2,44
020041901,243,24,8,0,3,1,8,287
020041902,240,26,16,0,1,3,9,295
020041903,321,18,2,0,1,2,7,351
020041904,332,22,10,0,1,0,10,375
020041905,256,23,5,2,6,0,19,311
020041906,343,14,6,1,0,1,12,377
020041907,265,2,1,1,1,0,1,271
020041908,241,18,4,1,1,0,11,276
020041909,307,21,0,2,3,0,6,339
020041910,257,23,2,1,1,0,6,290
020042001,272,20,5,0,5,0,19,321
020042002,244,28,3,1,0,0,10,286
020042003,254,16,7,1,0,1,6,285
020042004,219,8,6,0,0,0,6,239
020042005,210,6,29,0,0,0,5,250
020042006,301,19,4,0,0,1,7,332
020042007,281,17,7,0,7,0,12,324
020042008,241,13,7,1,1,1,2,266
020042009,283,24,0,0,1,0,12,320
020042010,341,15,4,0,6,0,24,390
020042011,317,15,25,0,0,0,19,376
020042012,457,50,23,0,0,0,18,548
020042101,237,11,5,0,3,0,3,259
020042102,241,14,7,0,1,0,10,273
020042103,196,17,1,1,0,0,17,232
020042104,235,13,1,0,4,0,4,257
020042105,236,26,5,1,1,0,2,271
020042106,262,12,9,0,0,0,26,309
020042107,246,22,6,1,0,0,7,282
020042108,290,4,1,0,0,0,5,300
020042109,234,9,1,0,0,0,6,250
020042110,225,2,1,0,1,0,1,230
020042111,254,9,4,0,0,0,20,287
020042112,185,7,0,0,2,0,7,201
020042201,246,30,9,2,3,0,27,317
020042202,289,46,7,2,0,1,5,350
020042203,346,32,11,0,4,0,16,409
020042204,486,62,4,0,0,2,12,566
020042205,265,40,4,0,13,0,9,331
020042206,254,23,2,0,1,1,12,293
020042207,378,64,14,0,3,2,22,483
020042208,348,50,5,6,5,0,12,426
020042209,239,13,9,1,4,0,2,268
020042210,226,30,13,1,14,0,10,294
020042211,254,17,40,9,8,0,25,353
020042212,196,38,4,2,4,1,10,255
020042301,261,15,2,0,0,0,17,295
020042302,275,22,11,2,5,0,24,339
020042303,243,35,13,0,2,1,6,300
020042304,258,14,11,2,6,2,19,312
020042305,212,4,4,1,2,0,21,244
020042306,299,69,13,1,9,1,20,412
020042307,225,25,7,0,4,0,5,266
020042308,286,37,11,1,4,0,7,346
020042309,121,3,1,1,0,0,2,128
020042310,226,19,1,1,0,0,6,253
020042311,181,12,1,0,0,0,3,197
020042312,201,9,0,2,0,0,12,224
020042401,371,1,0,0,1,0,2,375
020042402,493,14,4,4,1,1,16,533
020042403,305,5,2,1,1,1,14,329
020042404,467,4,0,0,0,0,11,482
020042405,189,3,0,1,0,0,13,206
020042406,340,2,0,0,0,0,4,346
020042501,580,16,2,6,0,0,4,608
020042502,474,0,1,0,0,0,10,485
020042503,804,18,1,2,0,0,16,841
020042504,440,9,1,0,0,0,5,455
020042601,117,6,0,5,0,0,3,131
020042602,245,6,0,0,0,0,1,252
020042603,189,16,0,1,0,0,4,210
020050101,250,41,15,1,9,0,3,319
020050102,370,67,16,1,3,2,16,475
020050103,325,38,26,1,5,2,50,447
020050104,307,47,16,2,11,1,12,396
020050105,448,64,108,0,7,6,11,644
020050106,205,75,0,0,4,0,21,305
020050107,302,46,7,0,9,3,9,376
020050108,316,26,12,0,5,0,14,373
020050109,344,58,12,0,3,2,9,428
020050110,300,43,13,1,1,4,19,381
020050201,320,56,28,0,12,4,11,431
020050202,262,22,21,0,8,1,19,333
020050203,297,75,15,1,4,3,14,409
020050204,427,82,28,3,1,1,23,565
020050205,220,47,0,1,8,3,7,286
020050206,225,50,8,1,9,0,7,300
020050207,240,15,13,1,18,1,10,298
020050208,431,92,25,0,21,3,41,613
020050209,324,26,13,4,5,0,29,401
020050210,291,46,4,0,5,0,13,359
020050211,383,1,26,0,29,6,41,486
020050301,313,31,6,7,17,3,21,398
020050302,479,83,50,3,16,3,37,671
020050303,138,8,3,0,0,0,7,156
020050304,227,35,5,1,3,3,18,292
020050305,318,28,28,3,5,4,13,399
020050306,297,24,2,2,3,3,34,365
020050307,293,48,21,3,10,0,39,414
020050308,162,17,21,1,3,5,11,220
020050309,303,40,16,0,15,2,25,401
020050310,225,29,3,2,5,1,19,284
020050311,383,73,23,0,3,4,21,507
020050401,409,42,12,0,11,5,15,494
020050402,342,60,28,0,17,2,8,457
020050403,283,54,19,2,1,2,7,368
020050404,275,50,18,2,7,1,18,371
020050405,330,35,22,0,8,0,13,408
020050406,501,89,18,1,25,6,18,658
020050407,250,32,8,0,9,3,20,322
020050408,495,58,23,0,1,3,17,597
020050409,330,64,13,1,11,3,17,439
020050501,335,46,15,1,5,4,8,414
020050502,563,70,18,1,26,1,36,715
020050503,350,48,11,1,13,1,15,439
020050504,287,41,20,2,8,1,26,385
020050505,240,42,9,0,6,2,8,307
020050506,313,47,13,0,5,2,12,392
020050507,419,54,16,1,8,0,8,506
020050508,322,35,20,4,20,2,24,427
020050601,301,24,11,1,6,0,18,361
020050602,405,36,18,0,16,0,32,507
020050603,435,37,27,3,23,2,26,553
020050604,647,104,24,2,16,2,29,824
020050605,542,69,29,1,23,6,22,692
020050606,364,53,22,4,14,1,15,473
020050607,394,104,13,0,2,1,21,535
020050608,376,76,22,1,13,0,3,491
020050701,514,61,14,2,15,0,51,657
020050702,208,13,4,2,2,0,8,237
020050703,269,33,22,0,6,2,11,343
020050704,591,74,26,0,4,7,34,736
020050705,598,112,46,4,14,3,45,822
020050706,291,40,12,0,5,0,12,360
020050707,196,5,23,2,13,1,20,260
020050708,370,53,14,1,7,0,28,473
020050801,545,63,15,0,9,2,22,656
020050802,317,32,9,0,52,1,25,436
020050803,493,63,14,1,33,7,23,634
020050804,446,41,22,0,20,1,19,549
020050805,172,39,1,0,6,0,2,220
020050806,385,55,10,0,7,3,12,472
020050807,393,67,13,4,4,2,12,495
020050808,348,43,16,3,5,0,33,448
020050809,326,35,12,3,5,2,17,400
020050901,451,66,10,1,10,1,29,568
020050902,275,22,17,2,25,2,23,366
020050903,265,38,12,0,12,0,14,341
020050904,231,35,5,0,9,0,17,297
020050905,257,41,24,0,2,0,11,335
020050906,240,50,10,1,4,1,5,311
020050907,218,38,23,2,11,2,13,307
020050908,453,41,36,3,7,2,7,549
020050909,424,69,14,0,5,0,12,524
020050910,333,40,4,0,1,0,12,390
020051001,521,71,18,0,0,2,24,636
020051002,530,77,18,1,32,0,36,694
020051003,154,15,6,0,1,1,12,189
020051004,242,21,4,0,1,2,20,290
020051005,264,37,19,1,9,5,24,359
020051006,305,25,6,0,0,1,12,349
020051007,538,73,7,1,11,2,22,654
020051008,297,47,15,0,3,5,25,392
020051009,316,56,14,2,13,2,23,426
020051010,252,36,8,0,13,1,19,329
020051101,514,81,22,5,11,1,45,679
020051102,377,46,9,5,6,1,19,463
020051103,272,35,4,0,2,1,9,323
020051104,317,44,35,5,11,3,27,442
020051105,296,42,6,0,8,1,84,437
020051106,310,78,8,1,6,4,21,428
020051107,453,63,19,1,4,2,18,560
020051108,316,62,18,1,7,2,14,420
020051109,451,75,21,1,4,2,15,569
020051110,347,31,9,0,1,1,5,394
020051201,250,35,26,0,2,0,10,323
020051202,823,100,43,0,18,5,49,1038
020051203,405,61,27,0,17,1,13,524
020051204,307,57,21,2,5,0,15,407
020051205,187,53,2,2,15,4,14,277
020051206,727,69,27,0,13,1,70,907
020051207,324,42,9,0,3,0,6,384
020051301,392,51,21,0,37,3,10,514
020051302,319,8,56,1,22,2,22,430
020051303,348,14,13,0,33,0,36,444
020051304,276,49,4,1,11,2,21,364
020051305,302,59,1,1,2,0,18,383
020051306,363,39,20,0,9,1,22,454
020051307,316,16,27,0,17,18,24,418
020051308,417,42,14,0,16,1,31,521
020051309,412,72,19,4,12,0,17,536
020051401,268,23,15,0,3,1,13,323
020051402,342,61,13,0,52,3,13,484
020051403,532,78,40,1,14,6,25,696
020051404,415,49,7,2,5,1,27,506
020051405,697,106,30,1,16,4,32,886
020051406,512,75,14,1,5,3,38,648
020051407,165,27,2,0,4,0,5,203
020051408,267,23,5,0,1,3,10,309
020051409,358,43,48,0,9,2,10,470
020051501,488,75,12,0,8,4,8,595
020051502,507,66,15,1,10,0,32,631
020051503,238,16,8,0,8,3,11,284
020051504,548,30,32,3,4,4,26,647
020051505,450,58,10,1,9,3,16,547
020051506,275,40,8,0,3,0,15,341
020051507,285,36,10,1,3,2,22,359
020051508,212,36,10,2,15,0,10,285
020051509,161,23,1,0,2,0,26,213
020051601,333,51,20,1,9,0,14,428
020051602,273,39,3,0,4,2,6,327
020051603,205,18,2,0,3,1,15,244
020051604,372,45,4,6,3,0,21,451
020051605,357,40,13,1,1,2,52,466
020051606,292,25,25,2,3,1,12,360
020051607,231,25,6,2,3,0,6,273
020051608,370,16,25,3,10,0,8,432
020051609,377,52,4,0,7,3,11,454
020051610,384,32,31,1,9,9,20,486
020051611,400,47,6,1,7,0,25,486
020051701,282,46,5,9,2,0,12,356
020051702,345,52,8,2,7,0,14,428
020051703,273,27,13,0,6,2,10,331
020051704,285,38,1,1,3,0,14,342
020051705,306,45,17,1,5,1,14,389
020051706,325,57,14,1,3,1,34,435
020051707,325,34,3,0,2,1,13,378
020051708,334,51,20,0,7,0,15,427
020051709,247,34,12,2,3,2,9,309
020051710,272,47,7,0,3,0,21,350
020051711,389,31,39,1,7,0,35,502
020051801,404,44,34,3,13,3,26,527
020051802,319,19,22,1,2,3,16,382
020051803,337,27,5,0,6,0,37,412
020051804,254,21,7,0,4,0,7,293
020051805,328,49,17,2,8,0,13,417
020051806,239,19,3,1,3,0,7,272
020051807,304,39,8,2,8,1,8,370
020051808,147,24,2,0,1,0,7,181
020051809,266,28,8,1,0,0,8,311
020051810,321,54,10,2,2,0,17,406
020051811,304,71,8,1,3,0,17,404
020051901,335,38,13,1,2,1,15,405
020051902,275,28,15,0,4,2,21,345
020051903,395,45,23,0,6,9,24,502
020051904,387,27,23,0,9,0,30,476
020051905,320,50,15,4,9,0,17,415
020051906,321,24,20,2,1,1,12,381
020051907,195,29,38,1,2,0,15,280
020051908,406,39,17,3,3,1,15,484
020051909,291,42,12,0,5,1,21,372
020051910,351,47,23,4,15,7,26,473
020051911,326,41,16,0,2,3,14,402
020052001,308,56,18,3,5,1,26,417
020052002,399,33,26,1,9,2,27,497
020052003,360,26,4,2,1,1,4,398
020052004,306,28,20,0,2,1,16,373
020052005,320,37,8,2,2,1,22,392
020052006,274,13,14,2,6,1,11,321
020052007,279,41,3,1,7,0,10,341
020052008,265,33,11,3,2,0,19,333
020052009,305,23,1,4,3,0,19,355
020052010,376,44,7,3,7,2,18,457
020052011,272,20,4,1,1,0,22,320
020052012,238,24,51,1,1,1,5,321
020052101,372,69,25,5,7,0,34,512
020052102,338,30,18,2,9,0,10,407
020052103,208,9,17,2,5,4,26,271
020052104,335,59,33,1,16,1,7,452
020052105,264,44,5,0,2,1,21,337
020052106,324,45,69,5,5,3,16,467
020052107,241,18,8,2,8,2,28,307
020052108,240,29,1,2,0,0,14,286
020052109,231,26,2,3,0,1,14,277
020052110,228,38,6,0,9,0,5,286
020052111,241,36,10,0,6,0,6,299
020052201,248,42,6,1,1,1,10,309
020052202,284,32,11,1,18,0,12,358
020052203,232,49,12,3,2,1,11,310
020052204,351,28,13,2,8,0,33,435
020052205,274,20,2,2,6,3,15,322
020052206,276,7,1,2,1,2,17,306
020052207,711,114,19,2,1,1,43,891
020052208,210,13,0,2,7,0,10,242
020052209,264,29,7,1,2,0,15,318
020052210,266,19,2,3,2,0,13,305
020052211,293,24,7,3,3,0,11,341
020052212,278,20,3,2,7,1,12,323
020052213,211,24,18,0,5,0,5,263
020060101,202,35,6,2,0,0,8,253
020060102,305,36,9,0,5,1,30,386
020060103,337,30,25,3,6,0,27,428
020060104,267,31,23,4,0,1,5,331
020060105,422,33,67,0,8,1,18,549
020060106,340,49,17,4,7,2,8,427
020060107,244,29,6,0,3,1,18,301
020060108,307,26,17,2,6,0,10,368
020060109,199,10,0,2,1,0,17,229
020060110,142,22,4,2,0,0,8,178
020060111,245,44,7,2,3,0,15,316
020060112,248,40,17,1,3,2,14,325
020060201,373,39,9,4,3,1,20,449
020060202,326,23,1,4,3,2,18,377
020060203,232,32,1,0,7,0,8,280
020060204,244,8,1,3,2,0,25,283
020060205,220,20,2,0,2,0,11,255
020060206,329,31,2,2,13,1,12,390
020060207,345,36,15,2,5,1,13,417
020060208,354,54,13,2,6,3,13,445
020060209,250,26,7,2,2,0,8,295
020060210,319,25,3,2,3,0,12,364
020060211,415,65,67,0,9,0,14,570
020060301,348,60,5,1,4,0,27,445
020060302,297,68,2,0,7,1,11,386
020060303,315,53,42,0,15,1,21,447
020060304,243,38,1,0,3,0,8,293
020060305,256,15,14,0,5,1,18,309
020060306,347,31,29,0,9,2,15,433
020060307,360,58,5,0,4,0,12,439
020060308,297,45,6,1,4,0,14,367
020060309,426,51,12,1,5,0,15,510
020060310,383,55,17,0,6,2,10,473
020060401,199,17,4,2,0,0,23,245
020060402,223,37,3,0,2,0,7,272
020060403,328,30,12,0,4,0,20,394
020060404,312,71,22,3,4,0,5,417
020060405,285,37,8,0,1,1,9,341
020060406,308,34,37,2,4,0,15,400
020060407,234,33,11,0,1,0,25,304
020060408,354,84,14,5,10,2,10,479
020060409,313,43,4,2,5,0,12,379
020060410,336,56,19,0,2,0,13,426
020060411,342,41,14,0,6,1,15,419
020060501,375,55,12,2,7,0,24,475
020060502,449,56,30,1,5,5,143,689
020060503,366,61,31,3,10,1,4,476
020060504,291,18,13,1,4,1,20,348
020060505,375,59,8,1,17,0,11,471
020060506,300,45,4,1,5,2,22,379
020060507,303,63,3,3,9,0,22,403
020060508,203,16,42,1,6,2,9,279
020060509,236,25,28,0,2,0,9,300
020060510,383,74,6,3,2,4,23,495
020060511,403,58,13,0,4,0,7,485
020060512,158,4,1,1,2,0,14,180
020060601,537,87,19,0,9,2,18,672
020060602,781,96,15,0,3,1,43,939
020060603,502,67,14,1,5,2,38,629
020060604,225,31,13,5,9,1,17,301
020060605,199,35,7,1,1,2,12,257
020060606,329,75,12,0,7,0,14,437
020060607,348,45,23,3,4,1,14,438
020060608,405,59,15,2,7,1,16,505
020060609,352,60,13,0,6,0,7,438
020060701,280,39,5,0,2,2,4,332
020060702,335,58,15,3,9,1,9,430
020060703,277,39,8,0,5,1,5,335
020060704,359,25,20,2,0,1,12,419
020060705,357,23,20,0,6,0,36,442
020060706,256,27,12,1,14,3,12,325
020060707,390,66,6,0,6,3,20,491
020060708,285,37,6,2,7,3,8,348
020060709,317,50,15,0,0,0,23,405
020060710,312,46,14,1,11,0,8,392
020060711,259,32,5,0,4,0,11,311
020060712,260,45,14,1,2,2,8,332
020060713,231,30,7,3,1,2,15,289
020060801,352,55,19,3,5,1,8,443
020060802,447,36,33,0,6,3,16,541
020060803,234,28,10,5,2,3,9,291
020060804,288,35,9,1,7,1,10,351
020060805,226,50,17,2,3,4,8,310
020060806,500,65,14,0,1,0,27,607
020060807,304,39,7,0,8,1,16,375
020060808,391,48,20,2,10,1,45,517
020060809,253,32,6,0,1,0,21,313
020060810,325,44,25,0,2,1,12,409
020060901,295,28,16,3,11,3,9,365
020060902,258,28,5,0,0,2,13,306
020060903,278,44,27,3,4,3,19,378
020060904,427,62,26,3,66,4,18,606
020060905,168,12,5,1,1,1,23,211
020060906,377,48,46,1,9,0,24,505
020060907,246,23,5,0,3,0,10,287
020060908,193,25,4,0,4,0,6,232
020060909,360,21,20,0,9,3,30,443
020060910,319,35,9,0,4,1,23,391
020061001,299,42,23,0,7,0,19,390
020061002,285,61,17,0,4,5,10,382
020061003,376,52,4,0,3,0,29,464
020061004,325,39,22,0,5,1,22,414
020061005,450,53,15,1,22,2,22,565
020061006,449,95,7,1,12,1,26,591
020061007,307,93,43,2,19,1,12,477
020061008,553,84,19,3,39,5,23,726
020061009,245,26,15,2,8,2,25,323
020061010,457,71,35,2,17,1,33,616
020061101,421,11,23,1,6,2,13,477
020061102,234,14,8,2,2,0,35,295
020061103,365,47,27,1,1,0,8,449
020061104,341,43,13,0,3,0,8,408
020061105,247,37,1,3,1,3,23,315
020061106,299,41,1,1,5,0,36,383
020061107,325,28,13,0,1,0,38,405
020061108,364,29,12,1,6,2,46,460
020061109,275,26,10,0,2,1,15,329
020061110,227,63,5,0,0,0,2,297
020061201,256,56,0,0,2,0,12,326
020061202,203,34,5,0,4,0,9,255
020061203,279,48,21,2,8,4,10,372
020061204,191,37,23,1,6,3,6,267
020061205,382,58,17,3,7,0,35,502
020061206,241,33,6,0,4,2,15,301
020061207,337,74,14,2,51,0,16,494
020061208,301,64,17,2,10,1,12,407
020061209,348,59,28,2,4,2,18,461
020061210,235,41,4,0,7,0,24,311
020061211,365,63,20,0,12,2,40,502
020061212,201,31,7,1,6,1,7,254
020061301,303,61,34,1,2,0,17,418
020061302,584,69,13,1,8,2,25,702
020061303,293,32,18,1,9,1,10,364
020061304,456,42,41,1,10,2,24,576
020061305,354,83,11,55,7,0,15,525
020061306,266,24,35,0,3,0,36,364
020061307,363,60,21,0,4,1,13,462
020061308,469,58,55,5,16,3,32,638
020061309,409,66,35,2,14,3,23,552
020061401,377,27,23,3,16,0,27,473
020061402,249,50,7,5,5,0,4,320
020061403,375,41,8,0,33,2,34,493
020061404,525,91,11,1,18,17,36,699
020061405,401,67,17,1,7,2,21,516
020061406,483,79,29,4,6,1,16,618
020061407,232,11,6,0,2,0,26,277
020061408,216,37,12,2,2,1,4,274
020061409,305,89,7,4,2,1,3,411
020061410,386,100,65,2,7,2,14,576
020061501,282,51,8,2,30,1,10,384
020061502,751,103,34,0,39,3,53,983
020061503,356,50,18,1,5,0,21,451
020061504,266,47,12,1,4,1,16,347
020061505,320,50,7,8,14,0,18,417
020061506,279,26,6,7,9,6,18,351
020061507,330,30,23,5,5,2,24,419
020061508,439,51,31,1,3,1,34,560
020061509,224,45,5,2,3,0,16,295
020061510,299,56,6,1,5,1,7,375
020061601,281,23,5,0,1,1,10,321
020061602,276,48,13,0,4,0,6,347
020061603,384,66,36,5,6,1,22,520
020061604,303,44,11,1,6,1,27,393
020061605,359,74,4,2,6,0,18,463
020061606,411,68,12,2,2,8,10,513
020061607,381,59,30,5,9,0,13,497
020061608,507,61,28,6,7,4,40,653
020061609,409,63,25,8,3,1,16,525
020061610,489,77,11,2,6,0,27,612
020061611,384,55,26,2,8,2,22,499
020061701,416,16,35,0,64,8,51,590
020061702,417,81,25,0,35,4,24,586
020061703,304,33,40,5,60,5,15,462
020061704,355,41,10,0,6,3,24,439
020061705,800,94,43,2,22,6,95,1062
020061706,507,56,32,3,12,4,35,649
020061707,273,23,27,1,12,8,15,359
020061801,259,29,7,0,19,3,29,346
020061802,242,33,11,0,12,0,10,308
020061803,252,46,18,0,21,0,19,356
020061804,306,35,7,3,54,1,15,421
020061805,380,44,20,1,29,1,31,506
020061806,425,53,15,1,17,1,14,526
020061807,495,53,19,1,23,1,30,622
020061808,504,82,22,1,35,3,37,684
020061809,392,41,18,2,18,0,16,487
020061901,381,55,12,5,7,3,11,474
020061902,632,73,25,0,14,4,58,806
020061903,597,60,31,2,42,2,34,768
020061904,432,48,15,0,35,6,21,557
020061905,303,39,21,0,3,0,20,386
020061906,432,78,12,0,6,1,17,546
020061907,440,51,6,0,1,1,14,513
020061908,422,15,5,0,4,4,93,543
020062001,208,28,9,0,3,1,24,273
020062002,253,54,16,1,4,2,14,344
020062003,444,67,104,1,10,1,23,650
020062004,255,36,25,0,7,1,19,343
020062005,375,65,22,2,32,10,22,528
020062006,358,87,17,0,4,0,18,484
020062007,254,34,6,0,3,0,18,315
020062008,475,60,8,3,8,1,20,575
020062009,315,42,11,0,0,1,2,371
020062010,379,66,9,0,6,0,25,485
020062101,289,69,7,1,2,1,16,385
020062102,450,62,8,2,10,1,23,556
020062103,446,63,23,3,8,2,19,564
020062104,260,42,24,2,2,6,17,353
020062105,325,43,20,2,2,1,18,411
020062106,229,29,4,0,6,3,21,292
020062107,369,37,11,0,12,1,13,443
020062108,454,64,6,4,10,2,32,572
020062109,289,53,7,4,3,0,8,364
020062110,362,33,50,2,14,2,7,470
020062111,378,61,9,0,5,2,16,471
020070101,197,30,15,1,11,2,9,265
020070102,284,14,4,0,2,0,17,321
020070103,302,48,14,2,2,0,27,395
020070104,236,27,7,1,21,0,17,309
020070105,162,28,15,0,11,1,17,234
020070106,217,22,7,6,16,1,18,287
020070107,169,9,18,2,9,0,35,242
020070108,298,52,17,0,19,5,15,406
020070109,267,35,4,0,4,2,11,323
020070110,365,68,15,0,9,0,24,481
020070201,274,23,11,4,4,1,26,343
020070202,355,22,16,6,5,2,22,428
020070203,288,32,8,0,9,1,8,346
020070204,592,49,3,3,0,0,59,706
020070205,351,37,42,4,6,0,14,454
020070206,374,35,25,4,18,1,33,490
020070207,239,20,8,0,2,0,13,282
020070208,292,21,15,1,2,0,11,342
020070209,382,43,8,2,2,0,10,447
020070301,296,33,11,1,9,0,21,371
020070302,342,58,7,4,7,0,24,442
020070303,458,43,44,1,6,1,26,579
020070304,345,29,5,4,2,0,8,393
020070305,303,39,11,2,3,0,32,390
020070306,311,34,8,3,2,1,10,369
020070307,438,42,14,1,2,2,2,501
020070308,295,44,9,0,0,0,13,361
020070309,268,26,19,1,5,0,4,323
020070310,419,70,12,3,9,2,11,526
020070401,513,60,22,0,26,0,30,651
020070402,304,52,8,0,0,0,17,381
020070403,401,98,10,1,8,3,28,549
020070404,525,46,70,2,15,2,23,683
020070405,278,112,9,5,60,9,16,489
020070406,286,85,8,1,1,5,53,439
020070407,345,76,40,2,10,16,12,501
020070408,267,46,5,5,3,1,11,338
020070409,210,21,8,1,3,0,21,264
020070410,359,56,38,0,13,2,15,483
020070501,332,24,10,30,17,1,30,444
020070502,218,35,17,3,20,3,15,311
020070503,299,61,26,41,14,0,12,453
020070504,452,67,23,2,52,4,14,614
020070505,451,51,15,2,4,0,21,544
020070506,267,34,7,1,2,0,12,323
020070507,264,24,4,2,7,1,9,311
020070508,337,26,18,22,1,2,9,415
020070509,430,36,4,2,9,1,10,492
020070601,370,53,3,0,7,2,21,456
020070602,240,34,8,0,1,1,14,298
020070603,232,23,10,1,1,0,16,283
020070604,274,20,5,1,8,2,19,329
020070605,410,34,21,2,0,1,24,492
020070606,346,55,6,1,3,0,24,435
020070607,377,49,17,1,43,1,11,499
020070608,183,21,8,0,4,0,6,222
020070609,270,21,19,0,21,1,19,351
020070701,244,41,11,1,13,0,3,313
020070702,196,18,15,0,1,1,6,237
020070703,408,21,18,1,2,0,14,464
020070704,234,29,10,1,3,0,8,285
020070705,260,7,0,0,4,0,20,291
020070706,353,63,11,0,7,3,13,450
020070707,216,23,0,0,15,0,21,275
020070708,217,17,13,5,0,0,30,282
020070709,377,96,12,2,17,1,16,521
020070710,349,33,38,1,1,0,8,430
020070711,280,36,22,2,6,1,7,354
020070801,302,38,20,2,25,2,14,403
020070802,339,63,29,0,9,0,16,456
020070803,246,28,10,1,5,0,20,310
020070804,347,49,35,4,6,1,15,457
020070805,363,50,29,6,7,0,15,470
020070806,364,33,31,2,8,1,27,466
020070807,314,47,12,2,5,0,10,390
020070808,354,61,45,2,3,3,32,500
020070901,247,31,4,0,2,0,8,292
020070902,273,18,9,0,8,1,35,344
020070903,223,27,14,0,4,1,6,275
020070904,328,72,26,1,12,5,34,478
020070905,196,27,47,1,5,2,13,291
020070906,348,44,14,1,14,3,21,445
020070907,321,60,9,0,4,1,17,412
020070908,377,37,18,0,12,4,21,469
020070909,278,26,8,1,11,1,36,361
020070910,301,44,15,1,2,3,20,386
020070911,224,38,9,1,3,0,17,292
020071001,301,35,32,0,7,3,18,396
020071002,178,27,16,1,11,1,5,239
020071003,252,34,13,0,4,0,17,320
020071004,289,27,15,0,4,1,11,347
020071005,239,31,5,0,4,0,11,290
020071006,347,46,23,1,13,2,27,459
020071007,335,72,3,1,14,0,23,448
020071008,423,79,31,1,3,0,29,566
020071009,299,37,13,1,10,0,24,384
020071010,317,45,9,7,6,1,7,392
020071101,304,58,21,0,25,0,21,429
020071102,399,53,10,0,40,1,31,534
020071103,361,48,17,1,15,2,15,459
020071104,375,44,30,3,16,0,16,484
020071105,225,37,9,1,3,0,6,281
020071106,266,23,48,1,6,0,15,359
020071107,489,62,20,2,4,1,21,599
020071108,444,55,109,2,3,2,23,638
020071109,363,30,25,2,9,2,10,441
020071110,241,24,11,0,3,1,5,285
020071201,417,35,13,10,7,0,28,510
020071202,213,28,6,1,10,0,8,266
020071203,274,13,6,2,4,0,6,305
020071204,312,18,7,0,1,1,8,347
020071205,292,25,3,3,1,3,6,333
020071206,295,42,9,0,5,1,24,376
020071207,211,16,10,2,3,0,9,251
020071208,200,22,12,1,4,0,2,241
020071209,282,22,8,0,2,0,13,327
020071301,313,34,9,0,2,3,12,373
020071302,290,39,19,4,7,2,15,376
020071303,390,66,60,1,4,3,15,539
020071304,213,33,5,1,0,0,12,264
020071305,326,47,9,3,3,1,10,399
020071306,260,21,5,3,3,1,6,299
020071307,196,32,6,1,9,0,12,256
020071308,187,48,9,1,5,1,6,257
020071309,161,17,2,1,0,0,5,186
020071310,192,26,1,3,0,0,9,231
020071311,248,13,1,6,1,0,8,277
020071312,210,16,6,4,3,0,5,244
020071313,191,21,3,1,1,0,12,229
020071314,204,20,4,1,2,0,23,254
020071315,182,18,4,1,4,2,4,215
020071401,288,42,3,2,1,0,5,341
020071402,296,24,36,2,4,3,15,380
020071403,236,34,3,2,0,0,15,290
020071404,244,18,5,0,1,1,10,279
020071405,263,28,17,1,3,0,9,321
020071406,342,37,6,1,5,0,8,399
020071407,257,29,17,3,1,0,4,311
020071408,272,26,4,2,2,0,14,320
020071409,270,40,8,6,1,0,4,329
020071410,225,20,2,1,5,1,3,257
020071411,300,25,8,1,3,1,11,349
020071412,307,23,3,6,5,1,13,358
020071413,223,31,10,3,4,0,3,274
020071501,165,17,3,2,0,0,7,194
020071502,253,12,7,2,7,0,21,302
020071503,296,18,3,3,4,0,5,329
020071504,222,24,6,2,6,2,10,272
020071505,223,13,4,2,0,0,13,255
020071506,330,17,6,0,1,1,17,372
020071507,280,36,8,0,0,3,7,334
020071508,233,25,16,0,2,0,16,292
020071509,353,25,2,0,0,0,6,386
020071510,287,14,5,0,5,1,8,320
020071511,316,12,10,4,1,1,10,354
020071601,242,21,1,3,1,0,7,275
020071602,231,15,2,0,2,0,5,255
020071603,229,18,3,1,1,0,4,256
020071604,182,17,4,0,2,0,20,225
020071605,258,28,7,2,7,1,12,315
020071606,303,29,16,2,10,1,16,377
020071607,292,17,7,0,0,2,18,336
020071608,338,15,5,0,1,0,21,380
020071609,297,22,15,2,6,0,9,351
020071701,328,4,0,0,0,0,14,346
020071702,297,5,0,0,1,0,8,311
020071703,207,5,1,0,1,0,1,215
020071704,246,5,0,0,0,0,0,251
020071705,100,1,0,0,0,0,3,104
020071706,352,11,0,0,0,0,1,364
020071707,454,2,1,2,0,0,6,465
020071708,150,3,0,0,0,0,2,155
020071709,329,4,0,0,0,0,8,341
020071710,214,5,0,0,0,0,2,221
020071711,87,0,0,0,0,0,6,93
020071801,342,93,0,0,0,0,2,437
020071802,119,15,0,0,0,0,0,134
020071803,230,1,0,0,0,0,4,235
020071804,119,1,0,0,0,0,4,124
020071805,105,1,0,0,0,0,0,106
020071806,280,10,1,0,0,0,10,301
020071807,255,9,0,0,0,0,3,267
020071808,219,2,0,0,0,0,2,223
020071809,258,10,0,1,0,0,5,274
020071810,332,59,1,0,0,0,1,393
020071811,199,14,0,1,0,0,9,223
020071901,171,6,3,0,14,0,3,197
020071902,258,2,0,1,1,0,5,267
020071903,232,2,2,0,0,0,2,238
020071904,277,8,0,1,0,0,1,287
020071905,295,11,0,2,0,0,2,310
020071906,422,18,3,0,0,0,5,448
020072001,367,29,10,1,9,0,17,433
020072002,184,3,10,3,0,0,13,213
020072003,240,20,10,2,0,4,11,287
020072004,180,21,2,4,1,0,9,217
020072005,263,15,10,3,4,1,6,302
020072006,269,20,5,1,3,0,15,313
020072007,204,18,3,4,3,1,21,254
020072008,417,28,17,3,5,3,22,495
020072009,263,30,1,1,0,0,11,306
020072010,328,20,1,2,2,0,14,367
020072011,309,29,2,0,2,1,21,364
020072012,205,13,8,6,2,1,9,244
020072013,562,28,26,1,0,0,36,653
020072101,396,47,21,0,3,0,10,477
020072102,442,85,19,0,4,0,10,560
020072103,419,55,11,1,3,0,23,512
020072104,237,30,11,0,1,1,8,288
020072105,238,31,6,0,4,0,13,292
020072106,411,40,11,1,7,0,35,505
020072107,296,27,6,0,1,2,29,361
020072108,172,13,3,0,0,0,12,200
020072109,286,45,19,0,1,0,17,368
020072110,351,50,15,0,0,0,27,443
020072111,294,36,12,1,1,1,7,352
020072112,256,27,1,3,0,0,7,294
020072201,285,30,12,0,3,1,16,347
020072202,342,36,44,27,4,0,48,501
020072203,355,31,27,0,3,0,8,424
020072204,370,40,8,1,11,0,18,448
020072205,374,87,19,1,3,1,15,500
020072206,329,47,15,4,9,1,14,419
020072207,213,33,5,3,5,0,8,267
020072208,232,33,1,0,1,0,8,275
020072209,219,22,2,0,3,1,8,255
020072210,260,26,15,2,1,0,8,312
020072211,280,40,3,4,2,2,5,336
020072212,253,19,14,0,3,3,6,298
020072213,283,26,13,2,2,0,17,343
020072301,285,49,2,3,7,0,8,354
020072302,371,44,11,0,5,2,16,449
020072303,314,19,5,2,3,2,34,379
020072304,265,36,7,1,3,2,17,331
020072305,268,15,7,0,1,1,15,307
020072306,273,23,11,4,1,1,33,346
020072307,296,38,8,0,2,2,15,361
020072308,257,33,11,2,10,0,13,326
020072309,268,4,0,1,2,0,10,285
020072401,341,36,7,0,4,0,25,413
020072402,277,19,7,0,11,0,17,331
020072403,346,40,8,3,7,2,11,417
020072404,371,46,14,2,7,4,27,471
020072405,333,18,13,5,5,0,22,396
020072406,354,72,2,1,10,0,17,456
020072407,261,17,5,1,3,0,7,294
020072408,314,23,8,2,3,0,19,369
020072409,325,31,4,5,8,0,10,383
020072410,303,40,10,8,3,0,10,374
020072411,354,24,5,5,6,0,31,425
020080101,260,6,2,0,0,0,3,271
020080102,428,10,4,0,1,1,31,475
020080103,257,2,0,1,0,0,6,266
020080104,399,1,0,0,1,0,2,403
020080105,379,20,0,1,0,0,11,411
020080106,408,0,0,0,0,0,21,429
020080107,360,0,0,0,0,0,0,360
020080108,338,24,2,3,4,0,13,384
020080109,572,12,2,12,4,0,26,628
020080110,392,0,0,0,0,0,4,396
020080111,67,1,0,0,0,0,3,71
020080112,874,7,0,0,1,0,20,902
020080201,367,33,2,0,0,1,8,411
020080202,161,15,2,0,0,0,5,183
020080203,154,18,1,0,0,0,9,182
020080204,243,37,3,0,0,0,9,292
020080205,173,19,1,0,0,0,1,194
020080206,240,11,0,1,0,0,9,261
020080207,396,24,7,0,1,3,25,456
020080208,282,36,2,1,0,0,16,337
020080209,260,17,9,1,1,0,14,302
020080210,175,11,1,0,0,0,4,191
020080301,261,24,6,1,5,1,19,317
020080302,248,21,7,1,2,0,13,292
020080303,172,17,4,0,0,0,9,202
020080304,229,17,2,3,0,1,9,261
020080305,215,20,4,1,4,1,18,263
020080306,120,5,2,0,2,1,7,137
020080307,205,19,2,1,3,2,13,245
020080308,422,12,2,8,0,1,3,448
020080309,365,2,0,1,0,0,5,373
020080310,303,4,0,0,0,0,1,308
020080401,246,19,8,4,7,1,14,299
020080402,173,6,9,4,0,0,26,218
020080403,202,28,5,0,0,0,10,245
020080404,214,24,2,0,3,1,10,254
020080405,309,34,4,2,1,1,8,359
020080406,338,30,16,3,2,1,12,402
020080407,253,15,5,5,4,1,17,300
020080408,265,21,9,5,4,0,13,317
020080409,244,18,7,2,5,1,13,290
020080410,296,16,8,2,2,0,23,347
020080411,226,16,6,4,0,1,6,259
020080501,267,38,6,2,4,0,16,333
020080502,251,25,1,1,0,0,21,299
020080503,245,23,5,3,2,2,10,290
020080504,282,17,7,2,3,0,16,327
020080505,170,18,3,2,0,0,1,194
020080506,262,25,7,4,9,0,11,318
020080507,319,12,10,1,3,0,23,368
020080508,204,21,11,1,3,1,12,253
020080509,268,32,1,0,0,0,12,313
020080510,408,37,4,1,1,0,21,472
020080511,315,36,3,0,0,1,5,360
020080601,298,34,5,0,0,0,12,349
020080602,389,41,1,0,0,1,8,440
020080603,397,30,2,0,0,0,6,435
020080604,183,17,3,3,3,0,16,225
020080605,308,14,1,2,4,1,22,352
020080606,214,24,1,3,1,0,9,252
020080607,196,20,5,1,6,1,17,246
020080608,231,20,4,3,0,1,12,271
020080609,264,24,4,1,0,0,14,307
020080610,189,9,10,6,3,0,24,241
020080611,161,1,0,1,0,0,2,165
020080701,291,6,0,1,3,1,9,311
020080702,368,9,1,1,0,0,4,383
020080703,348,3,0,1,0,0,11,363
020080704,302,0,0,1,0,0,5,308
020080705,453,2,1,0,0,0,8,464
020080706,238,0,0,0,0,0,0,238
020080707,475,13,0,0,0,0,6,494
020080708,374,1,0,0,0,0,6,381
020080709,479,7,0,0,1,0,6,493
020080710,160,0,0,0,0,0,1,161
020080711,321,0,0,0,0,0,3,324
020080712,317,4,0,0,0,0,1,322
020080713,253,0,0,0,0,0,1,254
020080714,235,4,1,0,0,0,19,259
020080801,262,15,5,5,2,1,17,307
020080802,270,8,18,2,4,7,10,319
020080803,217,17,11,5,6,0,8,264
020080804,299,14,21,5,7,5,21,372
020080805,234,26,6,6,1,0,25,298
020080806,299,33,29,2,18,1,32,414
020080807,280,31,2,1,1,0,18,333
020080808,182,18,4,2,3,0,13,222
020080809,195,16,7,5,1,3,16,243
020080810,250,15,10,0,2,1,13,291
020080811,331,34,10,0,0,0,7,382
020080901,259,14,4,6,1,0,17,301
020080902,272,16,12,5,1,1,12,319
020080903,346,34,14,6,5,0,24,429
020080904,161,20,1,3,3,0,5,193
020080905,319,45,26,4,5,1,36,436
020080906,276,11,10,0,0,1,7,305
020080907,243,20,4,2,0,0,28,297
020080908,216,37,15,2,1,0,14,285
020080909,291,9,3,1,2,2,20,328
020081001,242,5,4,2,0,0,4,257
020081002,221,6,1,1,0,0,3,232
020081003,375,43,12,0,0,1,13,444
020081004,699,75,22,1,0,0,33,830
020081005,805,79,13,0,1,1,59,958
020081006,531,66,10,1,4,3,40,655
020081007,533,72,7,1,0,0,31,644
020081008,309,45,3,0,1,0,11,369
020081101,815,41,6,0,1,0,47,910
020081102,671,72,32,1,9,1,31,817
020081103,998,59,15,1,1,2,42,1118
020081104,614,65,10,0,0,1,21,711
020081105,444,25,6,0,0,0,23,498
020081201,293,23,16,4,0,0,18,354
020081202,330,20,10,1,2,0,15,378
020081203,316,29,7,0,0,0,9,361
020081204,226,13,4,2,3,0,22,270
020081205,314,39,12,9,15,1,7,397
020081206,240,8,6,2,5,0,23,284
020081207,241,10,5,2,1,0,13,272
020081301,11,0,0,0,0,0,0,11
020081302,96,4,0,0,0,0,0,100
020081303,248,25,8,2,30,0,27,340
020081304,266,18,10,1,9,1,11,316
020081305,278,15,11,0,7,0,4,315
020081306,194,11,3,0,1,0,14,223
020081307,226,15,4,0,7,0,19,271
020081308,270,8,10,1,5,0,21,315
020081401,318,8,0,0,0,0,3,329
020081402,250,3,0,0,0,0,2,255
020081403,300,22,0,0,0,0,8,330
020081404,610,33,1,4,1,0,20,669
020081405,318,15,2,2,8,0,12,357
020081406,199,2,3,1,3,0,11,219
020081407,271,8,4,0,3,0,14,300
020081408,241,21,4,1,10,0,21,298
020081409,229,15,1,3,1,0,8,257
020081410,233,35,7,3,0,0,9,287
020081501,463,8,0,0,0,0,16,487
020081502,485,6,0,1,0,0,3,495
020081503,123,9,2,2,0,0,11,147
020081504,97,1,0,0,0,0,3,101
020081505,613,10,1,0,0,0,15,639
020081506,182,0,2,1,0,0,3,188
020081507,217,4,0,0,0,0,4,225
020081508,274,9,2,1,0,0,11,297
020081509,260,5,1,0,1,0,5,272
020081510,341,19,2,0,0,0,15,377
020081601,285,13,1,0,0,0,10,309
020081602,165,11,1,1,1,0,6,185
020081603,280,20,4,0,0,0,12,316
020081604,256,21,0,0,0,0,32,309
020081605,268,55,6,0,1,0,18,348
020081606,255,7,1,0,0,0,8,271
020081607,256,23,0,0,0,0,8,287
020081608,204,23,0,0,0,0,8,235
020081609,268,41,3,0,0,0,6,318
020081610,248,20,0,0,0,0,4,272
020081701,196,19,21,0,4,0,10,250
020081702,221,24,5,1,0,0,14,265
020081703,313,52,25,0,0,2,27,419
020081704,288,19,10,1,0,0,6,324
020081705,170,41,5,2,0,0,28,246
020090101,204,26,1,2,0,0,5,238
020090102,180,12,4,0,0,1,14,211
020090103,247,39,32,1,6,1,7,333
020090104,253,30,16,0,6,0,21,326
020090105,278,35,16,1,5,1,28,364
020090106,238,32,7,1,6,0,9,293
020090107,249,43,0,1,8,1,12,314
020090108,260,43,10,6,9,1,17,346
020090109,341,70,12,1,35,0,28,487
020090201,346,53,35,2,17,0,21,474
020090202,294,33,20,4,3,1,20,375
020090203,321,29,32,7,3,0,42,434
020090204,413,52,22,1,36,0,21,545
020090205,402,65,6,3,12,3,36,527
020090206,244,37,13,2,1,0,4,301
020090207,294,56,5,1,3,1,19,379
020090208,239,30,3,5,8,1,17,303
020090209,353,41,15,9,1,3,20,442
020090210,293,41,26,8,5,1,15,389
020090211,337,39,24,2,4,0,19,425
020090212,217,30,9,3,7,1,21,288
020090301,245,25,33,5,45,0,23,376
020090302,243,42,14,2,19,0,13,333
020090303,224,28,15,1,16,0,29,313
020090304,232,30,7,1,23,1,29,323
020090305,255,53,42,0,37,0,17,404
020090306,292,28,44,2,11,1,34,412
020090307,305,43,16,5,8,1,12,390
020090308,267,15,3,5,5,0,19,314
020090309,246,34,2,1,2,0,4,289
020090310,272,25,11,1,3,2,18,332
020090311,275,24,11,0,2,1,14,327
020090312,188,13,4,2,1,0,16,224
020090313,255,57,5,2,5,2,7,333
020090401,336,26,10,3,1,0,22,398
020090402,304,24,9,1,4,1,29,372
020090403,335,34,4,6,4,1,21,405
020090404,316,30,9,2,0,1,20,378
020090405,302,46,4,5,2,0,11,370
020090406,241,5,6,5,2,0,16,275
020090407,255,22,9,4,14,1,16,321
020090408,254,13,5,1,8,2,14,297
020090409,243,22,4,3,1,0,12,285
020090410,235,30,14,4,8,1,16,308
020090411,330,30,15,5,5,2,16,403
020090501,291,30,3,3,1,0,3,331
020090502,298,65,13,1,0,0,4,381
020090503,254,34,9,2,6,0,6,311
020090504,290,33,13,4,4,0,33,377
020090505,374,35,15,3,12,1,24,464
020090506,304,20,19,0,1,0,18,362
020090507,302,33,16,11,2,0,18,382
020090508,270,22,4,1,2,0,25,324
020090509,324,37,11,3,1,1,31,408
020090510,310,26,21,1,3,0,8,369
020090511,292,33,17,6,3,1,28,380
020090601,397,53,10,2,4,0,16,482
020090602,250,26,10,4,3,0,18,311
020090603,364,33,11,2,12,0,20,442
020090604,337,44,13,1,5,4,20,424
020090605,372,30,10,6,4,0,22,444
020090606,250,14,1,1,0,0,22,288
020090607,364,43,8,2,6,0,27,450
020090608,273,31,15,2,8,0,20,349
020090609,359,51,26,0,0,0,16,452
020090610,316,13,11,8,3,1,28,380
020090611,274,12,0,2,0,0,14,302
020090612,266,24,13,0,3,0,18,324
020090701,261,26,10,4,3,0,8,312
020090702,296,40,9,3,2,0,9,359
020090703,213,15,9,4,4,1,10,256
020090704,237,14,14,4,5,0,11,285
020090705,252,11,10,1,7,1,16,298
020090706,270,37,5,6,2,0,18,338
020090707,219,36,4,4,1,0,7,271
020090708,269,26,6,0,3,0,9,313
020090709,295,28,9,1,0,1,5,339
020090710,234,14,2,4,5,2,9,270
020090711,271,24,5,5,5,0,14,324
020090712,299,69,2,0,0,0,1,371
020090713,314,34,11,0,6,0,9,374
020090714,283,26,11,1,3,0,11,335
020090801,264,15,9,3,10,0,34,335
020090802,277,36,16,7,6,1,32,375
020090803,282,34,9,3,2,3,20,353
020090804,280,31,3,4,15,2,12,347
020090805,323,43,13,1,3,0,12,395
020090806,343,35,9,2,8,0,7,404
020090807,300,37,7,3,5,0,7,359
020090808,321,39,5,1,6,0,15,387
020090809,232,17,5,3,5,0,14,276
020090810,298,22,13,4,15,2,6,360
020090811,289,45,4,6,3,1,19,367
020090812,315,38,9,2,8,0,29,401
020090813,198,13,4,3,2,1,11,232
020090901,261,22,15,0,3,2,14,317
020090902,242,17,8,1,1,0,10,279
020090903,373,55,13,1,7,1,27,477
020090904,186,21,2,1,6,1,14,231
020090905,244,17,5,1,1,0,13,281
020090906,296,11,8,0,0,0,17,332
020090907,294,57,5,1,11,2,18,388
020090908,179,23,4,0,5,0,7,218
020090909,240,28,1,0,1,0,4,274
020090910,270,11,5,3,7,0,17,313
020090911,247,24,3,2,3,1,13,293
020090912,218,25,7,3,9,1,15,278
020090913,195,14,3,0,1,0,1,214
020090914,306,20,7,1,1,1,8,344
020091001,288,17,8,2,6,0,12,333
020091002,318,32,6,2,4,0,15,377
020091003,312,13,7,3,7,3,16,361
020091004,229,29,9,1,6,1,13,288
020091005,333,30,25,1,4,1,12,406
020091006,230,33,9,0,0,0,1,273
020091007,232,19,14,1,3,0,15,284
020091008,313,28,7,0,2,0,16,366
020091009,167,21,5,1,0,0,27,221
020091010,302,30,11,0,1,0,14,358
020091011,240,16,14,0,0,1,14,285
020091012,222,17,13,0,0,0,9,261
020091101,402,21,23,10,9,0,33,498
020091102,344,33,5,5,8,2,13,410
020091103,271,24,0,8,18,3,14,338
020091104,344,30,9,7,5,0,16,411
020091105,369,38,2,1,3,0,21,434
020091106,297,35,16,2,0,0,7,357
020091107,357,31,2,4,2,0,4,400
020091108,275,21,16,1,4,0,5,322
020091109,274,29,10,2,2,0,11,328
020091110,285,28,1,1,2,0,10,327
020091111,304,28,10,1,5,0,21,369
020091112,365,14,12,0,2,0,13,406
020091201,324,25,8,3,5,2,13,380
020091202,168,15,7,4,3,2,9,208
020091203,263,20,4,1,1,1,7,297
020091204,271,28,2,2,0,0,14,317
020091205,255,27,2,0,0,0,4,288
020091206,316,25,7,1,3,1,7,360
020091207,242,25,10,1,3,0,7,288
020091208,312,22,6,1,5,0,9,355
020091209,280,16,7,4,2,0,15,324
020091210,333,17,8,3,0,0,6,367
020091211,293,17,2,1,3,0,17,333
020091212,205,20,3,0,0,0,9,237
020091301,264,29,5,0,1,0,10,309
020091302,375,37,13,4,2,0,21,452
020091303,360,23,5,6,8,0,16,418
020091304,227,30,2,3,2,0,2,266
020091305,288,38,5,0,1,0,8,340
020091306,184,13,2,1,1,0,5,206
020091307,347,17,2,2,3,1,25,397
020091401,341,32,13,7,10,3,21,427
020091402,270,12,4,3,3,0,4,296
020091403,231,3,10,0,1,0,13,258
020091404,184,5,0,3,1,0,4,197
020091405,324,5,1,1,0,0,2,333
020091406,543,7,0,0,0,0,5,555
020091407,253,3,0,0,0,0,6,262
020091408,333,1,1,3,0,0,1,339
020091409,180,4,3,0,0,0,14,201
020091410,400,4,0,0,0,0,2,406
020091501,198,9,12,4,0,0,15,238
020091502,226,16,1,2,9,0,18,272
020091503,267,20,12,1,3,0,9,312
020091504,240,22,7,2,13,1,19,304
020091505,312,38,5,1,6,0,13,375
020091506,304,27,3,0,8,1,16,359
020091507,319,33,6,3,7,2,8,378
020091508,256,11,7,5,1,2,8,290
020091509,257,31,14,4,1,0,11,318
020091510,208,25,4,1,1,1,11,251
020091511,283,16,7,0,3,0,25,334
020091601,282,37,7,6,10,0,16,358
020091602,294,24,10,4,12,0,16,360
020091603,181,18,1,4,3,0,10,217
020091604,225,23,4,0,7,0,16,275
020091605,225,11,2,1,2,0,11,252
020091606,306,25,4,6,7,1,13,362
020091607,309,35,10,2,3,1,10,370
020091608,273,16,6,3,2,0,8,308
020091609,320,31,11,3,8,0,9,382
020091610,285,27,2,0,0,1,7,322
020091611,238,2,9,0,0,0,6,255
020091612,254,16,2,0,0,1,11,284
020091613,284,20,6,1,0,1,17,329
020100101,246,23,11,4,4,0,12,300
020100102,323,15,17,8,15,0,26,404
020100103,334,30,5,2,6,1,19,397
020100104,272,27,6,5,16,0,17,343
020100105,236,21,6,2,0,0,14,279
020100106,257,30,11,1,4,0,12,315
020100107,248,23,7,1,7,1,19,306
020100108,341,46,10,3,23,0,19,442
020100201,320,25,11,1,6,2,37,402
020100202,244,18,6,0,6,0,17,291
020100203,230,16,9,0,6,0,18,279
020100204,293,13,9,1,2,0,20,338
020100205,287,25,12,2,2,5,17,350
020100206,379,47,11,4,6,0,11,458
020100207,331,38,3,4,8,0,11,395
020100208,304,24,4,5,7,0,18,362
020100301,215,26,19,2,0,1,15,278
020100302,281,17,15,5,2,0,20,340
020100303,288,28,5,5,4,0,15,345
020100304,206,17,0,1,4,0,18,246
020100305,261,29,11,3,6,1,11,322
020100306,265,21,21,0,6,0,14,327
020100307,337,36,9,4,11,0,31,428
020100308,334,40,13,14,4,1,27,433
020100401,357,37,5,3,10,0,15,427
020100402,381,49,9,4,3,4,27,477
020100403,291,23,4,2,3,0,16,339
020100404,285,28,9,0,4,0,6,332
020100405,269,29,4,15,4,1,12,334
020100406,218,14,5,3,1,0,12,253
020100407,287,42,7,1,6,0,9,352
020100408,262,43,7,2,3,0,7,324
020100409,265,36,10,4,1,0,39,355
020100501,226,20,7,2,3,0,5,263
020100502,285,35,4,2,1,0,21,348
020100503,343,26,24,4,16,2,10,425
020100504,304,27,13,4,3,1,11,363
020100505,291,17,17,2,6,0,12,345
020100506,319,39,22,3,13,0,3,399
020100507,301,33,15,2,4,0,10,365
020100508,350,26,9,2,1,1,18,407
020100509,250,40,16,0,2,0,5,313
020100510,257,16,12,11,11,0,19,326
020100511,242,32,4,5,4,3,6,296
020100512,254,18,10,6,5,0,12,305
020100513,278,27,5,4,9,0,10,333
020100514,260,47,9,2,4,1,9,332
020100601,223,22,5,2,1,2,15,270
020100602,236,40,8,5,3,0,7,299
020100603,372,22,14,4,3,1,13,429
020100604,312,45,9,3,3,1,13,386
020100605,339,22,8,3,6,0,16,394
020100606,283,35,9,1,4,1,18,351
020100607,282,34,10,2,7,0,14,349
020100608,334,28,10,2,5,0,13,392
020100609,354,49,24,6,8,0,18,459
020100610,369,49,11,3,9,0,9,450
020100611,254,29,14,8,0,0,12,317
020100612,259,32,7,4,1,1,11,315
020100613,385,52,14,1,7,0,19,478
020100701,347,34,25,4,5,0,21,436
020100702,397,67,36,0,6,1,14,521
020100703,451,20,11,0,13,2,24,521
020100704,424,51,23,6,10,0,17,531
020100705,357,30,13,1,16,0,27,444
020100706,338,31,13,2,6,3,17,410
020100707,506,17,11,1,0,0,20,555
020100708,347,28,7,2,10,5,19,418
020100709,312,42,20,7,2,1,11,395
020100710,385,31,3,1,3,0,16,439
020100801,382,48,15,0,9,1,13,468
020100802,408,38,20,3,5,1,12,487
020100803,285,31,11,1,11,2,21,362
020100804,355,19,40,3,12,2,26,457
020100805,260,26,13,3,16,0,9,327
020100806,284,31,4,1,2,0,3,325
020100807,402,53,5,7,5,1,12,485
020100808,395,41,14,2,3,0,13,468
020100809,257,30,13,1,1,2,23,327
020100901,321,49,6,1,5,3,18,403
020100902,306,28,3,3,7,0,16,363
020100903,285,29,2,4,7,0,22,349
020100904,306,31,2,0,2,0,17,358
020100905,286,34,12,0,6,0,12,350
020100906,331,25,12,0,2,0,14,384
020100907,301,21,16,4,3,1,15,361
020100908,246,32,3,2,1,1,14,299
020100909,247,19,7,1,5,0,7,286
020100910,234,41,11,3,3,0,6,298
020101001,275,29,10,2,4,1,12,333
020101002,345,53,12,4,1,0,8,423
020101003,297,18,2,6,12,0,7,342
020101004,269,44,3,1,1,1,9,328
020101005,299,21,3,0,5,1,20,349
020101006,307,14,4,2,1,0,9,337
020101007,298,33,6,1,1,1,9,349
020101008,253,17,1,2,0,0,12,285
020101009,338,39,13,3,4,0,7,404
020101010,255,26,2,2,3,0,4,292
020101011,287,19,7,4,4,1,20,342
020101012,336,47,7,2,3,1,42,438
020101101,299,59,7,1,20,1,19,406
020101102,406,43,17,3,7,0,27,503
020101103,338,37,21,2,6,5,16,425
020101104,346,39,5,1,5,2,29,427
020101105,256,34,5,3,6,0,5,309
020101106,181,41,12,1,17,0,10,262
020101107,330,41,6,3,9,1,20,410
020101108,338,35,9,0,2,1,5,390
020101109,345,16,8,0,11,1,8,389
020101110,263,13,10,0,2,0,66,354
020101111,244,30,7,2,0,0,8,291
020101201,331,25,26,1,4,0,24,411
020101202,364,33,15,2,14,2,12,442
020101203,260,21,6,0,1,0,6,294
020101204,235,18,19,1,7,1,18,299
020101205,151,33,12,1,38,1,2,238
020101206,191,15,18,1,2,0,15,242
020101207,225,31,10,1,2,2,11,282
020101208,291,34,13,3,0,0,11,352
020101209,307,39,24,1,2,2,15,390
020101210,239,36,2,13,4,0,12,306
020101301,212,22,3,1,2,0,8,248
020101302,246,55,8,1,3,0,2,315
020101303,258,41,4,3,4,0,12,322
020101304,239,19,0,1,10,2,16,287
020101305,301,34,11,7,7,1,15,376
020101306,265,29,12,2,1,1,10,320
020101307,244,25,5,1,7,5,9,296
020101308,284,36,7,0,1,1,2,331
020101309,276,27,5,0,11,0,7,326
020101310,229,32,4,3,3,3,7,281
020101311,276,34,3,1,4,4,22,344
020101312,262,27,5,0,1,0,21,316
020101401,314,38,22,2,7,0,6,389
020101402,304,37,10,2,3,2,18,376
020101403,317,39,12,5,8,1,26,408
020101404,280,50,7,2,4,0,21,364
020101405,256,35,4,3,2,0,12,312
020101406,199,25,4,4,3,0,8,243
020101407,266,13,1,5,2,0,14,301
020101408,247,42,8,1,2,0,10,310
020101409,320,21,19,1,2,0,25,388
020101410,331,38,23,1,11,0,35,439
020101411,259,25,11,1,0,0,5,301
020101501,246,15,11,0,4,2,26,304
020101502,343,44,5,1,7,1,16,417
020101503,198,25,4,0,1,0,19,247
020101504,241,29,5,3,3,0,20,301
020101505,293,27,18,3,3,1,12,357
020101506,238,46,5,5,4,4,21,323
020101507,218,52,4,1,3,0,7,285
020101508,333,28,12,1,0,0,9,383
020101509,454,50,19,3,3,1,14,544
020101601,264,10,11,0,1,1,14,301
020101602,386,48,28,0,4,0,16,482
020101603,247,41,9,1,6,9,17,330
020101604,332,42,8,4,11,1,15,413
020101605,380,54,16,2,2,2,43,499
020101606,338,39,12,6,7,2,24,428
020101607,288,22,8,0,8,1,20,347
020101608,298,31,9,7,10,0,15,370
020101609,327,34,12,4,8,1,14,400
020101701,310,38,10,5,11,0,17,391
020101702,351,48,35,0,6,1,15,456
020101703,353,42,13,7,4,0,17,436
020101704,378,20,35,2,1,1,8,445
020101705,296,38,6,0,3,2,23,368
020101706,292,32,8,0,9,1,30,372
020101707,269,37,26,4,3,0,6,345
020101708,218,32,17,1,1,0,17,286
020101709,215,22,11,0,1,3,6,258
020101710,264,32,10,3,0,0,17,326
020101801,253,18,13,1,8,0,18,311
020101802,265,9,4,1,3,1,9,292
020101803,319,29,20,0,2,0,27,397
020101804,373,45,24,5,1,1,15,464
020101805,275,37,13,1,4,0,19,349
020101806,276,40,22,1,7,0,16,362
020101807,359,30,12,1,5,0,21,428
020101808,178,34,17,3,1,0,6,239
020101809,360,52,6,0,2,1,44,465
020101810,175,17,7,2,0,1,10,212
020101811,210,16,3,0,0,0,17,246
020101812,290,14,3,1,6,1,10,325
020101901,241,24,15,0,3,9,18,310
020101902,408,31,11,0,3,0,21,474
020101903,298,33,13,0,3,0,14,361
020101904,325,51,7,2,7,0,24,416
020101905,341,40,25,1,4,0,9,420
020101906,264,25,6,5,4,4,42,350
020101907,322,28,26,0,9,0,34,419
020101908,201,37,0,0,2,0,20,260
020101909,272,33,8,3,1,0,8,325
020101910,378,39,38,0,2,0,21,478
020101911,329,33,7,4,5,1,20,399
020101912,402,56,15,3,3,3,28,510
020110101,320,28,8,5,4,1,3,369
020110102,314,36,11,7,5,0,19,392
020110103,239,28,2,6,2,0,9,286
020110104,312,31,5,4,3,1,15,371
020110105,216,22,14,2,2,0,12,268
020110106,270,17,13,1,4,0,17,322
020110107,248,43,2,3,9,0,30,335
020110108,268,51,17,4,5,1,21,367
020110109,301,36,25,7,9,2,21,401
020110110,320,44,17,5,3,0,27,416
020110111,396,47,17,1,8,1,22,492
020110112,266,24,30,0,15,1,14,350
020110201,273,32,8,3,8,0,16,340
020110202,321,27,18,2,5,1,30,404
020110203,284,30,29,1,3,1,6,354
020110204,221,36,6,2,3,0,12,280
020110205,377,28,8,4,3,0,48,468
020110206,330,19,15,3,5,1,20,393
020110207,303,36,8,4,4,0,33,388
020110208,292,22,9,3,2,0,9,337
020110209,233,20,9,7,2,0,12,283
020110210,342,29,15,2,6,5,31,430
020110211,322,22,13,2,3,6,34,402
020110301,262,38,11,3,2,1,20,337
020110302,292,36,14,0,3,1,26,372
020110303,233,45,5,4,8,0,8,303
020110304,208,27,10,2,8,1,13,269
020110305,227,38,12,2,8,0,23,310
020110306,286,24,17,6,10,0,6,349
020110307,263,22,5,2,5,2,20,319
020110308,295,30,10,12,18,1,13,379
020110309,294,31,13,2,7,0,12,359
020110310,296,31,13,2,2,2,22,368
020110311,252,33,13,1,10,0,7,316
020110312,280,24,8,2,3,0,9,326
020110401,276,38,7,3,1,1,5,331
020110402,256,46,20,1,20,3,28,374
020110403,218,38,3,1,5,0,11,276
020110404,289,49,12,6,3,1,17,377
020110405,302,36,11,3,3,1,19,375
020110406,235,39,4,2,2,0,14,296
020110407,275,28,13,2,2,0,17,337
020110408,278,31,8,0,10,1,18,346
020110409,307,58,30,7,11,1,14,428
020110410,275,22,6,1,23,0,15,342
020110411,309,41,12,9,15,0,20,406
020110412,342,32,30,2,13,2,16,437
020110413,306,41,13,1,11,1,25,398
020110501,239,20,7,2,3,0,26,297
020110502,304,32,8,1,9,0,18,372
020110503,314,31,2,3,2,0,28,380
020110504,249,23,7,1,9,1,16,306
020110505,333,46,11,2,9,1,22,424
020110506,312,31,7,6,6,1,18,381
020110507,273,35,15,1,3,0,13,340
020110508,298,18,1,14,4,2,11,348
020110509,279,20,13,3,5,1,3,324
020110510,329,38,13,7,16,0,9,412
020110601,285,32,15,0,4,0,1,337
020110602,350,36,13,12,2,2,28,443
020110603,344,46,14,5,26,3,19,457
020110604,326,35,7,4,8,1,11,392
020110605,297,44,43,3,9,1,20,417
020110606,298,25,11,0,1,0,13,348
020110607,286,20,9,2,1,0,15,333
020110608,278,19,5,5,0,0,42,349
020110609,278,11,6,3,4,0,20,322
020110610,261,15,1,2,4,0,34,317
020110611,297,33,4,2,3,0,18,357
020110701,154,18,3,1,3,0,8,187
020110702,318,32,3,3,9,0,12,377
020110703,293,31,14,7,7,0,19,371
020110704,316,37,8,1,1,0,8,371
020110705,345,29,9,6,5,0,19,413
020110706,287,17,14,1,2,0,11,332
020110707,267,38,4,2,0,3,17,331
020110708,240,33,6,0,5,0,19,303
020110709,295,28,9,2,4,0,11,349
020110710,282,41,8,7,5,0,13,356
020110711,318,35,14,34,1,1,12,415
020110712,291,19,2,1,0,0,10,323
020110801,336,40,16,1,9,1,31,434
020110802,329,34,11,2,2,2,25,405
020110803,209,26,10,1,3,0,10,259
020110804,327,39,9,0,10,2,15,402
020110805,261,40,4,3,8,2,13,331
020110806,363,34,11,3,1,0,21,433
020110807,330,34,6,0,8,2,18,398
020110808,349,28,15,3,5,1,6,407
020110809,359,63,14,1,5,2,12,456
020110901,307,29,11,4,1,0,12,364
020110902,293,46,11,0,1,0,4,355
020110903,371,60,13,5,12,3,17,481
020110904,250,32,7,0,6,1,9,305
020110905,291,43,9,0,15,1,9,368
020110906,244,44,15,1,12,1,20,337
020110907,302,37,20,1,12,1,10,383
020110908,307,20,6,0,2,0,19,354
020110909,244,32,10,4,8,0,2,300
020110910,326,41,8,1,5,3,16,400
020110911,245,29,13,1,15,1,28,332
020110912,294,40,11,4,15,0,23,387
020111001,293,33,25,3,6,1,10,371
020111002,368,42,37,3,7,2,14,473
020111003,314,42,19,1,14,6,10,406
020111004,327,64,12,0,6,1,17,427
020111005,383,56,38,1,1,1,14,494
020111006,453,52,25,0,12,1,27,570
020111007,331,44,23,2,4,0,13,417
020111008,313,47,11,1,14,0,17,403
020111009,313,53,19,4,1,0,10,400
020111010,247,30,18,6,3,1,19,324
020111101,260,15,0,1,1,0,18,295
020111102,302,16,17,1,6,0,19,361
020111103,307,0,7,2,2,0,14,332
020111104,93,7,1,2,3,1,12,119
020111105,323,25,4,0,1,0,20,373
020111106,356,24,14,1,6,0,16,417
020111107,296,24,5,3,6,1,10,345
020111108,301,29,13,3,6,2,18,372
020111109,238,28,11,6,3,1,26,313
020111201,229,20,23,2,1,0,4,279
020111202,217,32,6,1,3,0,4,263
020111203,343,34,7,6,8,2,24,424
020111204,269,32,11,1,7,0,16,336
020111205,230,12,12,2,6,1,26,289
020111206,313,36,4,1,4,1,10,369
020111207,250,15,3,1,2,0,18,289
020111208,264,25,1,1,2,0,9,302
020111209,228,10,10,1,8,3,39,299
020111210,256,22,10,2,10,1,11,312
020111301,343,38,17,0,10,1,20,429
020111302,381,30,7,1,9,3,23,454
020111303,311,31,30,2,15,2,18,409
020111304,344,34,17,0,11,1,40,447
020111305,385,30,15,3,7,2,7,449
020111306,352,41,8,0,8,1,23,433
020111307,296,34,5,2,7,0,11,355
020111308,276,29,13,2,1,0,23,344
020111309,361,50,22,5,3,0,19,460
020111310,248,19,3,5,2,0,15,292
020111311,327,44,6,4,10,0,8,399
020111401,358,15,6,4,13,0,25,421
020111402,329,34,9,0,12,1,29,414
020111403,360,33,5,2,2,0,11,413
020111404,275,35,6,4,4,1,10,335
020111405,313,43,6,6,3,0,32,403
020111406,396,56,12,5,2,0,16,487
020111407,680,54,30,1,5,1,26,797
020111501,342,36,35,5,9,0,10,437
020111502,321,22,4,3,4,1,16,371
020111503,352,25,8,0,15,1,15,416
020111504,346,38,9,3,3,2,12,413
020111505,319,31,19,0,4,1,10,384
020111506,302,17,1,2,1,0,6,329
020111507,280,48,12,1,2,0,24,367
020111508,348,32,9,6,4,1,21,421
020111509,330,32,31,1,8,1,15,418
020111510,324,18,4,2,0,0,12,360
020111511,384,14,8,2,4,1,16,429
020111601,310,30,9,2,4,0,19,374
020111602,352,56,34,8,11,1,24,486
020111603,257,38,15,0,7,0,14,331
020111604,246,27,11,3,5,5,19,316
020111605,278,27,17,0,3,0,8,333
020111606,308,48,20,1,0,0,10,387
020111607,344,52,4,1,6,0,18,425
020111608,378,45,12,2,4,1,16,458
020111609,252,49,39,2,2,0,14,358
020111610,228,23,6,3,1,0,15,276
020111701,284,35,5,0,10,0,6,340
020111702,279,21,10,0,1,0,18,329
020111703,320,22,11,2,7,1,15,378
020111704,306,20,15,3,9,2,14,369
020111705,249,22,10,7,3,1,10,302
020111706,384,52,12,3,10,0,8,469
020111707,308,35,4,0,3,0,26,376
020111708,297,27,2,0,6,0,9,341
020111801,228,18,5,2,3,0,7,263
020111802,284,39,10,2,2,0,20,357
020111803,270,26,17,2,6,1,29,351
020111804,324,20,7,2,17,1,15,386
020111805,309,55,8,0,7,1,15,395
020111806,506,85,33,1,1,2,76,704
020111807,303,50,34,0,4,0,23,414
020111808,328,8,8,4,5,0,13,366
020111809,286,28,8,2,7,0,22,353
020111901,210,28,6,0,5,0,10,259
020111902,316,20,18,5,17,1,19,396
020111903,278,43,5,0,0,0,11,337
020111904,327,31,29,0,2,0,11,400
020111905,286,17,6,1,6,0,20,336
020111906,325,29,6,2,10,1,17,390
020111907,305,28,7,2,6,2,11,361
020111908,293,28,8,2,8,0,20,359
020111909,322,39,10,3,6,2,16,398
020112001,344,34,5,1,3,0,16,403
020112002,312,43,10,6,12,0,11,394
020112003,359,29,9,1,1,0,9,408
020112004,281,20,4,7,1,2,23,338
020112005,314,28,11,1,4,0,20,378
020112006,235,22,18,3,2,3,8,291
020112007,225,16,3,1,3,0,11,259
020112008,189,20,6,3,3,0,13,234
020112009,256,26,1,1,0,1,14,299
020112010,285,25,8,0,5,2,7,332
020112011,246,31,2,1,5,2,14,301
020112101,316,31,6,4,4,1,14,376
020112102,258,37,2,0,4,1,4,306
020112103,405,18,16,2,9,1,18,469
020112104,311,26,6,2,7,0,21,373
020112105,383,46,15,2,14,1,14,475
020112106,351,32,16,0,8,0,19,426
020112107,260,37,14,4,5,0,5,325
020112108,249,30,4,5,11,1,13,313
020112109,218,35,6,0,2,0,7,268
020112110,278,27,14,0,3,0,14,336
020112111,365,34,15,3,0,0,9,426
020112201,299,43,17,3,5,0,10,377
020112202,348,31,0,0,7,0,15,401
020112203,348,37,4,3,3,0,24,419
020112204,259,35,4,2,11,0,16,327
020112205,301,45,5,4,10,0,12,377
020112206,383,32,42,1,6,3,21,488
020112207,340,29,3,1,3,0,29,405
020112208,264,54,7,3,5,1,10,344
020112209,259,40,7,1,7,0,4,318
020112210,298,41,25,0,6,5,19,394
020112211,236,31,3,1,2,0,10,283
020120101,188,14,3,0,1,0,10,216
020120102,192,16,4,3,0,0,8,223
020120103,176,18,4,1,0,0,1,200
020120104,266,24,2,1,8,0,14,315
020120105,206,15,12,0,5,0,11,249
020120106,276,40,1,1,6,0,6,330
020120107,328,27,4,1,0,0,10,370
020120108,178,15,6,1,1,0,13,214
020120109,349,33,9,1,12,0,19,423
020120110,350,58,3,3,5,2,18,439
020120111,365,25,14,2,9,2,22,439
020120201,312,30,22,0,7,0,15,386
020120202,309,36,15,2,1,3,23,389
020120203,381,53,15,0,6,2,23,480
020120204,372,45,12,2,5,1,20,457
020120205,371,37,8,1,1,0,24,442
020120206,335,30,9,1,10,1,13,399
020120207,316,44,11,2,1,1,12,387
020120208,335,23,6,3,3,0,10,380
020120301,104,9,10,0,2,1,0,126
020120302,225,23,8,3,5,0,3,267
020120303,261,23,4,12,4,0,8,312
020120304,259,20,6,1,3,2,12,303
020120305,289,26,1,3,2,1,19,341
020120306,335,8,1,0,0,0,2,346
020120307,376,23,7,2,2,2,10,422
020120308,250,24,7,3,6,1,11,302
020120309,204,16,4,3,2,2,3,234
020120310,286,28,32,2,4,1,9,362
020120311,278,30,9,0,2,1,25,345
020120401,245,14,8,1,6,0,10,284
020120402,268,11,18,2,2,0,26,327
020120403,383,37,13,0,12,0,24,469
020120404,278,18,18,1,7,0,7,329
020120405,231,26,10,7,13,0,11,298
020120406,290,19,9,3,6,5,35,367
020120407,496,87,18,0,23,4,24,652
020120408,281,35,16,1,6,1,14,354
020120409,222,31,0,0,4,0,22,279
020120410,223,42,8,4,8,1,6,292
020120501,204,30,7,3,3,3,6,256
020120502,279,44,10,3,4,0,16,356
020120503,528,53,12,1,9,5,57,665
020120504,275,11,10,2,4,6,5,313
020120505,345,40,14,0,13,2,22,436
020120506,287,42,52,2,28,1,12,424
020120507,321,29,19,1,7,1,22,400
020120508,413,17,19,2,9,1,37,498
020120509,302,30,6,0,3,0,11,352
020120510,276,27,1,0,9,0,13,326
020120511,315,37,10,0,6,0,9,377
020120601,299,46,9,1,16,0,15,386
020120602,348,37,59,3,10,2,19,478
020120603,253,34,3,2,3,2,8,305
020120604,325,11,3,9,1,0,5,354
020120605,382,51,20,0,8,0,14,475
020120606,338,41,23,3,4,0,16,425
020120607,329,42,16,2,4,0,8,401
020120608,285,5,8,1,0,0,15,314
020120609,301,33,11,4,5,0,15,369
020120610,296,22,0,8,6,1,19,352
020120701,313,43,11,1,4,0,13,385
020120702,298,19,3,0,8,0,10,338
020120703,315,28,15,6,3,1,10,378
020120704,321,47,23,0,6,0,7,404
020120705,264,35,17,4,6,3,24,353
020120706,343,76,2,1,4,1,13,440
020120707,297,37,15,3,12,0,22,386
020120708,358,48,11,4,7,3,14,445
020120709,550,123,31,6,7,3,29,749
020120710,469,77,34,2,8,1,25,616
020120801,406,127,24,3,4,0,22,586
020120802,269,32,8,2,2,1,10,324
020120803,319,36,2,5,3,0,18,383
020120804,256,31,15,1,7,0,5,315
020120805,340,58,14,1,5,3,20,441
020120806,343,44,5,0,3,1,20,416
020120807,359,39,16,0,0,0,25,439
020120808,408,64,13,1,3,2,12,503
020120809,387,47,21,1,0,0,17,473
020120810,269,19,18,0,3,0,14,323
020120811,242,32,12,5,2,0,7,300
020120901,315,39,7,3,5,0,33,402
020120902,400,29,11,5,4,1,15,465
020120903,377,22,24,5,9,1,17,455
020120904,383,31,12,8,10,0,24,468
020120905,354,41,28,12,4,2,15,456
020120906,365,56,9,2,4,3,13,452
020120907,298,33,11,9,3,1,13,368
020121001,321,27,12,5,2,0,14,381
020121002,378,59,12,3,3,0,35,490
020121003,282,26,16,4,2,0,8,338
020121004,256,19,12,3,3,1,13,307
020121005,292,23,20,3,7,1,22,368
020121006,342,36,21,0,3,1,20,423
020121007,247,34,16,1,3,0,12,313
020121008,469,79,7,4,5,0,15,579
020121009,307,32,11,1,2,1,32,386
020121010,255,27,7,1,3,0,14,307
020121011,322,41,9,3,3,2,15,395
020121101,319,48,12,0,3,0,6,388
020121102,259,40,15,0,3,0,3,320
020121103,243,48,5,0,0,0,5,301
020121104,325,14,23,5,10,0,43,420
020121105,284,38,11,1,1,0,10,345
020121106,307,17,22,5,4,1,17,373
020121107,319,36,6,2,5,0,23,391
020121108,325,51,14,3,9,2,7,411
020121109,370,29,27,2,7,1,32,468
020121110,266,42,7,4,5,1,21,346
020121111,272,45,7,10,3,1,5,343
020121201,270,30,25,3,8,1,14,351
020121202,494,73,15,0,20,3,14,619
020121203,485,55,17,4,8,1,57,627
020121204,349,38,22,6,7,0,14,436
020121205,322,40,1,3,2,1,26,395
020121206,243,38,50,0,12,0,15,358
020121207,375,68,16,1,47,2,12,521
020121208,263,34,4,3,7,1,13,325
020121301,402,57,19,0,5,0,53,536
020121302,388,29,28,2,3,0,33,483
020121303,711,92,107,8,16,4,24,962
020121304,489,59,37,14,10,0,14,623
020121305,456,46,39,8,5,0,22,576
020121306,390,63,9,1,15,1,18,497
020121307,221,37,23,0,1,0,17,299
020121401,369,54,15,1,13,1,30,483
020121402,395,50,11,3,32,4,15,510
020121403,304,69,11,1,2,0,16,403
020121404,398,81,71,3,33,8,8,602
020121405,418,55,5,0,17,0,18,513
020121406,314,48,8,4,5,1,13,393
020121407,428,42,54,6,11,0,28,569
020121408,463,102,29,8,9,2,20,633
020121409,319,30,43,2,2,0,24,420
020121410,423,51,36,1,11,2,10,534
020121501,365,62,20,4,4,2,51,508
020121502,419,66,16,1,6,4,35,547
020121503,405,94,37,3,12,2,15,568
020121504,415,58,12,0,20,2,29,536
020121505,391,43,24,1,28,0,9,496
020121506,339,47,7,1,6,1,22,423
020121507,379,50,14,0,5,2,32,482
020121508,359,60,19,1,7,1,9,456
020121509,422,53,49,0,6,1,21,552
020121510,293,29,11,3,11,0,21,368
020121511,265,23,8,6,3,0,17,322
020121512,267,26,4,4,0,0,10,311
020121513,245,24,6,2,1,0,3,281
020121601,379,44,4,1,3,2,14,447
020121602,345,37,9,2,13,0,25,431
020121603,308,43,27,3,6,1,11,399
020121604,448,77,41,3,6,7,34,616
020121605,470,124,65,11,3,3,11,687
020121606,629,81,86,1,16,3,47,863
020121607,316,42,10,0,3,1,13,385
020121608,518,107,30,7,8,2,18,690
020121609,358,38,18,0,4,4,5,427
020121610,327,46,75,4,1,0,6,459
020121611,333,21,11,0,10,0,9,384
020121612,311,32,29,1,3,1,6,383
020121613,195,15,26,0,6,0,10,252
020121614,170,22,0,0,3,0,4,199
020121701,343,36,10,8,6,1,17,421
020121702,346,41,14,4,4,0,16,425
020121703,322,35,6,3,6,0,17,389
020121704,300,36,15,8,5,0,4,368
020121705,427,46,18,3,7,0,11,512
020121706,388,41,5,3,5,0,35,477
020121707,355,39,10,9,2,0,16,431
020121708,545,68,54,3,6,1,24,701
020121801,228,32,10,2,3,0,19,294
020121802,308,36,1,0,0,0,10,355
020121803,313,24,6,2,6,0,12,363
020121804,296,20,9,4,7,1,10,347
020121805,290,26,4,6,4,1,11,342
020121806,300,23,6,1,1,0,27,358
020121807,328,19,6,2,3,0,15,373
020121808,314,29,15,5,3,0,14,380
020121809,263,18,3,0,0,1,6,291
020121810,272,35,28,5,3,0,17,360
020121811,233,29,7,0,0,1,14,284
020121812,426,52,30,2,4,4,22,540
020121813,305,18,0,0,2,0,22,347
020121901,345,21,10,0,0,0,28,404
020121902,218,10,2,0,0,0,3,233
020121903,250,12,4,0,0,0,12,278
020121904,363,35,6,2,0,0,11,417
020121905,366,30,30,0,1,1,31,459
020121906,348,23,7,0,2,0,18,398
020121907,339,27,4,0,5,0,11,386
020121908,302,30,8,0,3,1,16,360
020121909,311,43,5,1,4,0,8,372
020121910,348,28,2,1,2,1,9,391
020121911,334,16,4,1,1,0,14,370
020121912,315,57,3,1,8,0,8,392
020121913,272,23,11,1,0,0,14,321
020122001,313,44,14,2,6,1,21,401
020122002,514,67,53,3,14,1,44,696
020122003,398,59,9,2,5,0,11,484
020122004,386,37,16,3,1,0,16,459
020122005,351,26,11,4,6,2,17,417
020122006,402,54,28,9,9,0,22,524
020122007,342,39,12,1,3,0,20,417
020122008,309,54,44,1,9,1,17,435
020122101,456,53,28,7,22,3,19,588
020122102,409,48,32,6,6,0,28,529
020122103,341,59,8,7,12,0,10,437
020122104,416,64,12,3,5,3,26,529
020122105,191,8,3,3,0,1,14,220
020122106,319,34,2,3,4,0,15,377
020122107,330,36,6,2,3,2,58,437
020122108,294,28,53,7,4,0,11,397
020122109,270,18,13,2,5,1,13,322
020122110,258,47,8,1,12,0,14,340
020122201,284,15,7,2,5,1,16,330
020122202,355,35,7,1,2,0,16,416
020122203,289,25,4,4,1,2,18,343
020122204,292,29,4,2,1,0,10,338
020122205,360,28,11,3,5,0,15,422
020122206,433,60,43,1,5,0,13,555
020122207,434,47,18,6,17,1,26,549
020122208,332,29,4,5,5,0,11,386
020122209,356,48,8,3,7,2,23,447
020122210,355,33,6,5,0,1,4,404
020122211,365,60,8,7,11,1,12,464
020130101,294,59,17,2,5,1,14,392
020130102,340,34,11,2,7,0,14,408
020130103,254,29,16,2,1,1,11,314
020130104,355,114,18,2,21,1,13,524
020130105,393,203,13,0,13,5,47,674
020130106,356,95,26,1,19,0,22,519
020130107,181,39,15,3,2,0,14,254
020130108,238,38,14,0,0,5,7,302
020130109,197,19,2,1,0,0,3,222
020130110,304,35,7,2,6,0,14,368
020130111,259,44,26,0,8,0,9,346
020130112,242,38,5,1,11,0,12,309
020130113,239,37,9,0,8,0,13,306
020130114,262,53,11,1,18,0,8,353
020130201,514,80,35,0,32,8,38,707
020130202,329,25,4,2,11,0,31,402
020130203,255,60,3,5,9,0,12,344
020130204,234,28,15,0,5,2,18,302
020130205,323,88,19,1,25,1,25,482
020130206,460,120,43,2,18,12,32,687
020130207,291,59,11,0,1,0,10,372
020130208,252,39,12,0,6,2,13,324
020130209,390,79,7,0,5,0,16,497
020130210,436,64,27,4,8,2,21,562
020130211,292,61,49,0,44,0,11,457
020130301,373,31,49,3,12,5,21,494
020130302,265,8,45,2,23,4,29,376
020130303,331,89,33,1,1,0,7,462
020130304,429,82,109,2,21,4,107,754
020130305,309,36,72,2,5,1,21,446
020130306,270,10,43,7,19,3,30,382
020130307,283,42,10,3,7,0,12,357
020130308,277,48,4,0,1,1,30,361
020130309,331,46,5,3,16,0,15,416
020130310,442,114,26,2,25,8,24,641
020130401,284,73,26,4,21,1,15,424
020130402,338,64,8,2,11,1,14,438
020130403,300,45,7,0,9,1,18,380
020130404,423,72,9,1,18,1,24,548
020130405,358,49,20,0,25,0,24,476
020130406,396,53,20,4,14,2,28,517
020130407,290,40,7,1,2,1,8,349
020130408,264,63,4,5,6,1,16,359
020130409,334,60,14,1,9,0,31,449
020130410,229,38,11,0,22,3,12,315
020130411,316,50,9,3,1,0,19,398
020130412,583,124,29,2,16,12,27,793
020130413,321,50,16,1,19,2,24,433
020130414,324,37,12,0,38,8,6,425
020130501,335,48,4,0,4,2,17,410
020130502,397,56,9,4,7,0,22,495
020130503,525,103,28,3,9,4,72,744
020130504,473,64,29,0,3,0,33,602
020130505,341,37,17,7,10,1,21,434
020130506,418,78,12,3,16,1,14,542
020130507,324,30,30,2,26,0,26,438
020130508,407,73,24,0,15,0,31,550
020130601,282,28,5,0,0,2,8,325
020130602,396,31,7,2,4,2,26,468
020130603,359,42,9,7,2,1,7,427
020130604,397,61,19,1,17,4,31,530
020130605,445,54,20,1,12,1,26,559
020130606,348,40,6,9,20,0,13,436
020130607,391,57,8,0,11,1,29,497
020130608,335,38,2,0,2,0,10,387
020130701,269,42,9,1,3,0,16,340
020130702,220,33,7,0,3,0,9,272
020130703,453,77,8,1,4,0,23,566
020130704,340,78,12,4,29,2,43,508
020130705,473,85,15,0,61,4,26,664
020130706,369,72,10,1,4,1,23,480
020130707,327,49,5,1,7,1,28,418
020130708,304,51,45,4,3,0,9,416
020130709,363,53,3,1,2,0,11,433
020130801,311,66,7,0,6,1,15,406
020130802,271,53,37,1,8,2,15,387
020130803,407,59,15,1,18,2,14,516
020130804,378,50,7,1,14,8,18,476
020130805,450,106,55,0,17,1,26,655
020130806,291,39,9,1,6,3,6,355
020130807,338,46,17,0,2,5,5,413
020130808,411,54,12,3,18,4,11,513
020130809,326,75,12,1,16,2,8,440
020130810,289,51,7,2,18,1,14,382
020130901,283,42,5,0,7,3,13,353
020130902,294,22,29,0,20,7,62,434
020130903,236,34,16,0,47,0,21,354
020130904,292,46,13,1,26,1,22,401
020130905,485,93,7,2,12,0,20,619
020130906,318,32,21,3,30,3,23,430
020130907,294,52,5,1,7,1,3,363
020130908,328,44,13,2,9,9,24,429
020130909,359,46,5,1,7,0,13,431
020130910,235,29,20,2,12,1,36,335
020131001,413,127,12,3,9,0,5,569
020131002,344,69,57,1,24,2,30,527
020131003,401,67,19,1,16,1,21,526
020131004,413,74,19,2,13,6,25,552
020131005,232,57,18,7,25,2,10,351
020131006,378,53,9,2,6,3,13,464
020131007,312,68,6,0,2,3,25,416
020131008,430,119,11,0,26,4,17,607
020131009,313,36,15,1,7,4,13,389
020131010,400,99,13,0,6,6,25,549
020131011,306,54,47,0,45,0,37,489
020131101,170,34,3,3,2,1,4,217
020131102,239,37,13,7,9,2,22,329
020131103,194,13,14,4,12,0,21,258
020131104,226,44,10,1,10,2,14,307
020131105,215,26,6,2,5,3,5,262
020131106,373,21,33,0,15,3,37,482
020131107,265,15,21,5,15,2,32,355
020131201,276,54,50,2,10,3,23,418
020131202,312,46,6,1,1,0,26,392
020131203,236,32,10,3,6,0,10,297
020131204,350,69,13,3,3,3,13,454
020131205,212,22,2,5,3,1,22,267
020131206,235,55,14,2,8,2,12,328
020131207,339,41,12,1,9,1,15,418
020131208,272,37,24,0,5,6,29,373
020131209,378,69,23,7,12,1,23,513
020131210,244,27,3,1,2,1,19,297
020131301,352,63,5,2,9,3,29,463
020131302,147,18,9,0,15,0,11,200
020131303,319,73,9,1,10,0,22,434
020131304,370,60,31,0,21,8,23,513
020131305,406,64,14,2,12,0,14,512
020131306,131,41,4,0,2,0,10,188
020131307,299,78,12,4,6,3,6,408
020131308,248,40,0,4,46,1,21,360
020131309,273,36,5,4,0,4,20,342
020131310,346,72,14,2,0,2,20,456
020131311,212,43,18,1,2,0,2,278
020131312,324,38,10,1,16,2,5,396
020131313,526,76,23,1,19,7,33,685
020131314,342,62,79,0,7,7,32,529
020131401,327,42,16,0,18,7,31,441
020131402,162,25,5,0,5,2,10,209
020131403,360,78,11,2,56,2,25,534
020131404,288,32,6,3,3,3,25,360
020131405,228,10,13,0,4,0,36,291
020131406,355,40,16,0,7,3,14,435
020131407,163,32,9,0,13,3,4,224
020131408,249,32,25,0,75,5,22,408
020131409,234,44,15,1,21,2,11,328
020131410,297,32,6,1,1,0,32,369
020131411,268,46,12,2,5,3,11,347
020131501,350,53,10,1,19,4,33,470
020131502,357,77,20,1,21,1,20,497
020131503,347,38,8,4,8,3,15,423
020131504,196,36,8,0,33,1,12,286
020131505,384,73,19,0,16,0,38,530
020131506,279,46,13,0,8,0,12,358
020131507,376,59,9,0,10,3,18,475
020131508,363,58,10,1,7,2,16,457
020131509,403,48,16,0,114,5,28,614
020131510,330,51,8,1,36,7,18,451
020131511,367,73,30,3,32,5,12,522
020131512,323,36,17,1,5,0,28,410
020131601,388,69,47,2,0,1,13,520
020131602,424,64,17,0,28,5,11,549
020131603,249,82,12,1,14,0,47,405
020131604,367,62,15,0,16,3,29,492
020131605,251,56,11,0,30,3,8,359
020131606,169,46,3,0,29,1,1,249
020131607,365,55,11,0,11,3,22,467
020131608,347,37,5,1,4,1,16,411
020131609,373,47,23,0,8,3,7,461
020131610,385,83,56,1,26,1,29,581
020131611,379,53,33,0,16,1,17,499
020131612,339,48,9,0,7,1,21,425
020131613,221,14,3,0,0,0,19,257
020131701,471,76,19,3,16,2,26,613
020131702,464,88,36,3,21,3,45,660
020131703,358,43,86,38,7,2,21,555
020131704,243,32,12,0,2,1,13,303
020131705,281,45,7,2,0,2,30,367
020131706,344,40,18,1,1,0,10,414
020131707,382,53,18,4,6,6,15,484
020131708,314,54,2,0,3,1,15,389
020131709,399,66,38,1,6,0,21,531
020131710,393,64,6,0,8,3,24,498
020131711,245,51,1,0,0,0,17,314
020131801,332,36,12,6,8,1,36,431
020131802,402,47,17,3,8,5,39,521
020131803,390,53,18,0,4,1,34,500
020131804,293,45,8,2,11,1,7,367
020131805,280,53,4,2,7,0,10,356
020131806,301,64,22,1,6,3,12,409
020131807,380,38,18,1,7,0,36,480
020131808,275,47,11,4,7,3,12,359
020131809,166,12,6,3,3,3,15,208
020131810,270,49,13,0,8,8,14,362
020131901,335,33,17,0,3,0,28,416
020131902,393,43,16,6,6,4,30,498
020131903,285,53,5,1,11,0,16,371
020131904,226,65,16,2,0,0,5,314
020131905,359,81,15,4,5,0,15,479
020131906,211,26,6,0,1,0,8,252
020131907,221,37,3,2,6,0,8,277
020131908,322,50,9,1,1,2,19,404
020131909,327,60,5,1,5,6,17,421
020131910,311,65,11,5,12,1,13,418
020131911,160,51,4,0,1,1,7,224
020131912,266,38,9,5,14,1,21,354
020132001,301,49,10,0,28,3,23,414
020132002,381,43,26,0,11,0,10,471
020132003,171,26,2,1,7,1,24,232
020132004,312,37,30,0,12,1,20,412
020132005,300,64,0,2,35,5,15,421
020132006,424,57,19,0,52,8,49,609
020132007,366,81,8,0,10,2,36,503
020132008,383,88,20,0,38,4,51,584
020132009,255,46,28,0,34,6,20,389
020132010,268,27,14,0,17,10,33,369
020132011,251,53,15,0,13,0,9,341
020132012,270,73,2,0,69,1,25,440
020132101,232,30,14,1,71,1,17,366
020132102,148,33,7,0,17,1,0,206
020132103,226,37,13,2,5,0,29,312
020132104,319,28,12,5,7,5,27,403
020132105,286,59,3,1,13,0,16,378
020132106,308,56,9,1,2,1,10,387
020132107,443,36,27,1,13,3,27,550
020132108,338,52,13,0,11,2,15,431
020132109,358,61,56,0,40,2,24,541
020132110,335,62,2,4,0,0,27,430
020132201,249,38,17,4,23,1,9,341
020132202,218,36,14,0,5,0,14,287
020132203,217,37,8,27,16,2,17,324
020132204,322,59,17,1,1,8,14,422
020132205,390,72,2,2,5,3,9,483
020132206,385,68,7,2,6,5,12,485
020132207,453,67,19,1,38,2,20,600
020132208,361,120,11,1,6,0,41,540
020132209,210,28,16,1,6,7,21,289
020132301,535,72,21,1,14,0,37,680
020132302,243,35,13,0,11,2,25,329
020132303,534,86,46,1,21,5,14,707
020132304,289,44,11,0,45,1,23,413
020132305,212,84,4,3,24,0,21,348
020132306,353,59,6,2,19,0,22,461
020132307,252,38,12,0,18,2,3,325
020132308,502,97,25,0,14,3,33,674
020132309,363,43,12,3,20,10,43,494
020132310,239,17,5,0,17,2,27,307
020132311,409,89,25,0,68,0,38,629
020132401,196,30,5,1,7,0,11,250
020132402,245,78,8,1,16,0,7,355
020132403,256,35,8,0,3,0,14,316
020132404,364,59,21,3,10,0,26,483
020132405,282,40,9,3,10,2,7,353
020132406,305,43,9,2,14,1,10,384
020132407,344,43,3,2,6,1,3,402
020132408,328,30,9,2,12,0,12,393
020132409,376,30,17,3,5,1,15,447
020132410,278,32,10,10,11,4,12,357
020132501,242,29,2,1,6,0,9,289
020132502,270,37,19,3,6,4,9,348
020132503,383,55,3,4,9,4,19,477
020132504,264,35,5,1,7,0,7,319
020132505,193,29,2,0,4,4,6,238
020132506,255,38,5,0,6,1,3,308
020132507,456,40,11,1,3,1,28,540
020132508,358,35,3,1,5,1,35,438
020132601,313,42,22,11,46,1,14,449
020132602,320,20,15,1,6,0,14,376
020132603,280,27,5,1,4,1,7,325
020132604,385,54,20,0,4,0,4,467
020132605,301,34,12,3,8,6,10,374
020132606,234,35,9,0,12,1,10,301
020132607,183,12,16,1,7,3,14,236
020132608,213,26,6,1,10,1,17,274
020132609,200,17,25,3,5,0,22,272
020132610,428,53,15,0,10,1,24,531
020132611,280,24,11,1,12,3,34,365
020132701,174,23,2,0,3,2,11,215
020132702,396,79,11,1,42,2,24,555
020132703,434,70,47,0,23,4,19,597
020132704,384,83,19,8,17,4,31,546
020132705,304,55,14,0,13,0,7,393
020132706,521,58,17,4,73,3,37,713
020132707,494,93,50,0,33,1,26,697
020132708,359,50,3,1,7,1,12,433
020132709,398,82,21,0,9,0,26,536
020132801,262,51,7,1,22,1,14,358
020132802,209,23,4,0,10,0,27,273
020132803,292,31,16,1,31,3,5,379
020132804,199,35,11,0,13,1,13,272
020132805,215,31,15,0,8,1,9,279
020132806,346,71,12,1,7,0,24,461
020132807,326,37,7,0,5,0,26,401
020132808,448,82,12,0,10,3,22,577
020132809,381,87,68,3,34,3,6,582
020132810,268,39,21,0,9,6,15,358
020132901,271,15,10,2,5,0,10,313
020132902,280,9,16,1,10,9,16,341
020132903,245,30,6,1,7,0,26,315
020132904,374,35,9,0,5,0,16,439
020132905,274,52,3,2,6,1,8,346
020132906,327,61,7,3,2,0,18,418
020132907,351,32,21,1,11,1,14,431
020132908,409,48,5,2,6,1,30,501
020132909,208,12,2,0,0,0,5,227
020132910,252,23,2,1,0,0,14,292
020132911,306,88,9,0,31,0,71,505
020140101,208,37,4,1,39,0,15,304
020140102,245,47,9,0,17,13,2,333
020140103,388,64,5,3,4,10,21,495
020140104,355,56,8,2,12,0,22,455
020140105,574,105,24,2,48,7,14,774
020140106,443,71,22,0,18,0,8,562
020140107,339,72,17,0,12,3,29,472
020140108,291,57,12,2,15,1,12,390
020140109,378,46,11,3,1,2,24,465
020140110,444,53,38,2,1,0,23,561
020140201,492,87,21,3,10,2,20,635
020140202,270,84,30,0,15,2,28,429
020140203,339,76,10,0,5,2,15,447
020140204,319,62,18,0,30,2,10,441
020140205,324,31,21,1,30,2,36,445
020140206,265,71,37,1,67,2,5,448
020140207,308,56,7,0,29,4,18,422
020140208,399,62,10,2,15,9,39,536
020140209,371,50,26,4,18,2,15,486
020140210,470,74,9,0,27,10,37,627
020140301,727,155,37,3,36,6,54,1018
020140302,222,61,5,1,47,3,27,366
020140303,225,51,10,1,58,2,7,354
020140304,297,66,13,1,15,1,22,415
020140305,401,88,24,1,13,9,28,564
020140306,162,23,12,0,6,3,23,229
020140307,289,62,7,0,5,4,17,384
020140308,400,67,76,0,9,2,31,585
020140309,441,78,41,3,29,1,25,618
020140310,307,88,16,1,11,4,14,441
020140311,346,63,36,3,7,2,7,464
020140312,299,76,39,1,14,10,15,454
020140401,405,81,9,1,18,3,9,526
020140402,220,17,10,2,7,7,10,273
020140403,214,60,11,3,8,2,14,312
020140404,292,46,11,0,22,1,14,386
020140405,368,57,11,0,14,4,22,476
020140406,451,91,40,1,20,9,37,649
020140407,430,67,14,3,6,0,83,603
020140408,475,81,22,0,3,3,14,598
020140409,401,66,33,1,31,9,45,586
020140410,671,73,24,1,52,7,41,869
020140501,351,37,8,0,0,2,10,408
020140502,356,36,9,0,1,0,12,414
020140503,407,66,13,1,6,6,28,527
020140504,264,32,32,3,23,1,13,368
020140505,482,98,19,1,17,3,22,642
020140506,275,58,11,0,12,1,30,387
020140507,215,32,12,0,8,1,13,281
020140508,180,23,8,5,5,1,8,230
020140509,495,69,12,1,1,1,22,601
020140510,517,65,21,1,12,3,41,660
020140601,482,106,71,2,16,2,20,699
020140602,345,96,62,11,23,5,46,588
020140603,339,46,19,8,10,0,16,438
020140604,349,85,5,3,13,0,43,498
020140605,368,68,2,1,11,1,10,461
020140606,470,84,19,1,9,5,16,604
020140607,355,46,21,5,2,3,22,454
020140608,237,47,17,0,8,2,13,324
020140609,385,28,20,0,8,1,82,524
020140610,212,42,8,1,9,6,6,284
020140701,352,41,39,3,20,2,21,478
020140702,407,53,52,4,23,1,39,579
020140703,283,48,23,9,7,5,25,400
020140704,399,69,87,13,4,1,4,577
020140705,255,73,9,34,28,2,21,422
020140706,289,37,8,6,12,2,23,377
020140707,226,41,16,3,40,5,10,341
020140708,228,51,17,13,47,1,10,367
020140709,254,67,34,6,23,5,14,403
020140801,297,115,46,3,19,0,9,489
020140802,282,50,37,7,18,3,15,412
020140803,169,25,16,3,3,0,10,226
020140804,241,49,6,1,7,3,9,316
020140805,459,118,26,0,10,2,29,644
020140806,451,126,15,1,12,1,23,629
020140807,289,58,26,1,7,0,10,391
020140808,296,54,10,3,12,9,4,388
020140809,459,193,51,6,34,1,35,779
020140901,481,109,45,14,30,1,51,731
020140902,301,50,34,1,4,1,32,423
020140903,502,131,36,2,28,7,28,734
020140904,533,109,32,1,60,1,30,766
020140905,193,36,25,0,0,0,1,255
020140906,295,99,8,1,11,0,13,427
020140907,257,79,19,0,2,6,14,377
020140908,377,97,23,5,8,8,37,555
020140909,362,135,34,1,19,8,20,579
020140910,401,101,32,2,44,4,49,633
020140911,389,99,45,0,8,2,48,591
020140912,345,64,45,3,11,9,33,510
020140913,340,103,43,5,12,0,23,526
020141001,6,11,0,0,1,0,2,20
020141101,281,24,50,3,5,0,39,402
020141102,464,101,66,0,79,17,33,760
020141103,230,73,1,1,1,6,22,334
020141104,271,76,8,5,11,5,11,387
020141105,375,100,14,2,32,9,21,553
020141106,350,85,9,3,24,2,31,504
020141107,265,70,31,0,41,4,15,426
020141108,522,120,38,3,13,8,41,745
020141109,395,101,54,4,22,3,27,606
020141110,204,53,8,0,13,5,30,313
020141111,306,91,37,0,10,2,21,467
020141112,357,81,25,2,17,9,21,512
020141113,393,133,45,1,13,12,76,673
020141114,211,65,13,0,4,3,37,333
020141201,218,57,18,0,14,0,8,315
020141202,374,80,34,0,18,0,18,524
020141203,321,112,75,2,27,4,18,559
020141204,343,82,6,1,6,1,21,460
020141205,366,53,20,5,16,7,33,500
020141206,260,58,16,0,8,3,11,356
020141207,144,12,7,0,10,1,12,186
020141208,186,50,12,0,4,0,29,281
020141209,318,36,26,0,4,0,10,394
020141210,351,119,46,1,21,17,49,604
020141211,269,54,8,1,10,0,13,355
020141301,249,12,16,3,12,2,5,299
020141302,309,73,18,1,16,1,27,445
020141303,386,76,95,2,13,3,16,591
020141304,239,43,2,0,13,1,17,315
020141305,299,51,23,3,19,1,35,431
020141306,273,42,33,2,25,7,25,407
020141307,138,24,17,0,2,1,6,188
020141308,264,28,25,1,12,1,18,349
020141309,304,55,24,2,7,4,34,430
020141310,271,31,19,6,17,1,19,364
020141311,236,44,26,1,3,1,10,321
020141312,238,36,19,4,10,0,13,320
020141401,454,81,20,1,15,15,25,611
020141402,287,66,31,1,26,1,23,435
020141403,355,92,43,0,14,3,34,541
020141404,194,26,15,0,5,0,10,250
020141405,159,25,23,1,14,12,7,241
020141406,200,46,8,2,5,2,7,270
020141407,169,22,3,1,13,1,66,275
020141408,454,80,31,1,12,7,22,607
020141409,476,99,69,0,24,14,30,712
020141410,340,83,16,0,6,5,13,463
020141411,402,62,8,3,12,11,31,529
020141501,284,52,43,0,14,3,19,415
020141502,343,66,82,0,10,0,26,527
020141503,343,93,22,2,13,2,13,488
020141504,373,84,14,2,22,6,9,510
020141505,441,72,33,1,11,7,41,606
020141506,410,54,30,1,6,16,53,570
020141507,344,79,21,1,20,6,18,489
020141508,838,162,42,2,62,8,39,1153
020141601,575,94,16,0,14,16,22,737
020141602,329,89,9,1,98,5,25,556
020141603,517,76,44,5,38,9,58,747
020141604,397,129,9,0,39,1,36,611
020141605,359,96,34,3,11,12,6,521
020141606,122,39,8,1,0,0,9,179
020141607,321,44,14,2,2,7,39,429
020141701,338,60,13,0,4,1,38,454
020141702,369,101,14,2,27,5,39,557
020141703,329,69,16,4,2,6,13,439
020141704,197,56,2,2,69,7,38,371
020141705,324,100,19,6,46,7,9,511
020141706,271,29,23,2,31,4,23,383
020141707,311,50,8,0,47,2,17,435
020141708,611,112,28,0,21,15,31,818
020141801,354,94,23,1,20,7,16,515
020141802,300,61,13,3,16,6,12,411
020141803,454,81,15,1,5,6,25,587
020141804,370,66,33,3,16,2,24,514
020141805,463,117,13,3,51,13,55,715
020141806,341,49,20,6,5,8,25,454
020141807,278,34,13,14,21,9,12,381
020141808,473,93,46,1,17,23,25,678
020141901,272,49,17,1,13,3,8,363
020141902,516,128,27,6,27,22,32,758
020141903,528,119,42,24,6,14,24,757
020141904,615,158,21,3,44,6,54,901
020141905,631,92,25,0,43,12,25,828
020142001,566,85,8,2,16,10,47,734
020142002,653,134,46,3,45,12,63,956
020142003,453,65,33,2,43,7,32,635
020142004,345,68,10,0,10,2,13,448
020142005,372,53,9,0,22,8,39,503
020142006,274,36,25,2,29,11,30,407
020142007,163,24,1,0,6,2,24,220
020142101,391,63,25,3,20,0,65,567
020142102,265,35,19,3,34,1,12,369
020142103,142,38,11,1,19,4,5,220
020142104,251,58,9,1,9,4,7,339
020142105,157,30,2,4,47,1,7,248
020142106,238,57,28,3,7,1,10,344
020142107,302,61,13,1,12,3,8,400
020142108,321,71,11,1,6,6,7,423
020142109,261,31,10,2,28,4,4,340
020142110,245,42,13,1,6,3,19,329
020142111,262,49,7,5,14,0,13,350
020142201,365,81,20,1,9,3,6,485
020142202,393,49,11,1,13,2,24,493
020142203,233,45,10,2,14,3,2,309
020142204,236,49,12,5,7,6,6,321
020142205,402,59,11,1,11,6,20,510
020142206,349,65,23,1,6,1,12,457
020142207,298,41,10,1,12,0,5,367
020142208,325,48,5,1,7,4,20,410
020142209,495,99,54,0,34,2,60,744
020142210,312,60,21,6,14,4,13,430
020142301,266,67,15,0,7,0,7,362
020142302,216,53,7,1,4,6,2,289
020142303,234,25,5,1,11,6,2,284
020142304,337,66,14,2,20,4,20,463
020142305,504,136,57,1,17,8,22,745
020142306,188,54,4,2,9,0,17,274
020142307,292,56,6,0,14,2,12,382
020142308,436,69,12,2,12,2,18,551
020142309,423,94,26,1,6,2,68,620
020142310,372,99,25,1,18,6,19,540
020142311,451,128,25,0,12,1,38,655
020142401,293,60,42,2,13,7,16,433
020142402,214,68,14,0,5,3,11,315
020142403,256,57,10,1,16,5,9,354
020142404,199,35,25,0,3,2,7,271
020142405,422,92,26,0,9,15,25,589
020142406,319,61,36,1,5,8,12,442
020142407,322,60,27,0,11,12,11,443
020142408,264,78,8,1,3,6,12,372
020142409,346,60,16,0,14,4,17,457
020142501,370,60,10,3,33,3,37,516
020142502,215,34,37,0,8,4,10,308
020142503,349,58,46,0,40,6,15,514
020142504,282,55,20,3,17,12,13,402
020142505,235,41,4,0,7,6,5,298
020142506,266,64,33,0,25,0,12,400
020142507,371,61,23,9,3,8,23,498
020142508,349,49,27,0,4,1,23,453
020142509,390,66,24,0,24,14,25,543
020142601,518,89,32,1,43,11,37,731
020142602,351,58,8,3,30,4,13,467
020142603,183,29,7,0,7,3,26,255
020142604,784,159,38,3,17,4,27,1032
020142605,434,122,11,2,15,9,16,609
020142606,379,60,14,2,30,8,28,521
020142607,525,83,24,3,97,6,43,781
020142701,602,140,33,0,36,4,39,854
020142702,558,184,33,3,49,13,25,865
020142703,283,68,14,1,66,6,9,447
020142704,394,112,95,0,37,10,27,675
020142705,475,119,42,10,19,5,30,700
020142706,212,52,3,0,4,6,40,317
020142707,217,46,0,1,32,5,10,311
020142801,280,45,4,0,15,4,13,361
020142802,263,48,7,1,23,3,10,355
020142803,284,32,13,0,13,10,17,369
020142804,306,59,8,0,9,4,9,395
020142805,228,42,1,0,23,2,4,300
020142806,405,66,25,0,21,6,29,552
020142807,362,76,6,1,97,9,34,585
020142808,298,79,31,3,37,8,19,475
020142809,258,97,6,0,8,3,11,383
020142810,377,119,44,0,14,8,21,583
020142811,389,55,16,1,13,5,13,492
020142812,267,88,6,0,42,10,15,428
020142901,269,62,21,2,39,5,9,407
020142902,280,74,14,1,9,8,8,394
020142903,262,51,47,0,28,5,60,453
020142904,352,84,30,0,9,9,42,526
020142905,276,125,27,1,28,6,31,494
020142906,441,96,40,3,61,9,28,678
020142907,367,77,52,2,81,3,35,617
020142908,266,20,21,0,29,5,34,375
020142909,335,90,8,1,13,1,8,456
020142910,359,58,17,1,41,0,26,502
020142911,280,55,20,2,28,1,46,432
020143001,321,77,32,0,50,1,34,515
020143002,413,137,15,2,19,7,33,626
020143003,383,139,55,4,11,14,20,626
020143004,300,104,21,1,30,17,66,539
020143005,375,83,24,6,13,22,11,534
020143006,229,57,4,1,13,9,4,317
020143007,203,51,10,0,31,3,16,314
020143008,667,132,31,8,10,9,32,889
020143009,571,91,44,3,53,11,34,807
020143101,217,85,30,28,16,2,28,406
020143102,317,86,9,4,5,8,10,439
020143103,279,45,26,2,11,10,40,413
020143104,249,48,11,2,1,1,34,346
020143105,239,27,10,0,8,6,29,319
020143106,376,124,31,2,14,7,55,609
020143107,314,59,6,2,3,6,28,418
020143108,267,126,14,7,76,1,34,525
020143109,224,63,15,5,11,5,15,338
020143110,189,68,7,3,0,1,12,280
020143111,214,44,21,6,18,2,21,326
020143112,258,58,23,4,11,7,22,383
020150101,409,64,21,2,7,1,23,527
020150102,341,23,16,2,2,1,26,411
020150103,266,49,6,4,4,0,9,338
020150104,227,14,10,1,10,0,13,275
020150105,259,35,2,2,2,0,6,306
020150106,255,16,1,0,2,0,5,279
020150107,289,35,7,4,1,0,7,343
020150108,265,17,21,3,0,0,9,315
020150109,332,37,3,0,11,0,11,394
020150110,332,37,6,2,3,1,15,396
020150111,214,23,9,2,8,1,15,272
020150112,283,33,6,1,2,0,9,334
020150201,271,29,7,3,3,0,17,330
020150202,290,16,3,0,4,0,15,328
020150203,279,22,5,2,4,0,23,335
020150204,202,23,5,3,2,0,10,245
020150205,198,28,3,1,6,0,6,242
020150206,267,17,3,3,1,0,16,307
020150207,260,29,2,0,2,0,13,306
020150208,227,16,8,1,1,0,19,272
020150209,206,8,27,2,7,0,18,268
020150210,229,28,12,0,2,0,13,284
020150301,286,39,11,1,9,2,8,356
020150302,387,40,30,2,9,1,9,478
020150303,369,19,7,0,5,4,13,417
020150304,257,32,2,1,1,2,7,302
020150305,230,15,8,7,3,1,10,274
020150306,264,31,7,2,5,0,14,323
020150307,244,44,4,6,2,0,9,309
020150308,315,31,13,3,4,3,11,380
020150309,347,38,6,2,5,3,38,439
020150310,336,30,16,2,8,0,35,427
020150311,335,39,10,1,5,1,9,400
020150312,396,22,11,6,8,1,12,456
020150313,259,38,13,0,10,1,16,337
020150401,329,54,15,4,9,0,12,423
020150402,240,29,12,4,6,0,37,328
020150403,389,69,13,3,12,1,27,514
020150404,204,21,4,0,1,0,5,235
020150405,210,17,17,2,2,1,15,264
020150406,266,26,4,5,5,0,18,324
020150407,292,37,4,2,17,0,13,365
020150408,272,44,12,0,8,0,7,343
020150409,240,38,10,1,10,0,5,304
020150410,226,32,12,1,11,0,19,301
020150411,279,37,2,1,4,0,8,331
020150412,288,41,34,0,6,2,5,376
020150413,312,62,12,3,11,1,13,414
020150414,261,49,5,0,0,1,8,324
020150501,297,47,11,1,20,1,19,396
020150502,325,48,5,6,4,0,9,397
020150503,271,25,13,0,1,1,9,320
020150504,225,40,6,1,8,1,2,283
020150505,294,30,6,4,2,2,24,362
020150506,276,29,8,2,3,0,13,331
020150507,272,34,10,0,3,1,9,329
020150508,315,28,18,3,7,0,24,395
020150509,239,23,1,1,2,0,9,275
020150510,204,28,2,0,1,0,13,248
020150511,247,28,4,2,6,0,18,305
020150512,242,24,12,2,1,1,29,311
020150513,276,44,25,3,5,0,11,364
020150514,247,19,6,4,4,2,8,290
020150601,289,38,5,0,7,0,15,354
020150602,266,40,14,0,9,0,19,348
020150603,271,38,15,1,5,0,11,341
020150604,246,33,4,0,4,0,13,300
020150605,182,31,6,0,4,0,10,233
020150606,171,10,2,1,2,0,2,188
020150607,238,30,8,2,3,0,17,298
020150701,285,18,5,2,4,0,15,329
020150702,213,19,3,1,2,0,7,245
020150703,226,16,5,1,1,0,5,254
020150704,192,20,7,2,7,2,7,237
020150705,277,38,4,2,4,1,3,329
020150706,281,17,7,4,3,4,7,323
020150707,340,1,13,0,6,2,43,405
020150708,294,22,3,0,0,0,6,325
020150709,262,27,10,2,1,0,11,313
020150710,371,22,26,4,9,1,14,447
020150711,315,31,7,0,6,0,23,382
020150712,309,27,4,4,10,0,7,361
020150801,259,42,10,4,10,0,11,336
020150802,205,15,5,2,3,0,19,249
020150803,364,20,8,2,27,2,21,444
020150804,306,16,13,1,18,1,15,370
020150805,271,31,6,1,5,2,8,324
020150806,243,22,16,3,20,1,19,324
020150807,348,53,15,7,4,0,20,447
020150808,317,20,5,0,1,1,16,360
020150809,390,44,18,3,11,0,16,482
020150810,375,42,7,2,14,2,25,467
020150901,224,47,15,0,1,2,1,290
020150902,204,19,7,0,3,0,9,242
020150903,221,22,11,0,10,2,14,280
020150904,226,29,3,1,5,1,14,279
020150905,230,43,2,2,7,0,12,296
020150906,210,22,16,0,6,0,6,260
020150907,245,61,1,2,14,2,6,331
020150908,585,14,15,7,14,0,23,658
020151001,300,65,18,0,12,3,6,404
020151002,333,49,4,2,3,0,16,407
020151003,396,34,17,4,7,1,11,470
020151004,330,53,12,2,5,1,29,432
020151005,272,38,8,2,5,0,13,338
020151006,213,38,2,1,7,1,19,281
020151007,382,73,17,0,16,5,15,508
020151008,278,49,5,2,11,1,11,357
020151009,286,26,16,0,16,0,8,352
020151010,242,50,15,5,17,0,13,342
020151011,246,40,4,0,11,1,14,316
020151012,310,33,13,0,16,5,19,396
020151013,361,32,11,2,9,0,30,445
020151101,291,76,3,1,48,0,4,423
020151102,324,88,18,3,140,1,15,589
020151103,302,28,8,2,7,0,28,375
020151104,285,26,4,3,6,3,10,337
020151105,226,38,29,0,14,2,11,320
020151106,232,31,5,0,7,0,13,288
020151107,245,36,7,0,6,0,11,305
020151108,264,35,8,2,6,1,15,331
020151109,358,43,11,14,10,1,16,453
020151110,261,47,8,2,7,1,7,333
020151111,516,69,44,0,20,4,27,680
020151112,372,57,8,0,3,0,17,457
020151113,354,56,1,0,6,0,32,449
020151201,221,37,2,1,2,0,8,271
020151202,278,42,11,1,7,2,4,345
020151203,290,51,13,1,2,0,12,369
020151204,308,69,13,2,5,0,18,415
020151205,331,44,19,1,0,1,7,403
020151206,294,33,12,3,4,3,47,396
020151207,231,19,4,1,6,3,9,273
020151208,331,59,27,1,10,0,30,458
020151209,244,43,5,4,5,0,8,309
020151301,294,57,18,3,6,0,12,390
020151302,252,54,11,1,14,1,14,347
020151303,298,49,3,0,3,1,10,364
020151304,255,25,23,1,14,1,24,343
020151305,209,21,10,0,1,0,2,243
020151306,233,31,4,6,5,0,11,290
020151307,282,42,5,1,2,0,8,340
020151308,189,39,5,0,4,3,7,247
020151309,458,62,27,1,13,1,6,568
020151310,295,31,10,0,4,2,28,370
020151401,339,26,23,1,4,0,21,414
020151402,385,58,8,5,2,2,13,473
020151403,276,34,20,0,40,1,4,375
020151404,305,31,14,0,9,0,20,379
020151405,413,41,32,0,3,0,17,506
020151406,276,47,11,0,4,1,3,342
020151407,388,80,6,0,1,1,10,486
020151408,303,52,17,1,10,1,7,391
020151409,321,20,24,3,9,2,1,380
020151410,266,33,14,1,7,3,21,345
020151411,342,24,2,0,5,1,9,383
020151501,290,27,2,0,12,1,31,363
020151502,226,14,5,0,2,1,9,257
020151503,394,18,7,0,1,1,13,434
020151504,313,29,0,4,6,0,26,378
020151505,286,32,13,1,21,1,5,359
020151506,277,12,7,0,4,0,28,328
020151507,351,43,15,0,12,1,11,433
020151508,254,46,10,2,9,1,18,340
020151509,408,75,22,2,5,1,18,531
020151510,393,50,7,2,6,0,15,473
020151601,311,26,13,0,5,0,27,382
020151602,279,22,13,4,7,0,28,353
020151603,361,38,12,6,13,0,24,454
020151604,284,46,10,5,3,1,13,362
020151605,256,53,9,0,6,3,9,336
020151606,302,36,6,2,2,1,30,379
020151607,297,31,11,2,6,0,22,369
020151608,348,29,4,2,30,2,41,456
020151609,303,39,21,1,17,0,13,394
020151610,327,47,28,4,8,0,21,435
020151611,305,27,12,0,9,0,6,359
020151701,312,28,6,0,3,0,16,365
020151702,250,43,6,0,6,3,8,316
020151703,362,52,7,0,6,0,12,439
020151704,367,55,4,2,2,1,12,443
020151705,349,51,13,1,9,2,10,435
020151706,295,36,8,0,4,4,9,356
020151707,330,31,3,1,23,0,23,411
020151708,269,38,3,1,7,0,15,333
020151709,262,23,12,0,1,0,12,310
020151710,319,37,33,3,16,0,15,423
020151711,339,40,19,6,6,1,7,418
020151712,284,50,2,0,5,0,11,352
020151801,257,54,5,0,9,1,4,330
020151802,201,15,1,1,2,0,12,232
020151803,301,29,12,1,31,0,46,420
020151804,206,9,3,0,11,0,6,235
020151805,208,40,12,0,0,0,18,278
020151806,209,13,13,4,7,1,6,253
020151807,276,27,6,0,3,1,13,326
020151808,217,22,2,2,4,2,10,259
020151809,222,32,0,0,1,0,12,267
020151810,237,24,5,3,4,1,4,278
020151811,290,26,8,1,3,3,7,338
020151812,232,32,46,2,1,0,4,317
020151813,250,26,5,0,2,0,21,304
020151901,229,27,7,1,9,0,17,290
020151902,327,32,23,0,37,3,18,440
020151903,284,59,9,2,6,1,14,375
020151904,338,48,11,2,7,3,20,429
020151905,377,88,5,0,5,1,16,492
020151906,334,32,15,0,12,1,14,408
020151907,370,49,18,0,7,2,22,468
020151908,291,39,16,1,25,1,15,388
020151909,283,22,35,0,13,1,16,370
020151910,380,25,12,2,16,0,15,450
020151911,380,58,26,2,10,2,10,488
020152001,340,27,17,0,8,6,19,417
020152002,361,57,46,0,50,2,19,535
020152003,336,52,2,1,34,1,34,460
020152004,262,46,10,1,3,1,11,334
020152005,267,47,11,0,16,0,9,350
020152006,307,40,5,2,6,0,28,388
020152007,279,20,10,1,4,2,25,341
020152008,242,46,8,1,1,0,9,307
020152009,218,32,5,0,1,0,9,265
020152010,308,36,11,5,9,0,17,386
020152011,327,44,16,7,14,2,11,421
020152012,320,64,20,0,17,1,30,452
020152101,316,48,2,5,3,2,7,383
020152102,361,48,12,2,5,0,24,452
020152103,264,44,8,3,5,3,16,343
020152104,323,20,32,2,15,3,7,402
020152105,196,21,4,0,1,0,10,232
020152106,402,48,23,5,4,1,11,494
020152107,171,21,5,1,3,3,13,217
020152108,256,45,4,0,7,0,8,320
020152109,379,80,24,3,4,5,13,508
020152110,274,26,68,0,5,0,14,387
020152111,324,64,13,0,4,1,32,438
020152112,215,50,3,0,1,0,7,276
020152113,382,66,13,1,11,2,21,496
060280101,306,0,6,4,0,1,9,326
060280102,240,7,0,0,0,0,0,247
060280103,312,12,0,2,0,0,5,331
060280104,293,21,5,11,1,0,9,340
060280105,196,14,4,0,0,0,1,215
060280106,241,10,0,0,1,0,7,259
060280107,306,14,1,18,0,0,14,353
060280108,354,6,0,1,0,1,7,369
060280109,446,17,3,3,0,0,6,475
060280110,218,12,4,2,2,0,3,241
060280111,378,22,1,1,0,0,9,411
060280112,297,14,0,1,0,0,3,315
060280113,236,2,3,0,0,1,7,249
060280114,292,18,0,1,0,0,3,314
060280115,392,10,4,2,1,2,25,436
060280201,369,3,1,4,0,0,4,381
060280202,280,2,0,1,0,0,10,293
060280203,370,5,4,4,4,0,6,393
060280204,382,10,0,0,0,0,1,393
060280205,236,5,0,0,3,0,5,249
060280206,312,2,0,0,0,3,2,319
060280207,279,9,1,2,1,1,2,295
060280208,262,4,0,0,0,0,5,271
060280301,420,17,3,4,0,0,10,454
060280302,393,2,0,5,0,0,7,407
060280303,408,9,0,1,0,0,9,427
060280304,212,2,1,0,0,0,4,219
060280305,270,0,1,0,0,0,4,275
060280306,177,1,0,0,0,0,2,180
060280307,289,0,0,3,0,0,2,294
060280308,517,1,2,0,0,0,8,528
060280309,246,1,2,0,0,0,2,251
060280310,309,1,1,0,1,0,2,314
060280311,236,0,1,0,0,0,4,241
060280312,226,4,0,1,0,0,3,234
060280401,357,1,1,1,1,0,3,364
060280402,280,3,1,3,0,0,6,293
060280403,257,1,0,0,0,0,1,259
060280404,277,0,0,1,0,0,0,278
060280405,313,0,0,3,1,0,7,324
060280406,269,0,0,1,0,0,2,272
060280407,329,0,0,0,0,0,8,337
060280408,374,0,0,2,2,0,1,379
060280409,352,0,1,3,0,1,5,362
060280410,307,0,0,2,0,0,1,310
060280411,339,2,1,3,0,0,4,349
060280412,418,3,4,0,2,0,9,436
060280501,19,0,0,1,0,0,1,21
060280502,24,0,0,0,0,0,0,24
060280503,11,1,0,0,0,0,0,12
060280504,269,0,2,0,0,1,4,276
060280505,19,0,0,0,0,0,1,20
060280506,186,6,0,0,1,0,3,196
060280507,92,0,0,0,0,0,0,92
060280508,72,0,0,0,0,0,0,72
060280509,55,0,0,2,0,0,0,57
060280510,59,0,1,0,0,0,0,60
060280511,246,0,3,1,0,0,5,255
060280512,29,0,0,0,0,0,1,30
060280513,309,1,0,1,1,2,5,319
060280601,373,10,4,2,1,0,8,398
060280602,611,2,9,4,2,2,24,654
060280603,346,3,4,4,12,0,3,372
060280604,1030,9,5,2,2,1,10,1059
060280605,460,0,2,0,2,0,10,474
060280606,502,2,1,0,1,0,6,512
060280607,327,7,0,1,0,0,10,345
060280608,213,1,0,1,1,0,7,223
060280609,325,6,0,1,0,0,15,347
060280610,826,10,4,1,0,0,10,851
060280611,241,6,2,4,0,0,1,254
060280612,242,3,1,3,0,0,6,255
060280613,240,13,2,0,0,0,0,255
060280614,700,5,5,1,9,2,11,733
060280615,854,11,4,8,5,0,8,890
060280701,521,4,2,3,1,1,6,538
060280702,433,4,0,3,0,0,13,453
060280703,458,6,1,2,0,0,11,478
060280704,345,10,1,8,0,0,10,374
060280705,344,4,2,0,0,0,3,353
060280706,411,24,1,4,1,2,11,454
060280707,593,19,7,5,1,3,62,690
060280708,262,6,0,3,2,2,6,281
060280709,314,19,6,3,0,0,13,355
060280710,318,17,3,5,0,1,14,358
060280711,403,16,2,6,2,1,6,436
060280801,79,0,2,0,0,0,1,82
060280802,66,0,0,0,0,0,0,66
060280803,15,0,0,0,0,0,0,15
060280804,54,0,0,0,0,0,3,57
060280805,264,0,1,1,0,0,6,272
060280806,253,0,1,3,0,0,3,260
060280807,242,0,3,5,0,0,5,255
060280808,328,2,3,4,2,0,7,346
060280809,27,0,0,0,0,0,1,28
060280810,463,3,9,4,1,1,5,486
060280811,426,0,5,3,1,1,18,454
060280812,345,3,5,1,2,2,7,365
060280813,361,1,6,5,6,2,13,394
060280901,389,0,3,2,0,0,2,396
060280902,328,1,1,3,0,0,4,337
060280903,277,1,0,1,0,0,4,283
060280904,490,0,2,3,0,2,5,502
060280905,288,3,0,2,0,1,12,306
060280906,368,2,6,1,0,2,13,392
060280907,256,3,0,1,0,1,3,264
060280908,332,1,1,1,1,0,8,344
060280909,484,4,4,8,2,1,7,510
060281001,217,1,3,0,0,0,2,223
060281002,219,1,1,0,4,0,5,230
060281003,323,2,4,4,0,1,7,341
060281004,202,4,2,0,0,0,4,212
060281005,233,1,1,1,0,0,5,241
060281006,219,0,0,0,0,1,5,225
060281007,235,0,1,0,0,0,3,239
060281008,406,0,6,3,0,3,10,428
060281009,266,0,3,3,0,0,6,278
060281010,286,1,1,2,2,0,2,294
060281011,269,0,0,1,0,0,16,286
060281012,253,0,0,0,0,0,1,254
060281013,497,7,2,3,0,0,11,520
060281014,323,12,4,2,0,0,7,348
060281015,255,12,1,6,0,0,9,283
060281016,303,3,5,2,1,0,2,316
060281017,233,6,4,5,1,1,7,257
060281101,284,6,2,2,2,0,4,300
060281102,264,10,7,2,0,0,5,288
060281103,227,14,1,4,0,0,1,247
060281104,217,9,2,5,1,1,3,238
060281105,221,14,3,5,2,0,13,258
060281106,199,13,3,2,2,0,3,222
060281107,201,17,3,7,2,0,9,239
060281108,106,11,3,2,2,0,7,131
060281109,443,27,1,6,3,1,18,499
060281110,458,31,2,4,1,0,15,511
060281111,487,24,7,5,1,2,11,537
060281112,238,13,0,4,0,1,3,259
060281113,212,12,2,4,0,0,23,253
060281201,376,25,3,4,0,0,20,428
060281202,321,29,3,4,4,0,12,373
060281203,408,34,18,3,7,1,15,486
060281204,318,45,11,1,3,3,10,391
060281205,309,31,5,8,2,1,17,373
060281206,189,18,18,3,4,6,10,248
060281207,270,41,9,6,7,1,8,342
060281208,310,19,20,4,9,3,12,377
060281209,331,19,5,1,2,0,16,374
060281210,382,16,4,6,0,1,12,421
060281211,358,20,7,8,0,1,5,399
060281301,385,23,7,7,0,1,7,430
060281302,230,16,1,3,0,1,2,253
060281303,211,14,2,1,0,1,5,234
060281304,421,8,2,2,0,0,3,436
060281305,300,16,2,8,0,2,12,340
060281306,297,14,1,5,1,0,1,319
060281307,234,6,1,2,0,0,3,246
060281308,311,7,1,5,0,0,1,325
060281309,329,10,3,6,0,0,17,365
060281310,372,13,3,5,0,1,1,395
060281311,319,8,1,1,1,0,3,333
060281312,270,9,5,3,1,2,6,296
060281313,197,5,2,2,0,0,2,208
060281401,354,5,0,3,0,0,8,370
060281402,281,3,0,0,0,0,7,291
060281403,431,14,5,3,2,1,5,461
060281404,404,10,2,3,1,0,1,421
060281405,352,13,5,4,2,0,4,380
060281406,403,16,1,1,0,1,3,425
060281407,379,7,2,1,0,0,6,395
060281408,245,2,1,1,0,0,1,250
060281409,244,7,0,4,0,2,5,262
060281410,260,5,0,2,0,0,0,267
060281501,228,4,3,3,0,0,5,243
060281502,209,3,0,3,1,1,9,226
060281503,274,5,1,2,0,0,5,287
060281504,231,3,1,2,0,0,5,242
060281505,272,7,1,2,0,2,6,290
060281506,248,5,2,9,1,0,8,273
060281507,426,19,7,3,4,0,7,466
060281508,219,7,3,5,4,4,9,251
060281509,430,23,4,11,1,3,14,486
060281510,317,16,2,0,1,1,14,351
060281511,194,9,0,1,1,2,4,211
060281512,255,11,4,5,1,0,5,281
060281601,273,3,2,0,0,0,1,279
060281602,359,0,0,0,0,0,1,360
060281603,539,31,0,0,0,0,1,571
060281604,290,11,0,0,0,0,3,304
060281605,282,9,0,0,1,0,1,293
060281606,371,14,0,0,0,0,9,394
060281607,217,4,1,0,0,0,5,227
060281608,274,19,1,0,1,0,5,300
060281701,244,14,1,0,1,1,2,263
060281702,310,17,0,0,1,0,4,332
060281703,161,3,0,0,0,0,3,167
060281704,242,9,0,1,0,0,0,252
060281705,253,24,0,0,0,0,5,282
060281706,427,24,0,0,3,1,13,468
060281707,327,21,1,0,0,0,7,356
060281708,282,9,0,0,3,0,11,305
060281709,282,13,0,0,0,0,3,298
060281801,380,23,0,1,0,1,11,416
060281802,273,10,0,0,1,0,12,296
060281803,416,13,3,1,0,1,7,441
060281804,205,4,1,1,3,0,4,218
060281805,221,3,0,0,0,0,5,229
060281806,441,19,1,4,2,1,3,471
060281807,281,7,1,3,0,0,3,295
060281808,392,7,6,7,0,0,4,416
060281809,278,10,0,7,0,0,5,300
060281810,287,4,0,0,0,0,1,292
060281811,237,16,1,1,1,0,3,259
060281901,329,8,0,0,0,0,2,339
060281902,331,12,1,0,1,0,14,359
060281903,367,11,0,0,0,6,14,398
060281904,343,9,0,1,2,2,6,363
060281905,166,7,0,3,0,1,5,182
060281906,88,2,2,1,0,2,2,97
060281907,273,14,1,20,0,0,22,330
060281908,327,36,2,0,2,18,40,425
060281909,387,19,1,0,1,0,8,416
060281910,252,108,1,0,0,0,16,377
060281911,332,9,1,1,0,0,8,351
060281912,277,4,0,2,1,0,7,291
060281913,177,14,0,1,0,0,3,195
060282001,385,18,2,6,0,2,6,419
060282002,303,11,4,1,0,0,7,326
060282003,182,6,1,1,0,0,3,193
060282004,474,16,1,4,0,0,8,503
060282005,276,13,2,11,0,1,8,311
060282006,345,13,4,0,0,0,16,378
060282007,233,3,0,7,1,1,13,258
060282008,263,14,0,2,1,0,3,283
060282009,274,10,2,1,0,0,4,291
060282010,304,0,1,0,0,0,4,309
060282011,258,2,1,2,0,1,5,269
060282012,166,24,2,5,5,5,26,233
060282013,372,12,1,7,0,2,24,418
060282014,308,5,2,5,0,2,12,334
060282015,357,16,4,10,0,0,5,392
060282101,181,12,1,0,1,0,7,202
060282102,225,7,2,3,3,0,8,248
060282103,366,13,6,2,2,0,5,394
060282104,234,15,3,2,1,2,3,260
060282105,279,12,2,7,1,0,12,313
060282106,202,16,5,4,1,4,11,243
060282107,289,33,5,7,0,5,7,346
060282108,289,17,3,12,0,3,18,342
060282109,284,4,0,3,0,0,9,300
060282110,192,7,0,3,0,1,7,210
060282111,304,13,2,1,0,0,7,327
060282112,264,30,1,1,3,0,1,300
060282113,245,16,1,3,1,3,10,279
060282201,144,8,2,2,0,0,6,162
060282202,269,13,3,2,0,3,13,303
060282203,332,5,2,5,1,1,6,352
060282204,243,10,0,1,0,0,8,262
060282205,392,11,1,3,0,0,10,417
060282206,374,14,1,8,0,1,4,402
060282207,181,7,1,3,0,0,5,197
060282208,221,5,2,0,0,0,6,234
060282209,344,7,2,0,1,0,3,357
060282210,450,10,0,1,0,0,9,470
060282211,267,8,2,0,1,0,16,294
060282212,241,5,4,4,1,2,10,267
060282213,241,7,3,0,0,1,8,260
060282214,230,6,2,4,0,0,4,246
060282215,199,7,1,2,0,0,12,221
060282216,471,13,0,1,2,1,12,500
060282217,167,10,2,2,0,0,0,181
060282218,206,3,4,0,0,0,8,221
060282301,406,12,5,3,1,0,13,440
060282302,400,9,3,3,5,2,16,438
060282303,234,18,2,2,0,0,6,262
060282304,352,18,5,2,4,2,7,390
060282305,231,15,3,5,0,1,4,259
060282306,301,20,11,5,1,1,13,352
060282307,331,25,2,2,6,0,14,380
060282308,195,20,2,3,0,0,3,223
060282309,265,4,5,2,0,3,3,282
060282310,251,7,1,0,2,0,11,272
060282311,242,16,8,2,0,3,5,276
060282312,200,8,7,8,0,0,8,231
060282313,200,12,6,1,1,0,12,232
060282401,366,0,7,3,2,2,13,393
060282402,306,2,2,6,1,1,10,328
060282403,282,3,7,6,0,2,12,312
060282404,384,1,9,1,0,0,8,403
060282405,416,0,2,3,0,0,12,433
060282406,327,18,5,8,0,0,5,363
060282407,364,13,13,6,2,4,18,420
060282408,315,25,4,6,5,0,10,365
060282409,338,17,11,1,11,0,8,386
060282501,235,17,5,6,0,1,9,273
060282502,325,26,22,12,33,2,18,438
060282503,188,24,16,0,78,0,20,326
060282504,178,24,40,0,45,1,23,311
060282505,351,47,10,5,42,1,15,471
060282506,351,29,5,12,5,1,17,420
060282507,213,47,37,5,18,0,13,333
060282508,197,20,18,2,7,6,7,257
060282509,191,11,11,5,4,1,9,232
060282510,364,34,15,12,6,3,17,451
060282511,376,18,10,11,10,5,20,450
060282512,267,23,2,7,9,1,12,321
060282513,293,28,4,5,0,0,15,345
060282601,157,11,13,3,1,0,5,190
060282602,126,4,11,1,0,0,2,144
060282603,234,18,11,4,0,0,4,271
060282604,241,28,11,1,0,0,6,287
060282605,224,17,0,0,0,0,2,243
060282606,199,9,2,2,1,0,4,217
060282607,141,5,0,0,0,0,1,147
060282608,171,16,19,24,1,0,6,237
060282609,280,15,14,2,1,0,4,316
060282610,157,3,3,2,1,0,7,173
060282611,144,8,2,3,3,0,5,165
060282612,119,3,6,0,0,0,2,130
060282701,206,14,1,2,0,1,1,225
060282702,281,13,4,2,0,0,20,320
060282703,318,6,5,0,1,0,4,334
060282704,296,13,6,6,1,1,9,332
060282705,241,8,3,9,0,5,1,267
060282706,304,2,4,4,0,1,4,319
060282707,147,4,1,1,0,1,4,158
060282708,421,11,5,2,0,1,13,453
060282709,140,5,4,1,0,0,5,155
060282710,150,18,4,1,0,1,1,175
060282711,234,18,2,7,1,0,6,268
060282712,304,14,8,12,1,1,11,351
060282713,324,21,12,8,2,0,34,401
060282801,318,7,0,1,0,2,6,334
060282802,213,4,3,2,0,0,21,243
060282803,353,7,4,2,0,0,6,372
060282804,301,6,1,3,0,0,4,315
060282805,411,16,1,1,0,2,8,439
060282806,449,19,1,4,0,0,15,488
060282807,360,25,6,2,2,1,7,403
060282808,209,11,0,4,0,1,0,225
060282809,298,7,4,0,1,0,3,313
060282810,283,0,1,0,0,0,4,288
060282811,111,13,19,0,0,0,4,147
060282901,298,8,0,6,1,0,5,318
060282902,220,7,7,2,0,2,15,253
060282903,296,13,3,3,1,1,14,331
060282904,257,10,1,4,0,2,8,282
060282905,252,5,0,1,0,0,5,263
060282906,192,13,1,0,0,0,3,209
060282907,248,6,1,4,0,1,2,262
060282908,255,6,0,4,1,0,1,267
060282909,291,10,2,4,0,0,1,308
060282910,220,14,1,1,0,1,4,241
060282911,294,3,3,1,2,0,5,308
060282912,254,3,2,3,1,0,5,268
060282913,262,7,0,5,0,0,7,281
060283001,230,7,3,0,0,0,2,242
060283002,221,4,0,0,0,0,3,228
060283003,191,7,1,5,0,0,92,296
060283004,289,6,1,21,0,0,2,319
060283005,236,8,1,1,0,0,9,255
060283006,255,7,2,0,0,0,2,266
060283007,342,15,2,4,1,2,12,378
060283008,362,15,6,0,0,0,3,386
060283009,256,13,0,1,0,0,7,277
060283010,362,11,1,4,0,1,7,386
060283011,254,6,0,5,0,0,8,273
060283012,192,1,2,1,0,0,1,197
060283013,213,15,0,4,1,0,1,234
060283014,282,3,0,0,2,0,6,293
060283015,255,17,5,1,0,1,4,283
060283016,263,6,2,3,4,0,9,287
060283017,10,1,0,0,0,0,0,11
060283101,269,31,6,4,1,0,10,321
060283102,236,24,6,5,18,0,7,296
060283103,282,15,3,6,3,4,17,330
060283104,185,6,4,2,0,0,3,200
060283105,252,5,9,0,0,3,6,275
060283106,394,37,5,4,1,1,7,449
060283107,374,12,1,6,0,1,4,398
060283108,191,8,0,1,0,0,3,203
060283109,228,4,1,0,0,1,9,243
060283110,383,18,5,8,2,0,6,422
060283111,347,20,6,7,0,0,11,391
060283112,283,17,4,1,1,0,20,326
060283201,231,6,1,4,0,0,4,246
060283202,224,16,2,0,0,0,1,243
060283203,313,9,1,3,0,3,9,338
060283204,283,21,9,8,11,1,14,347
060283205,220,18,6,3,1,1,6,255
060283206,232,23,2,2,1,1,4,265
060283207,275,22,3,3,1,3,10,317
060283208,356,11,1,6,1,3,6,384
060283209,423,22,8,8,0,3,12,476
060283301,284,53,2,14,0,2,27,382
060283302,411,21,3,5,1,7,15,463
060283303,226,16,1,3,0,0,1,247
060283304,254,17,1,1,0,1,1,275
060283305,138,47,29,2,0,2,15,233
060283306,1,0,0,0,0,0,0,1
060283307,316,15,1,3,0,0,3,338
060283308,370,27,2,10,0,0,7,416
060283309,329,26,3,6,3,7,9,383
060283310,289,35,2,3,13,1,15,358
060283311,334,17,4,0,0,2,22,379
060283312,327,8,8,12,1,1,0,357
060283313,354,16,1,3,0,0,8,382
060283314,449,12,0,12,2,2,12,489
060283401,261,17,6,2,0,0,11,297
060283402,361,14,7,3,1,2,14,402
060283403,389,26,11,6,0,2,5,439
060283404,345,15,1,1,0,3,12,377
060283405,254,20,1,2,0,0,5,282
060283406,357,11,7,3,6,1,7,392
060283407,217,14,5,2,2,1,2,243
060283408,323,12,0,2,3,0,0,340
060283409,376,13,10,16,0,0,15,430
060283410,346,16,6,11,2,12,16,409
060283411,281,16,2,1,0,1,8,309
060283412,351,14,9,7,3,0,9,393
060283501,370,15,2,2,0,1,2,392
060283502,331,13,1,2,0,0,8,355
060283503,300,14,7,10,0,8,1,340
060283504,294,18,9,2,0,3,14,340
060283505,391,12,4,8,0,0,3,418
060283506,341,14,1,0,0,0,2,358
060283507,338,19,6,3,4,2,11,383
060283508,299,18,4,3,0,6,12,342
060283509,394,7,0,3,0,1,6,411
060283601,194,17,1,0,0,2,5,219
060283602,183,18,12,0,0,1,14,228
060283603,278,41,4,0,1,2,33,359
060283604,424,20,6,7,2,7,9,475
060283605,390,31,2,1,0,2,6,432
060283606,386,16,0,5,0,0,4,411
060283607,431,28,5,6,0,2,17,489
060283608,279,12,7,5,5,1,5,314
060283609,258,13,3,2,1,0,7,284
060283610,304,8,1,4,0,4,9,330
060283611,296,1,0,4,0,0,10,311
060283612,372,25,1,33,0,1,11,443
060283613,354,35,0,46,1,0,27,463
060283614,405,16,2,9,1,1,6,440
060283615,420,20,5,5,0,1,1,452
060283701,343,27,5,2,5,2,15,399
060283702,268,12,2,0,0,1,4,287
060283703,254,5,2,11,0,1,7,280
060283704,290,7,4,2,0,1,13,317
060283705,351,12,3,3,1,2,6,378
060283706,337,2,1,2,0,1,14,357
060283707,235,9,1,5,0,1,5,256
060283708,255,8,6,5,0,1,4,279
060283709,263,16,2,7,2,7,4,301
060283710,343,11,2,11,0,6,11,384
060283711,363,6,3,7,1,0,15,395
060283712,359,0,1,3,1,1,20,385
060283713,235,7,1,1,0,0,9,253
060283714,274,8,5,11,0,13,23,334
060283801,478,14,0,8,2,3,2,507
060283802,344,9,1,4,0,1,3,362
060283803,339,14,1,8,0,0,6,368
060283804,405,19,8,1,0,2,10,445
060283805,372,28,12,5,2,0,15,434
060283806,263,20,4,2,0,2,2,293
060283807,225,23,4,1,0,3,2,258
060283808,342,32,6,11,1,23,8,423
060283809,280,9,1,8,0,14,8,320
060283810,277,18,7,6,0,9,5,322
060283811,250,21,1,6,0,0,6,284
060283812,290,19,4,2,0,3,6,324
060283901,237,11,1,17,0,0,14,280
060283902,355,3,0,4,1,1,9,373
060283903,255,6,1,2,0,0,5,269
060283904,333,9,0,2,0,0,4,348
060283905,286,6,0,3,1,0,7,303
060283906,228,8,43,8,0,0,6,293
060283907,250,5,0,3,0,0,3,261
060283908,235,0,4,7,0,0,4,250
060283909,415,11,0,7,0,0,5,438
060283910,427,17,1,7,0,0,3,455
060283911,397,6,0,12,0,0,11,426
060283912,418,25,2,8,0,1,15,469
060283913,466,13,4,3,0,7,14,507
060283914,210,5,1,3,0,0,2,221
060283915,251,20,1,7,1,0,27,307
060350101,491,1,1,1,1,0,16,511
060350102,185,0,1,0,0,1,8,195
060350103,216,2,6,5,0,0,9,238
060350104,140,0,4,1,2,1,14,162
060350105,146,0,5,0,0,0,7,158
060350106,201,1,7,0,1,0,2,212
060350107,215,13,2,0,4,0,6,240
060350108,146,1,3,0,1,0,8,159
060350109,104,0,3,0,0,0,6,113
060350110,262,0,1,0,0,0,5,268
060350111,171,3,0,1,0,1,12,188
060350201,266,4,0,1,0,1,4,276
060350202,258,0,0,1,0,0,1,260
060350203,287,2,0,0,0,0,7,296
060350301,294,1,8,1,2,0,10,316
060350302,282,3,2,1,1,0,9,298
060350303,256,2,4,3,0,0,7,272
060350304,354,4,6,0,0,0,12,376
060350305,250,0,6,0,4,0,11,271
060350306,354,0,6,0,0,1,5,366
060350307,315,0,4,0,0,0,7,326
060350308,289,0,6,0,2,2,7,306
060350309,178,0,4,0,0,0,1,183
060350310,221,0,5,0,0,0,9,235
060350311,329,3,3,4,0,0,6,345
060350312,244,0,2,1,0,0,7,254
060350313,312,3,13,5,0,0,8,341
060350314,272,2,7,6,0,1,11,299
060350315,318,9,13,4,3,0,5,352
060350401,311,2,1,2,0,0,6,322
060350402,210,3,1,1,0,0,4,219
060350403,289,3,4,3,0,0,6,305
060350404,272,2,1,6,0,0,7,288
060350405,350,2,4,3,1,0,7,367
060350406,308,1,7,1,8,0,11,336
060350407,341,4,3,0,1,2,13,364
060350408,229,0,2,1,3,0,22,257
060350409,407,2,16,1,0,0,10,436
060350410,230,5,8,0,0,0,21,264
060350411,414,3,8,5,0,1,11,442
060350412,242,5,1,1,1,1,12,263
060350413,316,6,3,6,0,2,10,343
060350414,256,20,24,2,0,1,9,312
060350415,224,7,6,0,0,0,8,245
060350501,184,12,2,0,0,0,13,211
060350502,369,33,36,1,0,1,15,455
060350503,291,30,4,0,0,0,4,329
060350504,352,12,5,2,3,0,12,386
060350505,690,17,0,1,2,0,6,716
060350506,356,7,1,0,0,0,5,369
060350507,272,17,1,3,0,2,12,307
060350508,319,29,12,4,1,0,8,373
060350509,295,26,3,3,0,0,8,335
060350510,265,30,5,3,1,0,5,309
060350511,265,23,3,5,3,0,7,306
060350512,264,20,4,3,0,0,5,296
060350601,309,7,4,5,8,0,15,348
060350602,374,6,5,1,8,0,18,412
060350603,321,21,8,2,4,3,17,376
060350604,244,25,0,0,2,0,8,279
060350605,296,25,12,3,9,0,19,364
060350606,313,24,4,6,0,2,16,365
060350607,204,22,8,3,4,0,18,259
060350608,300,15,5,0,0,1,16,337
060350609,307,7,1,1,0,0,8,324
060350610,255,9,0,0,0,0,3,267
060350611,214,3,2,3,3,0,3,228
060350612,263,35,11,1,12,0,20,342
060350701,179,18,1,2,1,0,9,210
060350702,319,17,2,1,4,0,19,362
060350703,244,17,5,0,2,0,8,276
060350704,229,21,8,2,0,0,25,285
060350705,275,18,8,2,2,0,14,319
060350706,340,9,3,5,3,2,17,379
060350707,193,17,8,5,4,1,159,387
060350708,116,18,3,0,0,0,160,297
060350709,108,22,3,1,0,1,140,275
060350710,123,12,2,4,0,0,179,320
060350711,162,19,16,4,6,1,120,328
060350712,92,6,1,2,4,0,161,266
060350801,264,9,0,0,0,0,31,304
060350802,173,2,0,0,0,0,14,189
060350803,335,7,2,0,0,0,11,355
060350804,316,15,0,0,0,1,8,340
060350805,112,2,1,0,0,0,1,116
060350806,198,16,6,3,0,0,5,228
060350807,220,1,3,3,0,0,2,229
060350808,200,12,1,0,1,0,3,217
060350809,224,9,0,0,3,0,3,239
060350810,148,0,1,0,0,0,2,151
060350811,214,21,1,1,1,0,3,241
060350812,1024,53,40,1,0,1,31,1150
060350813,284,6,1,0,0,1,4,296
060350814,200,13,2,1,2,3,16,237
060350815,171,6,1,1,0,0,7,186
060350901,140,2,0,0,1,0,6,149
060350902,179,5,1,1,1,0,7,194
060350903,119,7,0,0,0,1,12,139
060350904,412,2,0,1,0,0,17,432
060350905,223,2,0,0,0,0,6,231
060350906,179,8,2,21,0,0,11,221
060350907,280,0,2,1,0,0,1,284
060350908,307,4,2,120,0,0,7,440
060350909,182,6,0,2,0,0,5,195
060350910,368,1,1,1,2,0,8,381
060350911,306,6,0,14,1,0,7,334
060350912,135,9,0,0,0,0,2,146
060350913,249,2,3,2,4,0,7,267
060350914,212,7,2,0,0,0,8,229
060351001,249,0,6,2,3,0,10,270
060351002,899,10,81,4,1,6,149,1150
060351003,285,3,14,1,11,0,9,323
060351004,305,0,1,0,1,1,14,322
060351005,192,2,9,2,5,0,23,233
060351006,306,1,24,1,1,0,37,370
060351007,338,5,20,3,68,5,15,454
060351008,227,1,34,0,18,2,26,308
060351009,140,4,6,0,9,0,13,172
060351010,295,1,20,0,35,3,22,376
060351011,243,1,4,1,7,0,8,264
060351012,272,0,5,2,13,0,18,310
060351101,154,8,17,0,4,2,9,194
060351102,229,17,5,0,4,0,6,261
060351103,154,4,1,0,0,0,0,159
060351104,306,37,35,1,66,1,44,490
060351105,418,76,19,2,16,0,36,567
060351106,341,31,11,0,5,1,12,401
060351107,101,3,1,0,2,0,13,120
060351108,354,52,10,3,7,0,16,442
060351109,273,23,15,0,56,1,5,373
060351110,344,37,13,1,1,0,46,442
060351201,229,26,7,2,2,1,20,287
060351202,326,19,8,1,0,1,8,363
060351203,164,20,4,0,0,0,4,192
060351204,146,13,0,1,0,1,7,168
060351205,229,34,7,2,1,0,9,282
060351206,224,24,14,1,50,0,11,324
060351207,158,22,7,1,11,1,1,201
060351208,336,43,29,2,45,0,18,473
060351209,106,18,3,0,0,3,1,131
060351210,396,65,14,0,2,0,17,494
060351211,328,47,19,6,14,1,20,435
060351212,217,19,19,1,7,0,8,271
060351301,282,32,13,6,1,1,20,355
060351302,333,42,6,1,20,0,16,418
060351303,271,24,14,3,15,0,18,345
060351304,295,25,33,3,10,2,7,375
060351305,212,17,6,8,1,0,5,249
060351306,214,6,11,4,4,1,16,256
060351307,199,19,8,3,3,1,26,259
060351308,242,35,6,1,13,0,17,314
060351309,185,3,10,0,1,0,14,213
060351310,220,7,15,3,3,2,37,287
060351401,255,15,7,2,4,1,30,314
060351402,224,8,11,1,2,7,12,265
060351403,318,3,2,3,7,0,34,367
060351404,297,22,8,2,8,0,27,364
060351405,245,5,10,1,2,2,30,295
060351406,221,7,21,3,5,2,29,288
060351407,171,2,17,6,8,0,9,213
060351408,287,0,7,4,7,0,44,349
060351409,281,2,31,2,4,0,46,366
060351410,316,21,8,3,2,2,31,383
060351411,146,9,2,1,3,0,14,175
060351412,204,10,4,3,6,2,8,237
060351413,194,4,6,0,6,0,12,222
060351501,194,1,4,1,0,0,6,206
060351502,305,1,9,0,0,5,43,363
060351503,337,0,6,2,0,0,22,367
060351504,202,0,39,14,6,1,1,263
060351505,242,5,4,0,0,0,3,254
060351506,419,7,13,4,4,0,25,472
060351507,279,1,14,4,7,0,20,325
060351508,312,8,8,4,3,1,16,352
060351509,241,8,1,2,0,0,26,278
060351510,239,9,2,5,2,0,23,280
060351511,261,2,5,3,0,1,32,304
060351512,229,6,16,2,6,0,16,275
060351601,185,19,2,0,1,0,36,243
060351602,326,27,8,6,5,0,14,386
060351603,279,19,1,3,2,0,18,322
060351604,134,10,0,1,0,0,13,158
060351605,251,15,8,3,3,4,18,302
060351606,259,15,8,1,4,0,15,302
060351607,201,13,11,1,3,0,6,235
060351608,320,6,5,2,2,0,25,360
060351609,318,7,11,1,0,0,51,388
060351610,322,19,6,1,0,0,8,356
060351611,224,8,8,3,5,1,4,253
060351701,282,25,10,4,4,1,6,332
060351702,226,14,5,1,2,2,16,266
060351703,290,25,2,1,0,0,8,326
060351704,307,25,3,5,2,1,13,356
060351705,333,19,1,1,2,1,5,362
060351706,244,27,5,6,0,0,11,293
060351707,287,21,4,5,0,0,8,325
060351708,273,11,7,4,11,0,10,316
060351709,270,8,7,0,0,1,9,295
060351710,342,13,4,2,2,0,21,384
060351711,211,16,5,1,1,1,6,241
060351801,278,32,3,5,4,2,11,335
060351802,296,22,11,1,1,0,9,340
060351803,244,15,2,0,0,1,14,276
060351804,246,10,5,3,1,1,12,278
060351805,265,10,6,8,5,4,15,313
060351806,299,13,2,3,3,0,20,340
060351807,242,32,3,3,4,0,17,301
060351808,223,7,8,6,4,0,16,264
060351809,302,15,8,2,0,1,9,337
060351810,252,20,6,1,4,0,12,295
060351811,304,16,7,4,2,1,13,347
060351901,286,30,2,1,10,0,18,347
060351902,316,18,4,2,3,1,13,357
060351903,323,46,14,3,2,0,12,400
060351904,266,34,6,3,1,0,6,316
060351905,314,29,13,2,0,0,29,387
060351906,268,8,8,10,2,0,8,304
060351907,188,8,5,5,5,0,14,225
060351908,269,10,6,3,2,0,12,302
060351909,266,12,7,3,3,4,9,304
060351910,383,21,7,1,12,0,17,441
060351911,332,24,8,0,9,2,9,384
060352001,335,21,14,3,5,0,31,409
060352002,387,24,7,0,0,3,12,433
060352003,431,37,39,0,1,0,23,531
060352004,235,9,12,2,1,1,14,274
060352005,261,18,4,2,1,0,8,294
060352006,275,3,9,3,7,2,21,320
060352007,307,27,11,3,1,2,25,376
060352008,320,21,6,2,1,0,6,356
060352009,280,13,7,3,1,0,5,309
060352010,277,16,5,2,3,1,7,311
060352011,253,13,8,2,0,0,12,288
060352101,396,3,11,5,6,1,18,440
060352102,381,2,7,2,2,0,14,408
060352103,204,14,8,2,0,1,9,238
060352104,201,26,16,12,10,0,13,278
060352105,94,2,13,0,4,3,33,149
060352106,173,19,23,1,9,0,11,236
060352107,209,21,7,6,1,0,7,251
060352108,234,57,19,1,7,0,13,331
060352109,236,28,1,4,2,1,3,275
060352110,282,16,15,5,7,1,35,361
060352201,357,7,0,1,0,0,0,365
060352202,256,22,7,0,0,0,4,289
060352203,198,19,32,1,1,0,8,259
060352204,189,25,17,1,1,0,23,256
060352205,201,28,5,0,0,0,17,251
060352206,269,43,10,3,5,1,14,345
060352207,273,33,14,1,27,1,16,365
060352208,215,44,7,4,4,1,16,291
060352209,223,20,10,2,9,0,22,286
060352210,236,10,8,1,0,0,33,288
060352211,184,45,6,4,1,0,9,249
060352212,47,16,4,2,17,1,147,234
060352301,142,47,16,8,4,1,167,385
060352302,171,42,34,3,12,3,239,504
060352303,246,23,10,3,16,0,104,402
060352304,128,29,21,1,11,2,115,307
060352305,375,32,17,2,0,1,56,483
060352306,346,13,3,8,3,1,8,382
060352307,283,2,2,0,1,0,7,295
060352308,191,5,1,1,1,1,5,205
060352309,263,16,4,3,3,0,8,297
060352310,314,18,8,2,10,0,18,370
060352311,303,0,17,3,1,0,12,336
060352312,295,5,8,2,4,0,11,325
060352401,296,0,10,1,0,0,6,313
060352402,277,6,4,2,2,1,11,303
060352403,351,11,6,4,0,0,2,374
060352404,325,8,12,1,0,0,8,354
060352405,248,9,3,3,0,0,24,287
060352406,300,16,3,1,0,0,7,327
060352407,270,8,2,1,2,0,9,292
060352408,343,6,3,0,0,1,19,372
060352409,318,13,5,1,1,1,11,350
060352410,320,21,2,3,2,1,16,365
060352411,270,12,2,1,0,0,4,289
060352501,171,10,4,0,1,0,7,193
060352502,263,13,4,1,2,0,3,286
060352503,397,7,3,2,1,0,13,423
060352504,270,22,8,1,0,0,23,324
060352505,298,16,2,2,0,0,9,327
060352506,329,18,10,3,0,0,4,364
060352507,277,11,2,1,0,0,11,302
060352508,280,11,4,2,0,0,8,305
060352509,295,18,6,3,1,0,11,334
060352510,514,26,14,3,4,0,10,571
060352511,367,19,10,0,0,0,14,410
060352601,374,20,2,1,16,0,5,418
060352602,379,8,1,1,0,0,4,393
060352603,200,11,2,0,0,0,6,219
060352604,83,5,0,1,0,0,1,90
060352605,578,25,2,0,0,0,8,613
060352606,217,17,2,0,0,0,1,237
060352607,273,15,2,0,1,0,1,292
060352608,202,7,0,0,0,0,4,213
060352609,268,4,0,0,0,0,5,277
060352610,427,8,0,0,0,0,6,441
060352611,366,1,1,0,0,0,7,375
060352612,203,5,1,0,1,0,4,214
060352613,180,0,0,0,0,0,0,180
060352614,240,5,0,0,0,0,7,252
060352615,305,5,7,0,1,0,32,350
060352701,66,2,0,0,1,0,0,69
060352702,245,21,1,1,1,0,8,277
060352703,264,15,8,1,0,0,5,293
060352704,526,2,0,2,0,0,2,532
060352705,191,11,2,3,7,0,10,224
060352706,354,14,0,0,0,0,3,371
060352707,264,4,0,0,0,0,4,272
060352708,106,9,0,0,0,0,3,118
060352709,271,13,1,4,0,0,11,300
060352710,271,8,4,1,1,1,3,289
060352711,412,10,0,1,1,0,17,441
060352712,291,18,2,2,0,1,9,323
060352713,194,14,3,1,0,0,2,214
060352714,268,3,0,0,0,0,4,275
060352801,337,13,7,8,1,0,16,382
060352802,311,11,1,1,0,0,22,346
060352803,280,11,1,0,1,0,11,304
060352804,259,4,2,5,3,0,22,295
060352805,272,8,6,1,2,1,14,304
060352806,302,9,6,7,0,0,20,344
060352807,247,16,0,2,0,0,7,272
060352808,320,11,4,4,0,1,16,356
060352901,211,10,5,5,2,0,6,239
060352902,287,13,1,4,1,2,10,318
060352903,300,21,4,5,1,1,14,346
060352904,205,5,8,4,4,0,35,261
060352905,240,28,1,2,7,0,7,285
060352906,293,18,10,1,3,0,12,337
060352907,259,23,3,5,0,0,11,301
060352908,241,15,2,6,1,0,4,269
060352909,199,26,4,3,4,0,6,242
060353001,338,12,7,4,1,1,17,380
060353002,298,11,1,1,1,0,5,317
060353003,277,10,4,2,4,1,22,320
060353004,331,26,7,10,3,0,16,393
060353005,261,6,3,3,1,0,24,298
060353006,319,22,5,3,2,1,23,375
060353007,305,17,6,5,4,1,13,351
060353008,322,25,4,3,0,0,19,373
060353009,275,13,3,1,0,0,6,298
060353010,295,26,6,0,2,1,14,344
060353101,151,10,2,7,2,2,18,192
060353102,156,6,18,11,17,0,23,231
060353103,249,21,12,1,21,0,12,316
060353104,392,59,12,0,1,0,51,515
060353105,331,19,4,5,5,0,5,369
060353106,176,15,8,0,0,0,4,203
060353107,149,12,1,0,2,0,8,172
060353108,241,11,17,4,5,0,21,299
060353109,169,5,6,7,7,0,7,201
060353201,308,26,7,8,1,0,8,358
060353202,238,19,10,4,4,0,12,287
060353203,296,15,12,1,1,0,14,339
060353204,291,18,6,1,1,1,19,337
060353205,237,34,11,2,5,0,19,308
060353206,299,17,63,8,3,0,15,405
060353207,333,31,18,1,6,0,17,406
060353208,283,31,18,5,16,0,17,370
060353301,269,54,5,2,0,0,22,352
060353302,292,20,9,0,14,0,24,359
060353303,386,15,9,3,2,0,34,449
060353304,284,17,9,0,2,0,16,328
060353305,182,24,20,0,2,0,10,238
060353306,279,26,4,4,5,0,24,342
060353307,290,27,16,4,3,1,20,361
060353308,238,19,15,1,15,0,15,303
060353401,221,28,8,6,3,0,12,278
060353402,213,11,2,1,1,0,7,235
060353403,201,15,1,2,1,0,17,237
060353404,206,19,4,5,0,2,27,263
060353405,242,29,10,5,3,0,11,300
060353406,322,27,4,10,4,1,22,390
060353407,238,28,11,3,9,2,9,300
060353408,235,36,9,4,6,1,5,296
060353409,209,12,6,0,9,0,11,247
060353501,306,16,1,1,0,0,8,332
060353502,273,14,5,4,0,1,8,305
060353503,258,13,9,0,2,0,19,301
060353504,226,14,2,1,4,0,16,263
060353505,420,20,6,0,0,0,8,454
060353506,222,12,4,2,1,0,7,248
060353507,218,16,5,1,0,0,5,245
060353508,242,9,10,6,3,0,14,284
060910101,377,1,0,1,0,0,3,382
060910102,393,5,7,4,0,0,4,413
060910103,215,17,3,5,1,3,5,249
060910104,254,9,8,2,2,1,6,282
060910105,228,4,5,1,1,2,6,247
060910106,214,0,6,0,6,0,6,232
060910107,374,11,4,3,0,0,3,395
060910108,312,16,5,1,1,2,10,347
060910109,419,17,8,5,0,3,12,464
060910110,170,18,4,0,0,0,3,195
060910201,361,31,3,2,7,0,22,426
060910202,268,30,7,4,4,1,16,330
060910203,212,14,10,4,7,0,6,253
060910204,318,51,15,3,7,0,14,408
060910205,266,32,9,10,4,0,16,337
060910206,199,10,2,2,4,0,13,230
060910207,219,15,5,8,9,0,11,267
060910208,352,22,15,11,5,2,15,422
060910209,390,16,5,4,0,1,9,425
060910301,379,13,11,7,7,0,15,432
060910302,407,19,2,1,0,0,2,431
060910303,215,15,10,0,1,0,17,258
060910304,266,3,1,0,0,0,4,274
060910305,222,8,2,1,1,0,11,245
060910306,404,12,0,2,5,2,14,439
060910307,384,10,4,1,0,3,5,407
060910308,233,6,5,3,0,0,4,251
060910309,376,11,9,5,0,1,14,416
060910310,367,37,10,7,3,1,15,440
060910311,295,22,6,5,10,3,8,349
060910312,152,9,26,0,7,0,16,210
060910313,218,26,12,2,45,4,11,318
060910401,389,14,1,2,0,0,2,408
060910402,310,5,4,1,0,0,10,330
060910403,424,10,5,6,1,0,5,451
060910404,430,14,4,6,0,0,8,462
060910405,459,0,18,7,0,4,20,508
060910406,360,5,7,8,0,0,7,387
060910407,337,6,1,1,0,0,5,350
060910408,219,3,3,1,0,0,6,232
060910409,463,5,4,4,2,1,12,491
060910410,486,4,0,2,0,1,9,502
060910411,373,13,1,1,1,0,11,400
060910412,361,4,8,2,0,2,8,385
060910501,417,2,0,0,0,0,3,422
060910502,361,13,1,6,0,2,8,391
060910503,421,5,6,5,0,1,21,459
060910504,239,18,4,1,0,1,11,274
060910505,394,16,6,1,3,2,16,438
060910506,243,3,1,0,0,0,2,249
060910507,298,6,2,2,2,4,2,316
060910508,196,18,2,4,0,0,6,226
060910509,133,5,1,3,0,2,9,153
060910510,19,1,0,0,0,0,0,20
060910601,285,6,2,2,1,1,6,303
060910602,294,11,4,3,2,1,4,319
060910603,255,6,6,6,2,4,6,285
060910604,263,6,7,7,0,2,7,292
060910605,223,14,1,4,1,0,4,247
060910606,287,11,3,1,0,1,11,314
060910607,382,11,1,5,5,2,9,415
060910608,450,8,1,9,0,0,3,471
060910609,369,3,2,4,0,1,1,380
060910610,340,7,1,3,0,0,5,356
060910611,291,4,1,16,0,0,8,320
060910701,341,16,5,4,0,0,2,368
060910702,304,12,2,3,0,2,3,326
060910703,230,2,1,3,0,0,9,245
060910704,292,5,3,0,0,2,6,308
060910705,245,15,0,2,0,0,1,263
060910706,274,7,4,2,0,3,7,297
060910707,392,16,5,2,0,0,12,427
060910708,322,5,0,1,0,0,14,342
060910709,297,5,1,2,0,0,6,311
060910710,368,12,2,12,0,5,5,404
060910801,265,15,6,0,1,0,10,297
060910802,194,6,4,0,0,0,5,209
060910803,223,9,1,6,1,0,7,247
060910804,258,10,1,0,2,2,4,277
060910805,232,11,2,6,0,0,6,257
060910806,282,9,0,0,1,0,1,293
060910807,374,12,3,2,0,3,14,408
060910808,418,13,3,4,0,1,3,442
060910809,380,13,2,7,2,0,6,410
060910810,351,16,3,4,1,3,4,382
060910901,217,9,8,2,4,1,11,252
060910902,384,38,8,3,0,1,7,441
060910903,402,14,4,0,4,4,10,438
060910904,391,14,15,6,0,1,13,440
060910905,199,1,2,4,1,0,10,217
060910906,325,3,0,1,0,0,10,339
060910907,420,1,11,9,2,1,26,470
060910908,219,2,0,2,0,0,0,223
060911001,337,1,6,3,13,1,4,365
060911002,200,0,3,1,0,0,3,207
060911003,418,5,4,5,0,0,11,443
060911004,229,0,3,9,2,1,11,255
060911005,445,2,5,2,2,0,11,467
060911006,418,0,4,7,0,0,10,439
060911007,297,1,2,4,1,0,3,308
060911008,257,0,0,2,0,0,2,261
060911009,279,3,2,0,0,0,14,298
060911010,492,13,18,5,9,0,7,544
060911011,411,3,8,18,3,1,11,455
060911101,421,1,3,3,0,3,1,432
060911102,422,15,9,3,0,0,14,463
060911103,200,8,7,4,4,2,7,232
060911104,220,3,4,6,5,0,12,250
060911105,304,3,5,4,1,1,12,330
060911106,321,3,2,1,1,0,14,342
060911107,392,20,16,1,1,0,3,433
060911108,413,8,13,2,0,0,12,448
060911109,400,17,8,3,2,0,16,446
060911201,309,7,6,0,2,1,4,329
060911202,399,12,0,1,0,0,2,414
060911203,318,8,4,2,1,0,9,342
060911204,360,19,1,2,10,0,2,394
060911205,324,9,0,0,1,2,3,339
060911206,380,2,1,0,1,0,3,387
060911207,274,6,5,4,3,0,6,298
060911208,447,2,4,7,0,0,19,479
060911301,315,19,2,4,0,0,9,349
060911302,253,7,2,3,0,0,8,273
060911303,271,3,0,1,0,1,2,278
060911304,292,6,3,4,0,0,15,320
060911305,412,10,0,1,0,1,6,430
060911306,289,15,5,2,0,0,6,317
060911307,283,7,0,5,0,0,4,299
060911308,267,7,0,1,0,0,3,278
060911309,427,15,2,6,13,3,10,476
060911310,364,19,0,5,1,0,0,389
060911311,249,3,2,4,7,0,1,266
060911312,256,2,1,1,0,0,5,265
060911401,363,4,0,1,0,0,6,374
060911402,379,11,0,3,1,0,3,397
060911403,259,12,0,10,0,0,4,285
060911404,319,8,1,3,0,0,1,332
060911405,326,6,3,3,0,0,2,340
060911406,323,4,1,0,0,0,3,331
060911407,372,10,1,7,1,1,3,395
060911408,346,9,0,2,0,2,1,360
060911409,248,15,1,3,0,0,1,268
060911410,411,15,3,4,0,0,10,443
060911411,374,13,1,1,2,0,9,400
060911412,290,11,2,3,2,1,3,312
060911413,276,11,1,2,1,0,2,293
060911501,237,8,3,2,1,1,0,252
060911502,213,9,0,2,0,0,0,224
060911503,282,20,5,3,0,0,7,317
060911504,429,43,10,5,20,4,18,529
060911505,275,9,2,3,0,1,4,294
060911506,259,9,4,2,0,0,8,282
060911507,224,12,2,2,1,0,5,246
060911508,258,6,0,2,0,0,2,268
060911509,233,20,5,1,0,0,1,260
060911510,281,5,1,2,0,1,5,295
060911511,387,9,3,3,0,0,12,414
060911512,243,15,4,2,2,0,5,271
060911513,236,3,6,2,0,3,6,256
060911601,345,16,5,2,0,0,5,373
060911602,390,4,2,2,0,4,51,453
060911603,217,1,0,5,0,0,9,232
060911604,364,10,3,1,0,0,11,389
060911605,384,17,5,1,1,0,8,416
060911606,241,4,1,8,1,0,1,256
060911607,173,15,9,1,0,0,3,201
060911608,257,11,4,1,1,0,6,280
060911609,239,11,2,2,0,1,5,260
060911610,266,11,4,3,2,0,6,292
060911611,462,25,5,3,1,0,3,499
060911612,201,11,3,12,0,0,2,229
060911613,410,22,1,4,0,0,6,443
060911614,338,8,2,5,0,0,4,357
060911701,265,17,1,11,1,0,2,297
060911702,387,14,4,0,0,0,7,412
060911703,432,17,10,4,1,1,7,472
060911704,238,10,3,7,2,0,5,265
060911705,328,8,0,1,0,0,7,344
060911706,317,11,1,1,2,0,1,333
060911707,323,2,0,1,0,0,5,331
060911708,223,2,0,0,0,0,8,233
060911709,354,5,0,0,0,0,2,361
060911710,351,12,1,1,0,0,0,365
060911711,311,4,1,2,1,0,2,321
060911712,329,12,2,2,0,0,1,346
060911713,234,4,1,1,0,0,0,240
060911714,421,11,1,4,0,1,3,441
060911801,220,9,1,4,0,2,10,246
060911802,239,14,0,8,0,5,1,267
060911803,527,13,1,5,0,1,18,565
060911804,396,7,12,8,2,12,28,465
060911805,353,4,1,9,0,3,15,385
060911806,361,6,2,6,2,1,2,380
060911807,401,24,1,3,0,0,4,433
060911808,328,4,4,12,1,2,4,355
060911809,251,6,4,3,2,1,15,282
060911810,210,6,2,15,2,1,6,242
060911811,454,2,3,6,1,4,10,480
060911812,399,21,5,15,1,10,18,469
060911901,215,16,2,8,1,0,5,247
060911902,398,13,1,6,0,2,10,430
060911903,318,8,3,0,0,0,5,334
060911904,337,14,8,13,2,1,7,382
060911905,202,18,7,7,0,0,2,236
060911906,189,33,2,6,0,2,4,236
060911907,221,15,1,5,2,1,15,260
060911908,346,26,6,14,11,4,3,410
060911909,224,22,6,6,1,7,5,271
060911910,282,19,2,5,0,1,0,309
060911911,241,5,2,6,1,1,1,257
060911912,374,16,1,8,0,3,16,418
060912001,337,8,4,17,1,2,25,394
060912002,315,10,5,20,0,12,11,373
060912003,145,6,0,4,0,1,0,156
060912004,209,7,0,0,0,0,1,217
060912005,390,15,1,2,0,0,5,413
060912006,214,9,1,0,0,0,0,224
060912007,354,31,4,21,0,4,12,426
060912008,205,23,5,8,1,5,6,253
060912009,222,17,4,9,0,4,15,271
060912010,255,10,3,21,0,3,9,301
060912011,362,16,8,13,2,26,16,443
060912012,220,10,2,6,0,21,16,275
060912013,218,8,0,2,1,5,7,241
060912101,250,6,2,3,0,0,3,264
060912102,307,25,4,1,1,1,12,351
060912103,266,11,0,2,0,0,4,283
060912104,257,8,5,0,0,0,3,273
060912105,245,8,1,2,0,1,19,276
060912106,219,9,0,3,0,0,1,232
060912107,304,7,3,0,0,0,1,315
060912108,225,10,2,2,3,0,6,248
060912109,290,25,6,0,3,1,23,348
060912110,311,22,6,0,1,0,5,345
060912111,341,13,0,3,0,1,6,364
060912112,373,8,5,4,3,4,4,401
060912113,283,10,0,6,1,0,5,305
060912114,335,20,1,4,2,0,3,365
060912115,263,8,1,1,0,1,2,276
060912116,298,6,0,4,0,1,1,310
060912117,385,11,1,3,0,1,2,403
060912201,306,6,4,6,0,0,10,332
060912202,293,9,4,20,5,11,9,351
060912203,366,11,1,0,0,0,9,387
060912204,329,29,1,24,0,21,3,407
060912205,265,41,2,8,0,28,10,354
060912206,402,21,4,29,0,2,4,462
060912207,269,7,2,1,0,2,1,282
060912208,259,10,5,1,0,1,1,277
060912209,217,5,7,0,0,1,2,232
060912210,406,39,5,20,1,1,7,479
060912211,139,29,1,26,0,44,7,246
060912212,124,33,5,13,0,37,20,232
060912213,254,31,4,21,0,13,11,334
060912214,174,35,8,16,0,18,9,260
060912215,391,12,3,6,0,4,10,426
060912216,394,17,7,3,2,3,10,436
060912217,209,76,0,37,0,0,6,328
060912301,256,14,2,6,0,4,6,288
060912302,286,3,4,9,0,6,6,314
060912303,242,12,7,7,1,1,5,275
060912304,390,22,4,4,0,1,10,431
060912305,208,12,8,2,6,0,9,245
060912306,372,21,6,5,2,5,4,415
060912307,217,9,3,5,1,2,10,247
060912308,216,15,1,6,0,3,5,246
060912309,162,6,2,6,0,0,3,179
060912310,415,11,2,7,3,1,6,445
060912311,305,12,0,2,3,4,3,329
060912312,174,17,3,4,2,0,3,203
060912313,160,6,5,7,0,6,5,189
060912314,72,17,7,5,0,48,10,159
060912315,65,5,5,7,0,31,10,123
060912316,111,25,3,10,0,4,7,160
060912317,138,33,4,8,0,44,5,232
060912318,55,35,4,1,0,9,1,105
060912319,83,22,2,16,0,17,6,146
060912401,187,5,2,6,0,4,5,209
060912402,220,19,1,13,1,0,13,267
060912403,262,13,3,11,0,1,8,298
060912404,378,37,1,20,0,2,9,447
060912405,264,5,3,21,0,12,10,315
060912406,277,22,7,10,1,19,6,342
060912407,153,31,3,7,0,15,1,210
060912408,129,3,0,10,0,58,7,207
060912409,101,3,7,202,1,91,5,410
060912410,237,10,0,67,0,9,10,333
060912411,243,19,11,9,0,106,41,429
060912412,177,12,0,7,0,10,20,226
060912413,175,2,1,1,0,4,6,189
062600101,390,12,3,4,1,0,9,419
062600102,330,22,3,8,0,16,8,387
062600103,205,3,1,2,0,4,2,217
062600104,198,4,2,3,1,1,2,211
062600105,152,8,1,12,0,0,12,185
062600106,486,13,0,8,0,0,7,514
062600107,259,8,4,5,0,0,7,283
062600108,423,6,8,1,1,0,2,441
062600109,342,10,1,3,0,1,8,365
062600110,375,33,8,15,2,2,10,445
062600111,286,8,2,13,0,1,4,314
062600112,361,12,7,13,0,0,5,398
062600113,213,11,1,2,0,1,8,236
062600114,283,17,4,5,0,2,11,322
062600115,249,11,1,3,0,0,6,270
062600116,237,23,0,8,0,2,5,275
062600117,365,7,4,8,0,1,12,397
062600118,159,2,1,2,0,4,3,171
062600119,388,10,1,1,0,2,6,408
062600201,525,17,6,11,0,1,13,573
062600202,436,7,3,7,0,1,7,461
062600203,435,15,0,2,0,0,6,458
062600204,354,8,1,2,1,1,4,371
062600205,415,12,0,4,0,0,7,438
062600206,259,7,2,2,0,0,6,276
062600207,382,12,0,9,0,0,5,408
062600208,79,5,4,5,1,41,4,139
062600209,400,5,0,2,0,1,3,411
062600210,370,7,1,1,0,1,3,383
062600211,366,6,1,4,0,0,6,383
062600212,287,13,0,1,0,0,3,304
062600213,325,4,0,0,0,1,4,334
062600214,319,21,4,1,0,0,1,346
062600215,398,9,2,3,0,0,3,415
062600216,343,10,0,2,0,0,3,358
062600301,679,35,1,20,0,7,10,752
062600302,233,3,2,3,0,0,2,243
062600303,268,0,0,0,0,0,5,273
062600304,487,16,1,13,3,0,25,545
062600305,383,7,3,0,0,0,5,398
062600306,227,2,1,2,1,1,1,235
062600307,304,6,1,6,0,0,8,325
062600308,303,8,0,5,1,0,6,323
062600309,198,14,0,1,0,0,5,218
062600310,466,20,1,13,0,1,6,507
062600311,415,2,0,0,0,1,4,422
062600312,513,18,0,0,0,0,3,534
062600313,458,16,0,0,0,0,3,477
062600314,249,0,3,10,0,1,6,269
062600315,276,1,0,5,0,3,2,287
062600316,369,13,1,2,1,0,5,391
062600317,299,0,3,7,1,0,6,316
062600318,327,2,1,2,0,1,3,336
062600319,277,1,3,1,0,1,1,284
062600401,227,0,0,1,0,1,6,235
062600402,310,0,0,0,0,2,0,312
062600403,322,0,1,4,0,1,7,335
062600404,298,1,0,11,0,0,9,319
062600405,304,2,2,4,1,4,7,324
062600406,311,1,0,3,1,1,2,319
062600407,257,0,1,1,1,0,8,268
062600408,346,1,3,0,0,0,23,373
062600409,293,3,3,3,0,0,6,308
062600410,227,0,2,3,0,0,9,241
062600411,226,1,2,2,0,2,7,240
062600412,301,0,4,3,0,0,6,314
062600501,323,6,4,4,3,1,3,344
062600502,320,0,3,7,2,5,0,337
062600503,220,1,2,2,3,0,3,231
062600504,318,0,5,2,0,0,5,330
062600505,352,0,3,8,0,4,6,373
062600506,349,1,1,0,0,0,6,357
062600507,314,7,4,1,0,0,8,334
062600508,180,0,2,5,5,0,5,197
062600509,354,14,2,3,1,1,7,382
062600510,287,9,1,0,0,0,5,302
062600511,350,9,1,5,1,0,1,367
062600512,250,7,0,2,1,2,2,264
062600513,378,24,0,3,0,14,21,440
062600514,377,1,6,4,0,16,6,410
062600515,303,9,4,2,0,0,3,321
062600516,228,8,2,1,0,0,0,239
062600517,262,15,1,3,0,2,4,287
062600601,372,15,4,9,2,5,9,416
062600602,241,10,2,7,5,0,1,266
062600603,314,15,3,3,1,0,12,348
062600604,400,27,2,3,2,0,7,441
062600605,377,22,5,1,0,3,6,414
062600606,209,15,1,4,1,1,3,234
062600607,231,11,3,2,0,0,5,252
062600608,234,30,0,4,0,0,0,268
062600609,236,28,8,8,0,1,1,282
062600610,179,11,4,1,0,0,8,203
062600611,228,14,4,2,0,2,1,251
062600612,344,38,9,2,0,5,10,408
062600613,300,17,5,5,2,0,10,339
062600614,341,28,5,3,3,1,13,394
062600615,294,22,10,7,2,2,11,348
062600616,377,23,2,9,3,3,11,428
062600701,389,29,3,19,2,9,13,464
062600702,345,18,13,8,7,6,18,415
062600703,412,38,26,13,3,3,11,506
062600704,298,21,9,9,2,2,9,350
062600705,248,9,4,2,0,3,4,270
062600706,329,17,8,7,1,1,7,370
062600707,332,19,1,10,0,4,8,374
062600708,241,15,5,3,1,2,9,276
062600709,289,12,7,3,1,1,9,322
062600710,418,4,6,6,0,27,16,477
062600711,303,18,10,3,3,1,22,360
062600712,303,8,8,2,6,15,22,364
062600713,239,57,28,6,10,8,23,371
062600801,304,8,0,1,2,0,13,328
062600802,412,17,2,6,1,0,13,451
062600803,307,7,0,2,1,1,10,328
062600804,398,9,0,1,0,0,8,416
062600805,281,4,0,1,0,0,1,287
062600806,287,8,1,5,0,0,2,303
062600807,243,7,1,6,2,2,3,264
062600808,320,26,2,7,1,1,7,364
062600809,325,13,11,6,2,4,13,374
062600810,235,7,4,1,0,0,3,250
062600811,376,25,0,2,0,0,5,408
062600812,360,8,1,5,0,1,4,379
062600813,405,8,3,5,2,2,6,431
062600814,288,14,1,2,1,0,8,314
062600901,326,10,1,3,0,3,1,344
062600902,296,9,1,2,3,2,2,315
062600903,453,3,15,3,1,0,10,485
062600904,415,11,1,5,1,0,16,449
062600905,283,4,0,11,1,0,8,307
062600906,87,5,1,1,1,1,0,96
062600907,355,9,4,7,4,3,9,391
062600908,400,12,3,10,1,2,8,436
062600909,239,2,1,0,4,0,8,254
062600910,357,9,1,6,0,2,10,385
062600911,377,28,0,7,4,21,23,460
062600912,274,11,0,2,0,4,4,295
062600913,352,21,0,6,0,4,8,391
062600914,300,18,2,6,2,20,5,353
062601001,329,10,4,8,0,3,4,358
062601002,254,9,4,3,0,1,7,278
062601003,344,9,6,7,0,3,12,381
062601004,285,11,6,6,1,7,7,323
062601005,41,21,8,0,0,1,7,78
062601006,920,34,125,58,1,7,114,1259
062601007,309,12,0,1,0,0,2,324
062601008,322,17,5,6,0,3,5,358
062601009,209,12,0,2,0,3,4,230
062601010,243,4,3,2,2,0,6,260
062601011,303,1,1,4,0,0,13,322
062601012,258,8,0,1,0,0,6,273
062601013,370,13,0,2,1,1,6,393
062601014,245,13,3,11,0,0,4,276
062601015,135,7,7,2,1,10,10,172
062601101,130,31,19,1,13,0,20,214
062601102,190,40,21,1,23,0,28,303
062601103,362,31,14,2,22,6,32,469
062601104,325,26,27,5,2,3,9,397
062601105,280,29,9,7,0,1,9,335
062601106,189,8,4,0,5,3,3,212
062601107,373,23,6,11,3,0,14,430
062601108,348,31,11,9,3,1,4,407
062601109,340,23,5,12,2,3,7,392
062601110,371,16,2,12,0,1,5,407
062601201,305,22,11,5,4,3,27,377
062601202,180,24,7,0,1,1,9,222
062601203,166,34,14,0,17,1,3,235
062601204,295,26,27,7,4,1,13,373
062601205,396,26,6,5,1,2,16,452
062601206,343,7,24,5,4,4,17,404
062601207,174,17,3,0,0,1,1,196
062601208,300,12,15,3,4,10,7,351
062601209,263,2,10,7,6,6,10,304
062601210,199,15,7,3,3,4,0,231
062601211,238,19,0,3,0,2,7,269
062601212,332,18,4,7,8,1,4,374
062601301,246,13,5,4,3,2,15,288
062601302,432,29,5,2,5,3,8,484
062601303,353,41,10,10,2,2,8,426
062601304,338,25,19,10,6,1,7,406
062601305,408,35,2,3,0,1,12,461
062601306,329,21,8,17,1,0,9,385
062601307,361,44,8,6,2,2,7,430
062601308,326,18,8,1,2,1,12,368
062601309,324,20,11,3,2,1,7,368
062601310,203,5,4,3,5,2,8,230
062601311,261,43,18,2,18,8,30,380
062601312,170,26,33,5,21,0,11,266
062601313,219,21,24,2,10,0,13,289
062601314,217,24,33,9,15,0,15,313
062601401,369,4,11,8,3,7,12,414
062601402,284,21,5,8,4,1,10,333
062601403,268,12,5,4,1,2,7,299
062601404,210,11,5,4,1,7,5,243
062601405,359,21,9,2,1,1,4,397
062601406,428,46,18,6,2,4,6,510
062601407,269,11,0,4,0,1,9,294
062601408,378,25,3,11,0,4,23,444
062601409,362,20,5,5,1,2,6,401
062601410,360,19,11,7,0,0,8,405
062601411,275,8,3,5,0,2,15,308
062601412,223,2,2,3,0,3,13,246
062601413,265,3,0,2,0,10,7,287
062601501,418,20,2,11,1,1,8,461
062601502,301,19,1,5,0,3,6,335
062601503,192,6,2,2,0,0,9,211
062601504,229,16,3,7,0,1,6,262
062601505,292,4,1,1,1,0,8,307
062601506,306,4,0,1,0,1,8,320
062601507,264,3,0,0,0,0,8,275
062601508,250,12,0,5,0,2,0,269
062601509,356,4,1,4,0,3,8,376
062601510,423,11,1,10,0,2,6,453
062601511,423,15,1,3,0,0,6,448
062601512,277,8,7,2,0,0,9,303
062601513,280,14,0,2,1,1,7,305
062601514,220,0,0,8,0,5,10,243
062601515,281,10,0,3,1,0,2,297
062601516,298,23,0,3,1,0,1,326
062601517,449,11,3,2,0,0,11,476
062601518,412,7,1,12,0,4,12,448
062601519,290,22,3,5,4,0,0,324
062601601,396,33,1,10,1,5,6,452
062601602,298,13,9,5,0,0,1,326
062601603,379,13,0,7,2,1,10,412
062601604,238,12,0,5,0,0,6,261
062601605,334,14,2,3,0,3,12,368
062601606,376,12,1,10,1,4,6,410
062601607,370,11,1,8,0,0,6,396
062601608,122,7,0,0,0,0,0,129
062601609,319,18,1,1,0,0,6,345
062601610,278,18,1,11,0,3,2,313
062601611,289,3,3,13,0,1,15,324
062601612,328,8,0,4,0,0,6,346
062601613,309,14,1,5,0,2,8,339
062601614,414,20,4,8,0,0,4,450
062601615,402,8,5,5,1,0,15,436
062601616,334,12,3,18,10,3,18,398
062601617,385,26,17,13,3,3,16,463
062601701,457,2,9,42,0,0,25,535
062601702,20,0,0,1,0,3,6,30
062601703,411,29,0,19,2,1,112,574
062601704,235,0,5,6,2,2,9,259
062601705,62,0,2,14,0,92,5,175
062601706,432,16,1,17,1,9,10,486
062601707,58,113,1,6,2,112,7,299
062601708,203,1,1,1,0,39,1,246
062601709,75,9,0,7,1,172,27,291
062601710,105,0,1,7,0,145,1,259
062601711,85,119,0,3,0,74,16,297
062601712,106,21,0,6,0,61,23,217
062601713,630,65,7,21,0,82,45,850
062601714,51,3,0,22,0,2,13,91
062700101,181,0,0,13,1,6,3,204
062700102,180,0,6,8,1,9,12,216
062700103,140,37,5,0,0,4,3,189
062700104,320,9,3,4,0,1,3,340
062700105,159,29,5,2,0,7,2,204
062700106,165,3,5,13,0,86,6,278
062700201,454,13,5,3,0,0,14,489
062700202,228,4,0,3,0,0,3,238
062700203,273,6,1,1,0,3,8,292
062700204,265,9,3,10,0,0,11,298
062700205,288,21,4,3,1,2,3,322
062700206,451,20,4,6,1,1,8,491
062700207,381,22,2,3,0,0,12,420
062700208,443,23,5,7,0,2,14,494
062700209,419,14,1,14,4,2,8,462
062700210,362,15,1,3,0,1,5,387
062700211,423,6,0,9,3,1,4,446
062700212,419,12,4,4,0,0,26,465
062700213,254,9,2,14,0,3,3,285
062700214,246,4,2,10,0,0,7,269
062700215,265,7,1,6,0,2,3,284
062700216,329,12,0,10,1,6,0,358
062700217,371,15,1,8,4,1,11,411
062700301,229,15,9,11,0,13,5,282
062700302,250,11,2,7,0,6,2,278
062700303,413,16,3,5,0,0,5,442
062700304,486,16,4,6,0,0,14,526
062700305,420,24,2,7,0,1,11,465
062700306,337,13,5,4,0,2,16,377
062700307,266,16,1,11,1,0,16,311
062700308,350,17,4,11,1,1,9,393
062700309,397,21,3,4,1,0,1,427
062700310,366,20,5,6,2,3,9,411
062700311,343,15,1,9,0,0,13,381
062700312,439,28,7,8,7,1,33,523
062700313,239,13,2,4,2,2,9,271
062700314,286,1,29,7,2,2,27,354
062700315,241,27,4,7,7,2,14,302
062700316,248,36,6,4,11,0,3,308
062700401,165,9,5,1,0,1,2,183
062700402,268,23,10,9,1,5,4,320
062700403,365,44,29,5,3,1,14,461
062700404,371,9,2,23,0,22,88,515
062700405,391,1,3,15,2,15,20,447
062700406,457,11,6,14,0,9,12,509
062700407,330,3,4,13,0,9,15,374
062700408,176,24,11,5,10,2,11,239
062700409,425,34,10,2,2,2,8,483
062700410,349,4,3,3,0,7,14,380
062700411,439,12,5,6,0,4,7,473
062700412,352,22,3,7,1,3,12,400
062700413,339,19,9,9,1,4,15,396
062700414,308,15,5,2,0,0,4,334
062700501,292,11,10,6,2,9,8,338
062700502,224,8,12,4,2,6,13,269
062700503,234,1,0,2,0,1,8,246
062700504,416,9,3,9,0,3,9,449
062700505,358,7,1,8,3,0,3,380
062700506,354,3,0,6,0,0,4,367
062700507,375,10,5,9,0,16,11,426
062700508,407,24,2,8,1,5,15,462
062700509,11,0,0,0,0,0,2,13
062700510,380,10,3,19,1,2,14,429
062700511,191,17,1,7,0,7,13,236
062700512,235,53,10,18,0,18,55,389
062700601,271,11,0,9,1,1,5,298
062700602,181,21,23,6,5,122,70,428
062700603,111,0,7,8,0,127,7,260
062700604,138,42,1,8,0,56,12,257
062700605,356,21,4,18,0,11,34,444
062700606,411,20,1,24,0,4,9,469
062700607,399,24,2,24,2,18,18,487
062700608,411,23,2,25,1,1,19,482
062700609,355,43,5,7,0,16,32,458
062700610,534,9,1,19,2,8,21,594
062700611,403,37,1,19,0,14,9,483
062700612,114,2,1,2,0,3,92,214
062700613,104,18,0,7,2,42,2,175
062700614,230,16,3,4,0,3,6,262
062700615,194,11,2,9,0,5,6,227
062700616,333,12,7,34,0,1,10,397
062700617,465,22,2,24,2,4,13,532
062700701,248,6,1,4,0,4,5,268
062700702,198,7,2,20,0,3,9,239
062700703,308,13,3,6,0,2,5,337
062700704,189,14,4,8,0,1,3,219
062700705,309,5,5,10,0,0,6,335
062700706,229,9,2,4,0,1,5,250
062700707,418,10,12,13,2,9,17,481
062700708,239,9,19,6,9,0,10,292
062700709,203,16,9,7,0,5,3,243
062700710,185,8,3,1,1,8,2,208
062700711,352,20,3,12,0,1,11,399
062700712,413,11,0,8,0,0,6,438
062700713,265,8,1,7,1,2,1,285
062700714,319,11,2,1,7,0,8,348
062700715,268,17,1,5,0,1,11,303
062700716,351,19,1,34,0,15,14,434
062700717,368,14,2,15,0,6,9,414
062700718,487,15,0,10,0,1,10,523
062700719,413,19,0,14,1,1,18,466
062700801,74,8,3,8,0,48,4,145
062700802,42,6,0,2,0,15,38,103
062700803,69,6,2,4,0,14,32,127
062700804,18,4,0,0,0,2,1,25
062700805,45,4,1,6,0,38,14,108
062700806,28,6,0,10,0,52,123,219
062700807,71,25,8,4,0,15,6,129
062700808,375,2,2,12,0,3,18,412
062700809,250,19,0,3,0,0,8,280
062700810,219,7,1,6,1,0,2,236
062700811,322,48,0,14,2,342,25,753
062700812,28,1,0,0,0,1,2,32
062700813,57,17,1,3,0,38,40,156
062700814,99,9,3,11,0,29,4,155
062700815,165,3,0,6,0,34,12,220
062700816,177,11,0,5,0,7,5,205
062700817,35,6,3,0,1,2,3,50
062700901,599,15,2,14,0,0,19,649
062700902,367,31,2,10,0,2,6,418
062700903,290,2,4,15,2,3,15,331
062700904,292,2,6,12,1,2,14,329
062700905,292,10,3,11,0,0,1,317
062700906,265,16,0,9,0,0,13,303
062700907,241,16,10,3,0,1,5,276
062700908,195,7,1,4,0,4,2,213
062700909,241,16,2,13,0,1,11,284
062700910,357,14,0,5,0,1,7,384
062700911,242,8,3,8,0,3,2,266
062700912,271,11,3,4,0,4,7,300
062700913,283,15,0,18,0,1,15,332
062701001,359,38,5,3,3,7,15,430
062701002,511,30,6,20,0,11,25,603
062701003,589,36,3,20,2,6,10,666
062701004,411,25,0,5,0,3,18,462
062701005,350,8,3,7,8,4,8,388
062701006,278,12,0,9,2,0,14,315
062701007,365,17,4,10,0,1,7,404
062701008,328,5,3,15,0,0,8,359
062701009,296,13,6,18,0,2,13,348
062701010,334,11,1,14,1,0,12,373
062701101,371,51,1,6,0,4,30,463
062701102,9,3,0,0,0,0,0,12
062701103,21,0,0,0,0,2,1,24
062701104,107,10,0,7,2,71,22,219
062701105,13,7,0,1,0,0,0,21
062740101,336,0,1,7,1,0,9,354
062740102,376,0,15,9,19,1,15,435
062740103,214,0,4,2,1,1,20,242
062740104,187,0,1,5,0,1,6,200
062740105,454,1,4,7,1,0,20,487
062740106,246,2,0,2,2,0,7,259
062740107,243,2,4,4,1,0,5,259
062740108,171,0,2,0,0,0,14,187
062740109,228,0,4,2,1,3,11,249
062740110,259,0,7,7,1,4,16,294
062740111,256,0,4,4,3,0,8,275
062740112,226,1,1,1,1,2,0,232
062740113,411,1,4,1,4,0,9,430
062740114,214,1,5,0,0,0,13,233
062740115,454,3,7,1,12,2,12,491
062740201,363,8,15,7,4,1,6,404
062740202,349,1,3,2,0,1,14,370
062740203,400,0,1,8,0,0,8,417
062740204,277,4,11,2,0,3,3,300
062740205,304,2,7,6,0,0,5,324
062740206,440,2,1,4,0,1,11,459
062740207,300,0,13,2,2,0,8,325
062740208,259,2,0,1,0,0,3,265
062740209,261,0,0,1,0,1,2,265
062740210,290,4,0,0,0,0,2,296
062740211,392,5,2,2,2,4,1,408
062740212,307,0,0,1,0,1,8,317
062740213,305,0,5,4,0,0,5,319
062740214,377,1,4,6,0,4,7,399
062740215,375,1,8,6,0,5,9,404
062740301,357,7,1,4,0,0,2,371
062740302,242,5,1,2,1,1,4,256
062740303,213,11,2,3,0,2,4,235
062740304,416,9,3,1,0,1,7,437
062740305,354,11,1,1,1,1,5,374
062740306,195,13,6,4,0,0,1,219
062740307,356,4,2,4,0,1,8,375
062740308,287,11,2,3,0,0,6,309
062740309,232,6,0,0,0,1,3,242
062740310,366,12,0,2,0,0,5,385
062740311,343,11,1,6,0,1,2,364
062740312,366,7,2,1,0,0,2,378
062740313,368,10,2,8,0,1,3,392
062740314,294,7,1,3,1,1,4,311
062740315,238,72,0,79,0,0,8,397
062740316,285,9,1,3,0,0,5,303
062740401,327,6,1,5,1,0,14,354
062740402,381,11,0,2,0,0,8,402
062740403,333,8,1,6,2,3,1,354
062740404,330,17,1,3,0,0,7,358
062740405,293,10,1,1,0,1,6,312
062740406,289,8,1,2,0,0,7,307
062740407,241,6,6,5,0,1,1,260
062740408,235,13,2,1,0,1,5,257
062740409,351,10,0,1,0,0,2,364
062740410,318,11,2,3,0,1,6,341
062740411,262,19,2,1,2,0,9,295
062740412,464,7,0,1,0,1,7,480
062740413,290,11,0,2,0,0,4,307
062740414,293,0,1,6,0,0,4,304
062740415,333,1,5,3,0,0,4,346
062740416,257,15,0,2,0,0,4,278
062740417,287,11,0,6,0,2,21,327
062740501,268,14,2,2,0,0,17,303
062740502,229,20,0,4,1,0,7,261
062740503,247,11,1,2,0,1,5,267
062740504,324,6,0,3,1,2,13,349
062740505,217,2,1,3,0,0,5,228
062740506,211,5,0,1,0,0,1,218
062740507,311,4,1,2,0,2,3,323
062740508,370,23,1,0,1,4,8,407
062740509,255,11,4,2,0,1,2,275
062740510,293,6,1,9,0,5,5,319
062740511,343,6,1,6,0,0,8,364
062740512,315,11,2,6,0,0,7,341
062740513,258,14,0,2,1,0,5,280
062740514,369,12,3,7,0,0,2,393
062740515,327,16,0,4,0,1,8,356
062740516,273,11,0,4,0,1,8,297
062740601,379,7,1,5,0,0,9,401
062740602,296,3,1,12,0,0,1,313
062740603,290,6,1,3,0,4,13,317
062740604,282,5,7,6,2,0,11,313
062740605,388,5,9,7,1,4,3,417
062740606,367,11,4,1,0,0,7,390
062740607,221,3,0,1,0,0,3,228
062740608,236,10,4,3,1,0,5,259
062740609,238,7,1,7,1,0,2,256
062740610,266,4,3,9,3,3,16,304
062740611,245,5,1,11,0,1,1,264
062740612,248,1,3,2,0,0,3,257
062740613,217,3,1,2,0,0,8,231
062740614,247,3,1,1,0,1,5,258
062740615,330,4,1,6,0,0,6,347
062740616,179,3,0,1,0,0,3,186
062740617,259,4,2,0,1,0,3,269
062740618,193,4,1,1,0,0,4,203
062740619,187,4,0,4,1,0,7,203
062740620,342,9,0,7,0,1,5,364
062740701,185,13,3,18,2,13,18,252
062740702,240,6,3,8,0,4,3,264
062740703,282,7,0,1,1,0,11,302
062740704,278,3,0,0,0,0,8,289
062740705,289,4,3,3,0,0,13,312
062740706,360,7,1,10,0,0,10,388
062740707,334,11,3,1,0,0,5,354
062740708,395,20,2,6,1,0,6,430
062740709,302,9,3,3,0,2,13,332
062740710,269,19,2,6,1,1,6,304
062740711,217,5,0,8,0,0,1,231
062740712,263,6,0,2,0,0,1,272
062740713,324,15,1,6,1,1,3,351
062740801,174,5,0,1,0,0,3,183
062740802,203,11,6,3,1,3,5,232
062740803,262,6,0,0,0,0,2,270
062740804,250,6,2,0,0,0,0,258
062740805,240,8,0,0,0,0,1,249
062740806,183,3,0,0,0,0,2,188
062740807,347,12,0,0,0,0,4,363
062740808,258,21,2,0,0,0,15,296
062740809,240,8,0,1,0,1,0,250
062740810,285,1,1,3,0,0,9,299
062740811,232,2,0,1,0,2,4,241
062740812,250,14,0,1,1,1,3,270
062740813,393,9,1,7,2,2,14,428
062740814,300,5,0,5,0,0,11,321
062740815,303,3,1,6,1,1,14,329
062740816,268,9,1,4,0,0,6,288
062740817,228,10,0,1,0,0,22,261
062740818,286,4,4,6,0,1,8,309
062740819,301,15,0,8,0,1,7,332
062740820,316,8,0,7,0,0,3,334
062740901,326,14,1,8,0,2,22,373
062740902,304,9,1,8,0,6,7,335
062740903,317,17,7,11,0,2,5,359
062740904,286,11,1,11,0,0,7,316
062740905,245,1,2,4,0,1,14,267
062740906,373,25,3,14,0,2,16,433
062740907,228,2,0,5,1,0,5,241
062740908,199,15,0,5,1,3,7,230
062740909,200,13,1,3,0,1,1,219
062740910,330,15,1,0,0,2,3,351
062740911,204,9,0,0,0,2,3,218
062740912,239,5,1,8,1,1,4,259
062740913,248,6,1,2,0,1,4,262
062740914,235,6,1,7,0,0,7,256
062740915,380,11,3,13,0,1,9,417
062740916,233,6,3,4,0,0,5,251
062740917,281,7,0,7,1,2,12,310
062740918,281,19,1,5,0,2,6,314
062740919,337,13,0,9,0,3,10,372
062740920,354,9,3,6,0,3,15,390
062740921,289,3,2,2,0,0,12,308
062740922,274,17,2,7,0,4,11,315
062741001,299,32,0,5,0,3,13,352
062741002,279,10,2,13,0,2,7,313
062741003,305,12,1,5,0,1,5,329
062741004,262,8,0,2,0,0,3,275
062741005,229,4,1,4,0,0,4,242
062741006,217,2,1,3,0,1,6,230
062741007,328,7,1,5,0,0,2,343
062741008,341,7,2,10,0,0,6,366
062741009,193,9,0,3,0,0,5,210
062741010,259,19,2,12,2,24,5,323
062741011,194,20,1,3,0,36,47,301
062741012,297,10,1,2,0,3,17,330
062741013,81,26,5,9,0,3,17,141
062741014,233,8,5,6,0,3,12,267
062741015,273,29,5,18,2,36,16,379
062741101,273,15,2,5,0,2,6,303
062741102,307,15,3,3,0,0,3,331
062741103,258,5,1,1,0,1,5,271
062741104,295,5,1,3,0,0,2,306
062741105,374,8,1,4,0,0,10,397
062741106,452,23,1,1,0,0,7,484
062741107,272,6,3,0,0,0,2,283
062741108,286,9,3,1,0,0,2,301
062741109,483,10,1,4,2,0,10,510
062741110,498,15,1,0,0,0,7,521
062741111,260,28,6,10,1,14,4,323
062741112,284,17,1,5,0,2,4,313
062741113,265,11,3,1,1,0,3,284
062741114,281,19,1,9,0,1,3,314
062741115,295,11,4,3,0,1,3,317
062741116,255,4,0,0,0,0,5,264
062741117,359,12,2,7,1,0,6,387
062741118,262,5,3,2,0,1,8,281
062741201,410,26,8,5,2,1,12,464
062741202,240,14,1,9,1,1,6,272
062741203,300,13,18,6,4,2,5,348
062741204,169,22,10,5,15,0,7,228
062741205,204,12,8,2,3,0,3,232
062741206,189,7,3,1,1,0,11,212
062741207,208,13,1,2,1,0,3,228
062741208,398,18,8,6,8,0,14,452
062741209,390,9,0,7,1,4,3,414
062741210,315,10,3,5,0,1,6,340
062741211,342,6,2,5,0,0,9,364
062741212,379,14,2,9,1,2,6,413
062741213,203,2,1,2,0,0,5,213
062741214,217,7,4,2,4,0,3,237
062741215,299,5,2,5,0,0,7,318
062741216,324,13,0,7,0,0,3,347
062741217,321,17,4,8,0,0,3,353
062741301,379,22,1,6,0,0,10,418
062741302,189,12,6,2,1,0,3,213
062741303,225,12,3,3,1,0,10,254
062741304,235,10,3,5,0,0,3,256
062741305,225,4,2,1,0,1,3,236
062741306,297,7,0,3,0,0,1,308
062741307,256,3,4,0,4,0,10,277
062741308,231,20,4,1,1,0,2,259
062741309,265,0,2,6,0,3,13,289
062741310,222,6,1,2,0,1,4,236
062741311,263,7,5,4,5,1,3,288
062741312,359,13,9,12,1,0,11,405
062741313,166,16,8,3,1,1,2,197
062741314,185,25,28,3,9,0,12,262
062741315,227,23,28,8,27,0,13,326
062741316,258,18,4,6,1,0,4,291
062741317,417,36,4,5,1,1,6,470
062741401,391,18,7,1,0,0,4,421
062741402,345,26,21,7,0,2,24,425
062741403,204,29,5,1,3,1,18,261
062741404,293,13,16,4,1,0,5,332
062741405,368,17,13,2,2,1,10,413
062741406,202,23,43,4,2,1,7,282
062741407,239,50,22,0,21,2,20,354
062741408,298,20,15,6,7,0,6,352
062741409,352,25,9,3,5,0,9,403
062741410,289,18,10,5,6,0,14,342
062741411,347,26,10,9,6,2,24,424
062741501,323,3,0,0,0,0,1,327
062741502,303,6,0,1,0,2,2,314
062741503,260,4,0,1,2,1,5,273
062741504,361,15,2,1,0,1,7,387
062741505,179,13,0,2,0,1,5,200
062741506,208,11,1,1,1,0,2,224
062741507,287,3,3,1,0,0,6,300
062741508,226,6,0,0,0,0,2,234
062741509,214,4,1,2,0,0,0,221
062741510,410,4,0,2,0,0,4,420
062741511,244,4,3,2,0,0,2,255
062741512,231,10,0,0,0,0,0,241
062741513,260,11,2,2,0,1,2,278
062741514,255,0,0,2,0,2,6,265
062741515,245,12,2,0,0,0,0,259
062741516,322,6,0,0,0,0,2,330
062741517,328,6,0,0,0,0,5,339
062741518,397,20,8,7,1,1,9,443
062741601,336,9,1,4,0,0,9,359
062741602,370,7,0,3,0,1,3,384
062741603,355,13,9,12,0,1,9,399
062741604,435,4,1,4,0,0,14,458
062741605,244,3,0,1,1,1,6,256
062741606,327,7,4,2,0,0,3,343
062741607,261,10,0,2,3,0,6,282
062741608,279,6,2,1,3,0,11,302
062741609,226,6,0,0,0,0,3,235
062741610,277,14,0,1,0,0,9,301
062741611,203,26,0,0,0,1,6,236
062741612,239,3,1,1,0,0,2,246
062741613,288,5,0,2,0,0,3,298
062741614,259,10,0,0,0,0,1,270
062741701,209,3,2,2,1,1,6,224
062741702,216,18,1,3,1,1,7,247
062741703,279,5,0,2,0,0,2,288
062741704,258,7,2,2,0,0,7,276
062741705,236,7,1,1,0,0,9,254
062741706,284,7,0,4,0,0,4,299
062741707,207,11,4,3,0,0,3,228
062741708,210,7,2,1,1,0,12,233
062741709,305,9,2,6,2,0,15,339
062741710,294,7,1,3,0,1,7,313
062741711,233,9,1,3,0,0,6,252
062741712,191,4,2,0,0,0,2,199
062741713,297,8,0,6,0,3,6,320
062741714,341,14,3,2,1,1,14,376
062741801,435,6,1,9,1,0,5,457
062741802,257,4,0,2,0,0,4,267
062741803,238,2,0,1,0,0,1,242
062741804,220,3,0,0,0,0,2,225
062741805,234,5,0,0,0,0,3,242
062741806,351,2,0,0,0,1,6,360
062741807,358,2,3,0,0,0,2,365
062741808,229,4,0,2,1,0,4,240
062741809,292,6,1,0,0,0,2,301
062741810,311,5,0,3,0,0,5,324
062741811,387,13,1,9,0,0,4,414
062741812,198,4,1,7,0,1,3,214
062741813,289,7,0,2,1,0,8,307
062741814,237,6,3,0,0,0,6,252
062741815,209,5,1,3,0,0,2,220
062741816,371,11,2,3,0,0,6,393
062741817,344,5,10,3,2,0,1,365
062741818,395,8,4,11,0,0,11,429
062741901,311,10,3,1,1,1,5,332
062741902,375,3,0,3,0,1,5,387
062741903,266,6,2,4,0,1,2,281
062741904,419,13,3,1,0,0,1,437
062741905,465,10,0,8,0,1,10,494
062741906,341,5,2,5,0,0,5,358
062741907,396,4,2,1,1,1,9,414
062741908,207,9,1,5,0,2,4,228
062741909,211,7,5,6,0,0,7,236
062741910,436,14,2,6,0,1,9,468
062741911,445,13,3,5,0,0,7,473
062741912,391,9,2,5,0,0,8,415
062741913,269,17,0,5,0,0,4,295
062742001,355,3,0,1,0,2,2,363
062742002,348,5,0,3,0,1,3,360
062742003,320,15,1,2,0,1,3,342
062742004,518,4,1,5,0,1,4,533
062742005,418,11,0,3,0,1,6,439
062742006,394,14,0,4,3,1,5,421
062742007,464,11,0,1,0,1,3,480
062742008,276,7,2,6,1,0,9,301
062742009,269,7,2,2,0,1,4,285
062742010,259,10,0,1,0,0,0,270
062742011,287,9,0,1,0,1,3,301
062742012,308,9,2,4,0,1,1,325
062742013,343,7,0,2,0,2,5,359
062742014,47,1,0,0,0,0,401,449
062742015,10,2,0,0,0,0,470,482
062742016,258,6,1,1,0,1,9,276
062742101,201,3,0,0,0,19,1,224
062742102,217,8,3,8,0,5,14,255
062742103,412,9,0,7,3,5,11,447
062742104,336,6,0,0,0,0,11,353
062742105,349,8,0,1,0,0,3,361
062742106,389,0,0,0,0,0,11,400
062742107,398,0,0,0,1,0,14,413
062742108,386,5,0,0,0,1,2,394
062742109,248,3,0,0,0,0,0,251
062742110,242,4,0,2,0,0,4,252
062742111,251,1,8,2,1,0,2,265
062742112,224,1,0,0,0,1,4,230
062742113,376,7,5,9,0,0,12,409
062742114,303,3,1,1,0,1,4,313
062742115,394,10,0,6,0,0,6,416
062742116,235,0,3,4,0,0,6,248
062742117,293,9,1,8,0,0,17,328
062742118,330,7,2,6,0,1,4,350
062742119,304,11,3,4,0,0,4,326
062742120,219,5,2,1,0,0,4,231
062742121,224,5,0,4,0,1,6,240
062742122,242,9,3,3,0,1,6,264
062742123,275,12,1,3,3,0,5,299
062742201,233,20,0,3,1,0,6,263
062742202,245,10,0,3,0,0,8,266
062742203,407,7,1,2,2,2,7,428
062742204,245,9,3,1,0,0,6,264
062742205,255,4,0,3,1,1,2,266
062742206,305,10,2,4,0,4,10,335
062742207,44,8,1,3,0,108,5,169
062742208,92,6,5,6,0,40,5,154
062742209,142,3,2,5,1,14,2,169
062742210,311,16,7,15,2,21,9,381
062742211,394,23,1,29,0,3,15,465
062742212,240,35,3,36,1,21,24,360
063710101,264,3,0,1,0,0,3,271
063710102,268,0,0,0,0,0,5,273
063710103,371,0,1,0,0,0,2,374
063710104,223,3,1,2,3,1,13,246
063710105,172,0,0,0,1,0,0,173
063710106,124,2,0,2,0,0,2,130
063710107,99,1,0,1,0,0,0,101
063710108,96,0,0,0,2,0,4,102
063710109,225,0,2,3,0,0,5,235
063710110,391,1,1,4,0,0,7,404
063710111,20,0,0,1,0,0,6,27
063710201,375,2,5,0,6,2,7,397
063710202,366,1,1,1,2,0,17,388
063710203,376,8,4,1,5,0,12,406
063710204,366,0,1,2,1,0,11,381
063710205,461,4,3,19,3,0,23,513
063710206,275,3,2,1,0,1,8,290
063710207,245,0,2,0,0,0,6,253
063710208,280,3,4,1,0,1,8,297
063710209,394,6,7,1,3,0,8,419
063710210,376,0,3,8,0,0,5,392
063710211,247,0,0,0,2,0,7,256
063710212,202,0,3,1,0,0,1,207
063710301,400,0,4,0,4,0,12,420
063710302,232,2,3,1,0,0,5,243
063710303,154,1,2,1,0,0,0,158
063710304,398,0,4,3,0,0,13,418
063710305,302,0,5,0,0,0,5,312
063710306,291,1,7,0,1,1,14,315
063710307,315,0,10,1,3,5,17,351
063710308,365,1,5,2,3,0,6,382
063710309,290,0,0,0,0,0,2,292
063710310,235,0,3,0,0,0,2,240
063710311,347,3,0,0,0,0,1,351
063710312,115,3,0,0,0,0,1,119
063710313,203,6,0,0,0,0,3,212
063710314,221,3,1,1,0,0,12,238
063710315,324,0,3,2,0,0,22,351
063710401,432,5,5,4,5,0,14,465
063710402,383,1,4,1,3,1,20,413
063710403,218,1,4,1,0,0,8,232
063710404,206,4,4,2,0,0,12,228
063710405,323,2,7,1,2,1,6,342
063710406,376,2,5,1,13,0,32,429
063710407,332,7,8,3,1,2,14,367
063710408,198,3,5,0,1,0,4,211
063710501,221,4,6,1,3,0,13,248
063710502,304,2,3,0,1,0,6,316
063710503,157,15,3,3,1,0,9,188
063710504,223,1,0,1,2,0,15,242
063710505,239,2,0,0,0,0,6,247
063710506,313,4,8,1,7,0,13,346
063710507,263,4,3,1,2,0,13,286
063710508,193,6,1,1,1,1,4,207
063710509,380,8,5,0,5,0,6,404
063710510,361,13,2,1,0,0,18,395
063710601,205,13,7,1,1,0,10,237
063710602,200,0,1,3,5,0,10,219
063710603,242,1,1,2,0,0,16,262
063710604,212,9,5,0,3,0,16,245
063710605,202,3,1,0,0,0,59,265
063710606,267,1,2,0,0,0,10,280
063710607,255,1,0,1,2,0,3,262
063710608,173,3,1,0,0,0,0,177
063710609,319,6,0,1,0,0,0,326
063710610,345,10,4,1,0,0,18,378
063710611,416,4,1,0,0,0,7,428
063710612,276,17,3,0,1,0,14,311
063710701,267,16,3,0,2,0,11,299
063710702,425,10,9,0,1,0,11,456
063710703,262,3,0,0,0,0,8,273
063710704,305,0,0,0,0,0,0,305
063710705,263,1,0,1,0,0,1,266
063710706,295,9,0,0,0,0,6,310
063710707,467,9,0,4,2,0,11,493
063710708,216,8,8,0,7,0,16,255
063710709,327,31,5,1,3,0,12,379
063710710,210,12,3,0,3,0,11,239
063710711,209,4,1,0,0,0,5,219
063710712,313,25,7,0,0,0,16,361
063710713,261,13,10,4,3,2,25,318
063710801,413,13,4,4,1,0,10,445
063710802,269,19,6,2,1,0,6,303
063710803,314,13,4,1,5,0,18,355
063710804,302,28,2,3,0,0,8,343
063710805,283,31,11,5,5,0,17,352
063710806,403,13,6,1,0,0,5,428
063710807,254,29,1,0,3,0,14,301
063710808,334,8,8,4,5,2,30,391
063710809,331,21,6,5,4,0,19,386
063710810,335,16,5,0,4,0,18,378
063710811,323,25,11,2,1,1,11,374
063710812,320,37,5,0,6,0,1,369
063710901,359,1,4,0,4,1,16,385
063710902,389,3,12,3,6,0,8,421
063710903,245,0,4,3,0,1,16,269
063710904,210,1,0,0,3,1,15,230
063710905,273,0,9,0,1,0,10,293
063710906,473,2,9,4,4,2,20,514
063710907,274,5,7,0,2,0,12,300
063710908,356,8,3,2,1,2,16,388
063710909,358,20,4,2,3,0,13,400
063710910,363,15,11,8,5,1,10,413
063710911,179,5,3,1,0,0,6,194
063710912,230,13,8,3,2,0,7,263
063710913,228,10,4,3,1,4,11,261
063710914,334,29,6,4,7,1,8,389
063710915,184,25,1,0,0,0,8,218
063710916,187,14,6,5,1,0,5,218
063710917,310,13,8,1,3,2,11,348
063711001,282,11,8,1,2,0,16,320
063711002,373,27,6,3,6,0,12,427
063711003,324,28,8,4,2,2,12,380
063711004,186,19,16,2,0,0,13,236
063711005,225,14,21,1,2,0,13,276
063711006,348,29,7,3,1,0,11,399
063711007,374,14,7,1,5,0,21,422
063711008,296,17,7,4,1,3,11,339
063711009,287,31,5,4,2,1,19,349
063711010,347,41,12,2,3,2,14,421
063711011,286,18,18,0,1,3,21,347
063711012,102,3,0,0,0,0,0,105
063711013,341,17,2,0,6,1,7,374
063711014,284,17,7,5,2,0,4,319
063711015,320,19,7,2,5,0,25,378
063711016,191,10,5,2,0,0,6,214
063711101,260,5,25,0,1,1,12,304
063711102,236,7,15,2,12,2,10,284
063711103,313,2,24,6,8,0,18,371
063711104,335,18,18,49,17,2,21,460
063711105,278,5,4,1,75,0,17,380
063711106,226,1,14,2,52,0,33,328
063711107,347,13,3,7,9,2,29,410
063711108,243,22,25,2,22,0,28,342
063711109,177,11,13,2,3,0,17,223
063711110,381,13,21,4,4,2,5,430
063711201,363,29,7,2,11,0,12,424
063711202,238,38,8,2,1,0,11,298
063711203,204,16,3,1,0,0,6,230
063711204,365,21,6,4,4,0,12,412
063711205,226,18,5,6,3,4,12,274
063711206,193,31,34,1,2,0,5,266
063711207,278,20,11,5,4,0,11,329
063711208,423,27,9,7,3,1,25,495
063711209,268,21,3,0,3,0,25,320
063711210,294,45,12,4,37,0,23,415
063711301,300,20,5,3,1,0,17,346
063711302,312,19,3,5,1,0,10,350
063711303,379,22,10,6,2,1,13,433
063711304,341,29,2,4,4,0,27,407
063711305,298,26,11,4,8,0,25,372
063711306,349,17,2,7,1,0,18,394
063711307,376,22,10,2,6,2,10,428
063711308,307,40,3,3,13,0,7,373
063711309,382,19,5,7,4,0,21,438
063711310,371,1,7,14,1,0,32,426
063711311,312,23,7,2,5,1,29,379
063711312,361,20,3,11,3,0,20,418
063711401,349,9,3,3,2,0,23,389
063711402,277,7,4,0,9,0,21,318
063711403,170,12,2,2,0,0,12,198
063711404,241,1,2,3,1,0,6,254
063711405,171,2,0,0,0,1,4,178
063711406,366,1,0,0,0,0,3,370
063711407,180,6,0,3,0,0,2,191
063711408,231,7,1,0,0,0,5,244
063711409,210,5,0,0,0,0,2,217
063711410,206,3,0,0,1,0,3,213
063711411,210,16,6,1,2,1,10,246
063711412,236,8,4,1,0,0,4,253
063711413,255,17,9,3,2,0,12,298
063711414,212,18,1,4,0,0,2,237
063711501,48,1,0,0,0,0,0,49
063711502,208,6,0,0,0,0,0,214
063711503,340,3,1,1,0,0,0,345
063711504,130,0,0,0,0,0,0,130
063711505,501,5,1,0,0,0,1,508
063711506,454,12,0,0,0,0,5,471
063711507,195,4,0,0,0,0,4,203
063711508,149,0,0,0,0,0,5,154
063711509,197,9,0,0,0,0,6,212
063711510,122,5,0,0,0,0,4,131
063711511,370,1,0,1,2,0,4,378
063711512,242,5,0,0,0,0,11,258
063711513,211,4,0,0,0,0,26,241
063711514,249,5,0,0,0,0,28,282
063711601,153,2,0,0,0,0,4,159
063711602,155,2,0,1,0,0,0,158
063711603,153,2,0,0,0,0,3,158
063711604,293,0,0,0,0,0,4,297
063711605,59,0,0,0,0,0,4,63
063711606,150,8,2,0,2,0,3,165
063711607,226,15,6,2,4,2,6,261
063711608,309,20,4,1,2,2,9,347
063711609,359,17,8,3,3,6,19,415
063711610,237,8,3,2,4,1,13,268
063711611,243,15,2,2,4,0,7,273
063711612,113,15,6,3,6,0,6,149
063711613,278,24,10,4,3,1,7,327
063711614,229,8,0,0,0,0,7,244
063711701,353,21,10,3,8,0,30,425
063711702,317,26,3,5,6,1,6,364
063711703,305,18,6,1,7,0,20,357
063711704,309,12,6,1,9,2,9,348
063711705,275,19,11,5,2,0,15,327
063711706,328,15,9,1,4,1,18,376
063711707,296,12,3,4,2,1,20,338
063711708,289,11,12,1,3,0,7,323
063711709,300,27,9,0,15,0,28,379
063711710,380,24,3,2,0,0,2,411
063711711,330,19,0,4,1,2,12,368
063711712,244,20,5,2,1,2,4,278
063711713,359,18,9,5,0,0,15,406
063711714,329,12,9,4,3,2,15,374
063711801,329,30,8,6,1,0,22,396
063711802,235,18,7,0,2,2,26,290
063711803,375,40,22,1,6,2,21,467
063711804,351,30,12,3,5,3,14,418
063711805,329,19,6,0,4,0,25,383
063711806,342,12,1,1,0,0,12,368
063711807,323,26,6,1,2,0,11,369
063711808,249,11,2,1,2,1,8,274
063711809,265,6,4,1,2,0,5,283
063711810,219,7,2,2,3,1,8,242
063711811,404,31,5,6,3,1,14,464
063711812,218,4,5,1,1,0,3,232
063711813,341,18,2,0,2,1,17,381
063711814,438,33,2,7,1,1,11,493
063711815,411,28,2,2,0,1,9,453
063711901,208,41,1,0,5,0,12,267
063711902,298,46,12,9,2,1,13,381
063711903,304,24,12,6,12,0,21,379
063711904,304,36,4,4,4,0,19,371
063711905,323,28,5,3,4,3,15,381
063711906,234,8,0,1,0,0,4,247
063711907,357,21,8,8,2,0,22,418
063711908,321,14,6,6,4,2,14,367
063711909,374,44,20,12,6,0,24,480
063712001,364,30,7,2,0,0,5,408
063712002,361,19,8,3,5,2,10,408
063712003,263,11,9,1,3,0,10,297
063712004,374,27,8,3,3,4,20,439
063712005,260,8,6,0,3,2,10,289
063712006,365,20,5,3,4,0,10,407
063712007,363,5,7,1,1,0,9,386
063712008,218,13,0,1,0,0,5,237
063712101,311,12,18,1,13,0,33,388
063712102,355,23,8,0,15,0,43,444
063712103,235,20,32,14,11,2,23,337
063712104,171,13,7,4,5,0,15,215
063712105,396,23,12,4,13,1,30,479
063712106,118,8,0,0,0,0,4,130
063712107,273,16,1,1,3,0,9,303
063712108,367,20,5,5,3,0,28,428
063712109,326,36,15,4,2,1,26,410
063712110,283,15,13,4,2,0,25,342
063712111,385,33,12,3,8,1,19,461
063712112,198,29,0,1,0,0,1,229
063712113,275,18,8,2,1,0,14,318
063712114,273,25,10,7,2,0,13,330
063712115,319,47,68,0,0,0,21,455
063712201,306,22,9,1,3,0,13,354
063712202,254,35,23,6,15,0,12,345
063712203,259,14,4,0,0,0,11,288
063712204,326,32,18,8,14,2,45,445
063712205,183,16,0,0,9,0,18,226
063712206,168,24,12,3,7,0,15,229
063712207,308,19,4,2,4,0,20,357
063712208,218,27,9,8,31,0,13,306
063712209,187,27,10,1,8,0,9,242
063712210,187,16,18,1,6,1,17,246
063712211,133,34,10,0,81,0,1,259
063712212,208,19,4,1,5,1,31,269
063712213,210,23,13,11,4,0,13,274
063712214,239,25,22,1,42,1,24,354
063712301,295,3,26,3,16,0,43,386
063712302,409,5,1,5,1,1,24,446
063712303,147,5,11,1,95,4,18,281
063712304,218,26,33,1,87,0,9,374
063712305,238,7,13,0,20,0,32,310
063712306,256,8,7,1,8,0,32,312
063712307,273,5,22,0,24,1,17,342
063712308,295,6,5,2,11,3,18,340
063712309,269,0,38,3,126,5,37,478
063712310,199,0,34,4,103,0,1,341
063712311,245,8,19,6,26,0,26,330
063712312,227,6,30,4,61,0,16,344
063712313,245,4,44,4,153,0,14,464
063712314,294,3,9,2,3,0,24,335
063712315,423,14,2,3,2,0,24,468
063712316,404,13,7,2,2,0,18,446
063712317,278,5,14,2,19,0,15,333
063712401,349,12,2,1,4,1,15,384
063712402,209,8,7,3,1,0,17,245
063712403,394,6,7,2,3,0,18,430
063712404,133,4,3,1,1,0,9,151
063712405,173,2,2,2,24,0,10,213
063712406,208,5,5,2,3,2,5,230
063712407,230,15,2,1,3,0,21,272
063712408,213,4,13,0,12,0,5,247
063712501,256,13,6,0,0,0,15,290
063712502,288,19,1,0,0,0,10,318
063712503,197,23,2,5,4,1,7,239
063712504,285,20,11,1,9,0,27,353
063712505,305,26,8,7,11,0,11,368
063712506,291,10,5,5,2,1,16,330
063712507,295,18,7,1,3,0,24,348
063712508,267,18,2,7,0,2,17,313
063712601,342,22,11,1,6,0,18,400
063712602,184,12,10,2,3,0,5,216
063712603,295,16,2,0,1,0,9,323
063712604,323,25,5,1,3,1,2,360
063712605,176,7,0,2,0,0,15,200
063712606,263,6,10,4,0,0,18,301
063712607,241,32,4,4,3,0,15,299
063712608,226,24,4,1,1,1,9,266
063712701,244,20,2,1,0,0,4,271
063712702,316,17,2,7,3,0,16,361
063712703,490,26,5,7,0,0,17,545
063712704,321,14,14,2,1,0,14,366
063712705,302,10,3,0,0,0,30,345
063712706,168,5,1,1,0,0,7,182
063712707,190,14,4,1,0,1,11,221
063712708,210,23,3,1,3,0,12,252
063712801,163,1,0,0,0,0,2,166
063712802,47,1,4,0,0,0,2,54
063712803,32,13,0,0,0,0,1,46
063712804,99,11,3,3,3,0,1,120
063712805,60,1,4,0,1,0,6,72
063712806,238,4,3,7,0,0,20,272
063712807,75,6,3,2,0,0,3,89
063712808,276,9,1,1,2,0,8,297
063712901,266,35,16,0,9,0,11,337
063712902,205,17,53,1,5,0,25,306
063712903,196,15,11,3,4,1,27,257
063712904,308,34,10,7,1,0,15,375
063712905,390,24,19,2,6,3,14,458
063712906,172,12,7,1,1,0,9,202
063712907,405,16,7,3,9,0,19,459
063712908,588,30,28,2,4,0,29,681
063712909,353,17,4,0,0,4,27,405
063713001,270,9,9,1,0,0,4,293
063713002,373,19,4,0,3,0,14,413
063713003,262,18,0,2,0,0,4,286
063713004,215,20,3,1,4,0,3,246
063713005,295,16,6,0,3,0,16,336
063713006,293,12,2,1,1,0,18,327
063713007,214,15,7,0,8,0,5,249
063713008,241,14,2,0,0,0,13,270
063713009,228,15,6,3,0,0,9,261
063713010,116,2,0,0,1,0,0,119
063713011,298,24,8,1,1,0,19,351
063713101,306,22,1,2,2,0,4,337
063713102,207,17,0,2,0,0,8,234
063713103,358,26,3,3,2,0,5,397
063713104,123,6,6,3,0,0,3,141
063713105,270,19,3,4,1,0,3,300
063713106,446,25,0,0,0,0,2,473
063713107,263,20,4,5,2,1,13,308
063713108,243,18,10,4,2,0,13,290
063713201,66,6,21,0,0,2,12,107
063713202,407,7,0,0,1,0,14,429
063713203,347,8,3,0,1,0,5,364
063713204,298,31,2,0,1,2,1,335
063713205,309,16,1,4,1,0,6,337
063713206,351,4,4,1,1,0,28,389
063713207,260,8,11,1,2,1,11,294
063713208,437,20,9,0,3,0,13,482
063713209,236,10,8,1,0,0,2,257
063713210,391,17,0,2,0,0,3,413
063713211,394,18,3,1,0,0,3,419
063713212,298,3,2,1,5,0,5,314
063713213,347,13,10,5,1,0,7,383
063713214,453,2,3,1,1,0,5,465
063713215,244,11,5,1,0,0,6,267
063713301,258,5,0,0,0,0,3,266
063713302,369,13,0,0,0,0,8,390
063713303,379,29,2,2,1,1,10,424
063713304,294,21,2,0,0,0,8,325
063713305,416,23,2,3,0,0,20,464
063713306,368,24,12,2,0,0,15,421
063713307,282,28,4,0,1,1,5,321
063713308,217,5,4,0,1,0,4,231
063713309,312,7,11,0,1,0,10,341
063713310,190,17,0,2,0,1,3,213
063713401,241,19,2,1,0,0,9,272
063713402,323,14,3,2,2,0,6,350
063713403,133,5,8,1,1,0,9,157
063713404,237,7,5,1,2,0,9,261
063713405,432,7,0,0,0,0,5,444
063713406,255,15,7,6,4,1,10,298
063713407,287,15,11,1,1,1,8,324
063713408,314,29,10,1,6,0,17,377
063713409,213,32,6,1,0,0,9,261
063713501,364,9,3,4,2,1,17,400
063713502,190,3,2,0,0,0,5,200
063713503,217,1,2,1,0,1,9,231
063713504,206,11,1,0,2,0,3,223
063713505,203,10,3,2,0,0,7,225
063713506,358,18,10,3,6,1,13,409
063713507,18,0,0,1,0,0,1,20
063713508,22,0,0,0,0,0,0,22
063713509,40,1,0,3,0,0,0,44
063713510,218,2,0,4,0,0,3,227
063713511,375,6,1,1,0,1,1,385
063713512,265,2,0,7,0,0,3,277
063713513,300,25,0,1,2,0,6,334
063713514,184,9,1,0,1,0,1,196
063713601,367,21,0,0,3,0,6,397
063713602,231,5,3,0,0,0,12,251
063713603,261,14,0,1,0,0,14,290
063713604,464,13,0,2,1,0,9,489
063713605,287,7,7,4,0,0,4,309
063713606,276,14,1,2,0,1,3,297
063713607,338,18,1,3,0,0,3,363
063713608,333,22,11,2,6,0,22,396
063713609,417,22,1,2,4,0,5,451
063713610,345,28,7,4,2,1,5,392
063713611,379,23,10,3,4,1,11,431
063713701,248,4,1,1,0,0,8,262
063713702,322,6,0,1,0,1,5,335
063713703,182,5,0,0,0,1,3,191
063713704,106,6,0,1,0,0,1,114
063713705,140,8,1,0,0,0,4,153
063713706,174,4,0,1,0,0,3,182
063713707,365,20,1,3,0,0,6,395
063713708,540,27,2,4,0,0,12,585
063713709,441,14,0,2,0,0,8,465
063713710,414,20,1,6,1,1,7,450
063713711,360,14,0,1,1,0,3,379
063713712,337,3,1,4,0,1,3,349
063713713,360,14,1,2,0,0,6,383
063713714,350,15,0,1,0,0,2,368
063713715,340,12,0,2,0,0,3,357
063713716,415,14,0,2,2,0,22,455
064080101,344,0,9,1,2,0,10,366
064080102,275,1,3,2,3,1,9,294
064080103,335,8,4,1,2,0,20,370
064080104,378,6,6,1,4,1,17,413
064080105,363,2,18,1,2,0,4,390
064080106,212,0,13,3,1,2,8,239
064080107,369,0,11,2,2,1,22,407
064080108,378,0,1,1,1,0,14,395
064080109,425,4,6,3,0,1,7,446
064080110,235,1,1,2,0,4,4,247
064080111,529,5,9,6,3,3,13,568
064080112,359,0,5,5,1,0,5,375
064080113,390,13,12,0,0,0,4,419
064080114,26,0,0,0,0,0,0,26
064080115,101,7,2,0,2,0,3,115
064080116,194,9,11,0,2,2,22,240
064080117,292,17,5,3,2,0,19,338
064080201,300,18,2,1,0,0,8,329
064080202,337,12,11,1,1,0,13,375
064080203,328,16,4,1,0,0,14,363
064080204,342,15,2,2,1,0,6,368
064080205,230,15,3,0,1,0,7,256
064080206,319,32,7,2,0,0,0,360
064080207,388,22,6,3,0,2,16,437
064080208,469,15,9,6,0,0,5,504
064080209,476,24,7,4,1,0,6,518
064080210,417,33,0,3,0,1,5,459
064080211,311,16,5,1,0,0,11,344
064080301,97,8,0,0,0,0,0,105
064080302,90,2,1,2,1,0,0,96
064080303,326,1,1,1,1,0,12,342
064080304,273,14,4,0,0,0,4,295
064080305,275,7,8,4,2,1,5,302
064080306,308,6,11,4,1,2,7,339
064080307,429,24,2,2,0,0,19,476
064080308,601,13,11,0,0,0,8,633
064080309,282,24,10,2,13,0,8,339
064080310,201,5,3,3,0,0,14,226
064080401,340,11,1,2,0,4,9,367
064080402,534,6,2,1,3,0,1,547
064080403,203,3,1,0,0,0,1,208
064080404,360,10,1,2,0,0,5,378
064080405,349,6,3,3,0,0,5,366
064080406,254,10,4,1,0,2,3,274
064080407,364,16,3,0,0,0,3,386
064080408,431,14,3,3,1,0,15,467
064080409,342,7,2,2,0,0,14,367
064080410,557,19,8,7,0,0,9,600
064080411,292,10,0,0,0,0,2,304
064080412,297,7,3,3,1,0,6,317
064080501,227,8,1,1,1,1,0,239
064080502,273,4,2,0,0,0,4,283
064080503,333,5,6,0,0,0,6,350
064080504,286,7,3,2,0,0,7,305
064080505,103,2,2,1,1,0,1,110
064080506,203,3,3,3,0,0,6,218
064080507,229,10,5,1,0,0,2,247
064080508,276,12,3,0,0,1,1,293
064080509,301,13,6,2,1,0,4,327
064080510,249,11,5,0,0,0,8,273
064080511,260,11,3,5,1,0,5,285
064080512,238,6,0,4,1,2,10,261
064080601,356,46,7,2,28,0,22,461
064080602,177,13,2,2,0,0,3,197
064080603,345,30,3,7,5,0,22,412
064080604,272,17,3,11,9,2,14,328
064080605,359,21,8,5,0,4,13,410
064080606,100,4,0,2,1,0,8,115
064080607,336,16,5,9,0,2,7,375
064080608,272,16,5,5,0,1,10,309
064080609,339,27,7,3,6,0,20,402
064080701,318,23,6,6,1,0,7,361
064080702,216,10,0,2,0,0,9,237
064080703,207,4,0,0,0,0,5,216
064080704,373,18,5,0,0,3,7,406
064080705,335,21,6,6,1,1,7,377
064080706,312,23,5,5,1,0,14,360
064080707,94,7,2,1,1,1,4,110
064080708,326,34,8,2,1,2,7,380
064080709,214,11,4,2,0,1,4,236
064080710,249,11,0,2,3,0,4,269
064080801,315,6,2,0,2,0,6,331
064080802,282,7,0,0,0,0,0,289
064080803,203,18,3,1,0,0,5,230
064080804,196,17,7,3,4,1,5,233
064080805,228,18,4,1,1,0,4,256
064080806,292,14,2,10,1,1,4,324
064080807,231,11,3,0,0,2,3,250
064080808,322,19,5,2,1,0,9,358
064080809,245,16,5,1,0,0,7,274
064080810,322,13,8,0,0,0,26,369
064080811,324,16,2,2,1,0,11,356
064080812,170,7,0,1,1,0,6,185
064080813,249,12,0,0,0,0,2,263
064080814,433,9,5,4,1,0,9,461
064080901,365,21,8,3,5,1,23,426
064080902,214,20,7,2,1,1,9,254
064080903,257,13,3,3,0,0,6,282
064080904,245,23,4,2,5,0,13,292
064080905,343,28,8,4,12,0,14,409
064080906,354,20,7,4,1,2,15,403
064080907,422,11,4,2,2,1,7,449
064080908,314,17,2,0,1,0,12,346
064081001,319,9,4,6,0,3,7,348
064081002,275,9,4,5,0,0,1,294
064081003,377,27,1,2,1,0,16,424
064081004,358,21,11,2,1,0,10,403
064081005,429,8,3,2,0,2,20,464
064081006,277,9,1,1,0,0,4,292
064081007,395,13,7,7,3,0,10,435
064081008,239,11,4,0,1,0,13,268
064081101,258,11,0,1,0,1,5,276
064081102,298,15,2,0,0,1,1,317
064081103,342,14,5,5,0,0,4,370
064081104,323,28,2,3,0,0,1,357
064081105,427,12,3,8,0,1,7,458
064081106,300,19,3,1,0,1,21,345
064081107,80,1,0,0,0,0,1,82
064081108,316,7,1,3,1,2,5,335
064081109,72,4,0,0,0,0,2,78
064081110,171,5,4,0,0,0,0,180
064081111,74,5,2,1,0,0,1,83
064081201,324,4,0,1,0,0,6,335
064081202,250,5,0,44,2,0,17,318
064081203,321,5,2,2,0,4,2,336
064081204,317,17,3,1,0,2,3,343
064081205,447,26,7,6,1,2,7,496
064081206,552,20,9,10,0,0,8,599
064081207,359,15,11,2,5,5,11,408
064081208,464,20,6,8,1,0,12,511
064081209,281,12,13,11,1,3,4,325
064081301,433,20,1,1,3,1,20,479
064081302,276,8,1,1,0,1,3,290
064081303,279,8,2,2,1,0,5,297
064081304,267,8,5,2,0,0,4,286
064081305,236,9,0,1,0,0,7,253
064081306,354,12,1,1,2,0,4,374
064081307,337,0,3,2,1,3,7,353
064081308,301,8,5,4,0,1,8,327
064081309,256,1,3,3,0,0,0,263
064081310,324,9,0,9,0,0,3,345
064081311,341,16,3,2,0,1,4,367
064081312,318,8,2,2,2,0,3,335
064081313,205,15,1,0,0,0,20,241
064081401,319,18,5,0,3,0,10,355
064081402,348,22,0,1,0,0,23,394
064081403,385,4,3,0,1,1,11,405
064081404,394,12,8,0,4,3,15,436
064081405,167,1,1,2,0,0,11,182
064081406,241,8,3,2,1,0,5,260
064081407,230,18,3,2,2,0,5,260
064081408,230,11,7,6,0,0,6,260
064081409,203,17,1,0,0,0,4,225
064081410,251,15,5,2,2,0,3,278
064081411,271,15,7,5,1,1,3,303
064081412,294,26,32,14,2,0,10,378
064081413,306,19,5,1,1,1,11,344
064081501,382,22,12,5,0,0,11,432
064081502,414,12,1,3,2,1,11,444
064081503,51,4,1,0,0,0,3,59
064081504,331,4,0,2,1,0,3,341
064081505,414,42,18,0,0,1,19,494
064081506,105,15,3,0,1,0,2,126
064081507,266,9,1,1,1,0,6,284
064081508,207,19,1,2,1,0,7,237
064081509,303,20,4,4,1,1,18,351
064081510,201,7,5,1,1,0,7,222
064081511,264,17,4,2,0,0,3,290
064081512,132,24,0,2,0,2,6,166
064081513,291,25,5,1,0,0,15,337
064100101,300,7,0,3,0,1,12,323
064100102,342,0,0,3,0,1,7,353
064100103,304,0,1,2,0,1,2,310
064100104,427,3,5,5,0,8,8,456
064100105,235,1,2,9,0,10,7,264
064100106,227,0,9,5,0,73,2,316
064100107,223,1,7,8,1,54,10,304
064100108,404,1,6,7,0,32,27,477
064100109,241,1,7,4,0,18,5,276
064100110,328,1,6,17,1,6,48,407
064100111,792,40,9,16,2,7,36,902
064100112,332,2,11,12,1,26,16,400
064100113,180,1,2,9,1,53,17,263
064100201,276,5,2,7,1,18,19,328
064100202,277,13,1,10,0,22,11,334
064100203,220,36,3,17,9,41,17,343
064100204,60,3,0,5,0,0,4,72
064100205,375,20,1,5,0,0,7,408
064100206,57,4,0,1,0,1,2,65
064100207,236,8,3,0,0,1,4,252
064100208,395,25,2,2,0,1,4,429
064100209,322,25,5,8,2,0,9,371
064100210,273,6,4,5,2,8,8,306
064100301,356,24,6,6,0,14,7,413
064100302,293,19,5,5,3,8,5,338
064100303,242,36,2,8,0,23,21,332
064100304,302,11,1,2,0,2,9,327
064100305,323,26,8,5,0,1,8,371
064100306,293,17,2,5,0,2,5,324
064100307,265,7,3,9,0,1,5,290
064100308,267,11,4,7,1,0,7,297
064100309,383,13,1,3,4,7,11,422
064100310,286,16,3,1,1,0,8,315
064100311,228,6,2,13,0,5,5,259
064100312,150,9,6,7,0,13,3,188
064100401,353,23,2,1,0,4,8,391
064100402,302,18,2,3,2,1,13,341
064100403,394,20,1,2,0,2,7,426
064100404,249,22,2,1,1,1,10,286
064100405,232,11,5,1,0,1,3,253
064100406,341,27,5,7,0,2,18,400
064100407,220,9,6,3,1,1,4,244
064100408,265,17,2,3,0,0,10,297
064100409,431,13,3,1,0,1,10,459
064100410,242,11,0,3,1,0,3,260
064100411,223,22,2,1,0,0,6,254
064100412,243,16,1,3,1,0,7,271
064100413,261,7,3,2,1,1,12,287
064100414,364,20,6,0,1,0,12,403
064100415,78,0,3,7,0,1,0,89
064100416,167,36,2,20,0,20,9,254
064100501,232,5,3,0,1,0,9,250
064100502,253,5,3,1,0,0,4,266
064100503,392,12,1,4,1,3,10,423
064100504,217,5,8,0,0,0,0,230
064100505,268,3,3,1,0,0,7,282
064100506,174,8,0,1,6,0,4,193
064100507,188,3,0,1,0,0,1,193
064100508,326,9,0,1,1,2,8,347
064100509,333,23,2,4,5,0,6,373
064100510,326,6,2,0,1,0,14,349
064100511,272,2,0,1,0,0,4,279
064100512,275,16,1,1,0,1,5,299
064100513,355,10,2,2,2,0,13,384
064100514,211,2,0,1,0,1,2,217
064100515,366,0,0,1,0,0,3,370
064100601,346,12,4,0,0,2,4,368
064100602,326,15,2,1,0,0,10,354
064100603,370,17,4,4,0,0,15,410
064100604,336,13,3,3,1,0,13,369
064100605,313,19,3,5,0,3,18,361
064100606,301,19,7,2,2,1,6,338
064100607,312,33,6,2,1,1,16,371
064100608,415,20,1,5,0,4,9,454
064100609,279,17,3,4,4,0,6,313
064100610,270,14,7,6,0,0,5,302
064100611,200,11,2,2,1,0,0,216
064100612,406,27,12,5,1,3,16,470
064100613,416,19,7,6,1,4,8,461
064100614,383,22,2,8,1,0,13,429
064100615,329,27,10,1,1,2,10,380
064100701,218,14,1,0,0,1,4,238
064100702,184,6,3,3,0,0,9,205
064100703,307,12,4,3,2,0,13,341
064100704,429,17,7,8,0,0,10,471
064100705,356,18,8,4,1,3,11,401
064100706,290,8,14,3,0,0,4,319
064100707,446,16,4,5,0,3,6,480
064100708,277,12,1,5,0,0,6,301
064100709,291,9,4,4,2,3,6,319
064100710,400,22,6,3,4,0,10,445
064100711,298,21,1,4,1,2,6,333
064100712,269,22,4,0,1,0,9,305
064100713,370,17,3,10,2,2,12,416
064100714,270,6,2,0,0,0,4,282
064100715,230,13,1,2,0,1,10,257
064100716,434,19,8,2,1,1,4,469
064100801,213,11,0,1,0,0,1,226
064100802,247,15,4,1,1,2,6,276
064100803,397,16,2,4,0,0,11,430
064100804,236,19,0,3,0,0,8,266
064100805,261,8,3,2,2,1,5,282
064100806,397,16,10,4,2,5,14,448
064100807,379,18,6,3,3,0,8,417
064100808,291,24,5,4,4,3,12,343
064100809,434,41,5,3,2,2,9,496
064100901,391,24,5,8,5,4,8,445
064100902,263,20,7,3,0,2,6,301
064100903,425,28,6,8,5,2,13,487
064100904,363,32,6,5,1,2,20,429
064100905,319,24,16,3,4,2,16,384
064100906,303,6,3,2,1,2,11,328
064100907,282,8,2,2,1,3,11,309
064100908,279,14,20,5,2,1,38,359
064100909,268,13,4,3,0,0,9,297
064101001,405,16,7,8,3,4,7,450
064101002,410,23,12,12,0,1,15,473
064101003,345,16,5,12,0,1,11,390
064101004,373,24,8,2,3,1,11,422
064101005,309,17,6,5,0,0,5,342
064101006,309,10,2,0,1,2,12,336
064101007,442,24,3,9,1,1,12,492
064101008,292,16,7,3,0,1,2,321
064101009,301,15,4,5,1,3,5,334
064101010,336,24,13,9,2,0,11,395
064101101,355,32,6,6,5,3,16,423
064101102,350,18,8,7,13,2,14,412
064101103,285,10,12,6,2,0,23,338
064101104,283,11,11,5,4,1,18,333
064101105,199,15,3,2,81,2,18,320
064101106,207,25,6,5,30,0,17,290
064101107,289,15,4,5,11,3,17,344
064101108,295,33,1,7,2,0,9,347
064101109,386,28,12,5,5,0,9,445
064101110,341,10,10,3,1,3,14,382
064101111,318,9,4,3,6,4,8,352
064101201,327,23,9,0,23,4,22,408
064101202,331,44,12,1,5,1,13,407
064101203,201,18,4,2,1,1,10,237
064101204,236,14,0,6,0,1,3,260
064101205,232,4,1,3,0,0,17,257
064101206,276,15,4,5,0,0,3,303
064101207,270,24,8,5,4,2,6,319
064101208,170,12,5,0,2,1,7,197
064101209,218,10,5,1,0,6,8,248
064101210,216,13,3,1,4,1,11,249
064101211,280,15,3,2,0,0,14,314
064101212,271,10,0,3,1,3,2,290
064101213,436,16,5,3,0,0,16,476
064101301,395,15,6,6,4,6,7,439
064101302,253,9,4,6,1,4,8,285
064101303,202,5,3,2,5,4,3,224
064101304,216,8,2,4,2,3,10,245
064101305,236,12,0,2,1,2,12,265
064101306,437,24,1,2,0,2,17,483
064101307,459,16,5,6,1,0,20,507
064101308,262,26,1,4,0,1,9,303
064101309,248,9,5,1,0,0,1,264
064101310,229,10,5,2,2,1,8,257
064101311,257,16,0,4,0,0,2,279
064120101,200,3,3,2,0,28,6,242
064120102,168,0,0,2,1,89,3,263
064120103,63,0,2,8,0,85,2,160
064120104,157,1,0,5,0,5,1,169
064120105,98,1,1,0,0,19,36,155
064120106,293,2,6,6,1,67,8,383
064120107,88,6,5,8,0,15,11,133
064120108,134,43,2,9,0,20,21,229
064120109,324,43,8,19,0,21,10,425
064120110,380,22,8,17,0,7,16,450
064120111,198,8,1,13,0,9,8,237
064120112,302,19,0,6,0,0,1,328
064120113,278,7,1,5,0,0,5,296
064120114,325,8,0,4,0,0,13,350
064120115,283,11,2,3,0,2,4,305
064120116,433,8,0,5,0,2,4,452
064120117,393,14,1,10,0,1,9,428
064120118,391,9,0,1,0,1,2,404
064120201,127,22,2,3,0,4,11,169
064120202,317,10,7,8,0,18,6,366
064120203,299,7,0,3,0,0,16,325
064120204,374,8,1,1,0,1,7,392
064120205,412,21,1,3,2,0,7,446
064120206,257,15,0,1,2,0,7,282
064120207,306,20,4,3,13,0,8,354
064120208,344,4,0,1,0,0,3,352
064120209,339,15,3,3,0,2,6,368
064120210,307,15,5,5,2,1,20,355
064120211,277,13,3,8,3,0,8,312
064120301,322,7,2,3,2,0,4,340
064120302,428,12,1,2,1,5,16,465
064120303,418,14,3,5,0,2,7,449
064120304,357,5,6,11,0,2,7,388
064120305,392,17,8,7,2,2,285,713
064120306,321,36,2,4,5,0,15,383
064120307,403,20,9,9,1,0,5,447
064120308,278,8,5,5,2,5,12,315
064120309,285,10,1,5,0,0,7,308
064120310,321,9,2,0,0,0,19,351
064120311,342,23,1,2,0,1,7,376
064120312,151,15,17,2,8,1,16,210
064120313,207,16,3,2,6,0,10,244
064120401,391,29,0,3,1,0,17,441
064120402,346,13,3,2,0,0,8,372
064120403,395,16,3,2,0,0,8,424
064120404,417,24,9,0,1,1,15,467
064120405,260,6,2,0,0,0,9,277
064120406,263,7,3,0,0,0,3,276
064120407,282,16,0,6,2,1,3,310
064120408,184,3,1,2,4,0,8,202
064120409,212,17,6,3,0,1,3,242
064120410,381,12,3,3,0,2,14,415
064120411,321,12,0,0,0,0,1,334
064120412,448,19,7,1,0,0,9,484
064120501,231,8,4,4,1,1,9,258
064120502,347,18,13,7,1,0,4,390
064120503,347,17,17,0,2,0,8,391
064120504,217,4,3,2,0,1,13,240
064120505,212,5,6,3,0,0,3,229
064120506,208,15,3,11,0,0,6,243
064120507,314,14,2,5,0,0,6,341
064120508,349,12,2,1,1,0,10,375
064120509,373,15,0,9,0,1,8,406
064120510,359,10,2,2,0,0,4,377
064120511,297,9,1,5,1,0,1,314
064120512,301,18,0,1,0,0,2,322
064120513,373,10,3,4,3,1,9,403
064120514,275,27,3,3,3,0,60,371
064120601,169,23,17,5,37,1,10,262
064120602,279,17,1,6,3,0,16,322
064120603,277,31,12,0,5,1,10,336
064120604,256,25,30,2,23,1,14,351
064120605,249,8,2,5,11,0,7,282
064120606,389,28,9,9,2,0,5,442
064120607,368,13,1,4,0,0,4,390
064120608,412,10,1,5,0,2,11,441
064120609,262,7,2,4,1,0,3,279
064120610,243,6,5,1,0,1,8,264
064120611,420,19,8,9,3,1,5,465
064120612,363,10,0,1,2,2,17,395
064120613,305,10,1,1,2,0,19,338
064120701,348,7,1,6,0,0,11,373
064120702,339,13,0,1,0,0,10,363
064120703,363,23,0,6,0,0,7,399
064120704,278,2,3,2,0,0,3,288
064120705,238,2,0,0,0,0,5,245
064120706,210,9,3,2,2,0,10,236
064120707,206,0,5,3,0,0,2,216
064120708,252,5,0,1,0,0,8,266
064120709,188,29,3,3,1,1,1,226
064120710,331,13,15,5,2,2,7,375
064120711,362,18,2,2,0,1,9,394
064120712,323,1,1,1,0,2,2,330
064120713,324,11,0,1,0,0,11,347
064120714,259,8,1,5,0,0,3,276
064120715,221,12,0,1,0,1,1,236
064120716,216,3,2,0,0,0,0,221
064120717,244,10,2,0,0,0,2,258
064120801,407,11,3,5,0,0,27,453
064120802,356,14,5,1,0,1,6,383
064120803,216,11,1,0,0,0,5,233
064120804,216,5,4,1,0,3,3,232
064120805,250,11,4,7,5,1,19,297
064120806,261,5,6,1,0,0,15,288
064120807,260,18,3,0,0,0,2,283
064120808,222,6,0,1,0,0,5,234
064120809,330,6,3,5,1,0,6,351
064120810,276,1,0,0,0,0,6,283
064120811,245,10,0,1,0,0,7,263
064120812,260,5,2,1,0,0,4,272
064120813,328,14,2,3,0,0,8,355
064120814,297,7,0,4,1,0,6,315
064120815,240,8,0,2,0,0,1,251
064120901,211,7,1,13,0,0,3,235
064120902,264,12,7,11,0,1,4,299
064120903,359,14,0,49,1,5,13,441
064120904,344,28,0,13,0,9,10,404
064120905,320,18,3,18,1,19,8,387
064120906,85,13,10,3,1,52,11,175
064120907,135,23,0,4,0,20,14,196
064120908,351,17,4,5,1,1,3,382
064120909,334,13,0,5,1,2,7,362
064120910,335,2,0,3,0,1,5,346
064120911,348,6,0,8,0,0,6,368
064120912,222,8,2,4,0,0,3,239
064120913,226,5,1,3,0,0,5,240
064120914,399,15,3,4,1,1,13,436
064120915,352,3,1,4,8,0,14,382
064120916,199,4,0,3,0,0,5,211
064120917,114,14,2,15,0,0,7,152
064120918,380,15,1,3,0,0,14,413
064121001,359,8,1,2,0,1,5,376
064121002,338,7,0,3,0,0,8,356
064121003,372,5,0,9,1,0,7,394
064121004,423,11,2,6,1,1,11,455
064121005,345,8,0,6,0,0,6,365
064121006,314,12,1,5,0,0,4,336
064121007,310,10,1,2,1,0,7,331
064121008,325,9,0,4,0,0,10,348
064121009,264,12,3,3,0,0,7,289
064121010,263,5,0,8,0,0,4,280
064121011,281,8,2,1,0,2,16,310
064121012,221,4,3,2,0,0,2,232
064121013,212,3,0,2,0,0,6,223
064121014,355,6,2,10,0,1,3,377
064121015,255,6,0,3,0,0,12,276
064121016,314,7,0,0,0,0,20,341
064121017,484,17,1,0,0,1,5,508
064121018,364,11,0,0,0,0,1,376
064121019,397,16,0,0,0,0,5,418
064121020,369,18,0,3,0,0,9,399
064121021,327,28,0,60,0,0,5,420
064121101,267,7,0,3,0,0,0,277
064121102,308,15,1,9,0,0,4,337
064121103,454,11,2,3,0,3,8,481
064121104,226,7,0,0,0,0,3,236
064121105,378,9,0,2,0,1,1,391
064121106,303,4,0,0,0,0,7,314
064121107,217,0,0,1,0,0,4,222
064121108,235,5,0,2,0,1,6,249
064121109,243,11,1,0,0,0,2,257
064121110,209,2,1,3,1,2,7,225
064121111,251,4,0,2,0,0,7,264
064121112,221,8,0,0,0,0,5,234
064121113,233,7,0,1,1,0,4,246
064121114,233,4,0,2,0,1,4,244
064121115,339,5,5,1,0,0,8,358
064121116,266,7,0,3,0,0,1,277
064121117,191,3,1,1,0,0,2,198
064121118,300,7,3,4,0,0,5,319
064121119,369,4,3,7,0,0,5,388
064121120,424,14,3,3,0,0,4,448
064121201,293,15,1,5,1,0,5,320
064121202,318,9,0,2,1,2,8,340
064121203,346,7,0,4,0,2,5,364
064121204,401,12,1,4,2,1,10,431
064121205,398,4,6,4,5,2,5,424
064121206,320,10,1,4,0,0,4,339
064121207,399,6,0,12,0,0,3,420
064121208,338,7,2,4,2,0,3,356
064121209,395,13,0,7,0,0,7,422
064121301,318,10,0,8,0,1,5,342
064121302,351,9,1,2,0,0,1,364
064121303,200,16,3,1,0,0,7,227
064121304,252,1,3,4,7,1,5,273
064121305,383,6,3,4,0,0,5,401
064121306,445,1,6,4,1,0,3,460
064121307,276,6,0,1,0,0,1,284
064121308,370,13,0,1,0,0,2,386
064121309,287,6,3,4,3,0,3,306
064121310,222,4,2,1,1,1,10,241
064121311,306,8,0,3,1,0,1,319
064121312,386,12,1,6,0,0,4,409
064121401,249,13,0,4,0,2,3,271
064121402,307,3,2,1,0,0,2,315
064121403,418,13,3,4,0,0,6,444
064121404,269,3,0,1,0,0,8,281
064121405,301,13,0,2,0,0,2,318
064121406,395,19,4,1,0,0,3,422
064121407,358,5,0,6,0,1,7,377
064121408,402,1,0,0,0,0,1,404
064121409,303,23,2,1,0,1,3,333
064121410,331,10,0,3,0,2,4,350
064121411,365,9,2,1,0,2,11,390
064121412,353,4,1,5,0,0,4,367
064121413,252,6,0,0,0,0,3,261
064121501,231,12,2,3,0,0,1,249
064121502,403,17,12,3,0,0,10,445
064121503,440,13,2,2,0,1,8,466
064121504,348,10,0,3,0,1,9,371
064121505,249,12,2,3,0,1,5,272
064121506,272,17,7,7,0,0,2,305
064121507,287,5,0,6,0,1,6,305
064121508,244,3,0,0,0,0,8,255
064121509,265,9,3,2,8,0,1,288
064121510,275,5,2,4,0,1,8,295
064121511,357,5,4,1,0,0,6,373
064121512,440,15,1,6,0,0,9,471
064270101,217,37,15,1,12,0,17,299
064270102,194,44,7,0,13,0,21,279
064270103,535,86,43,0,52,3,67,786
064270104,117,11,9,1,17,0,10,165
064270105,137,43,29,0,6,3,8,226
064270106,447,81,37,2,8,4,24,603
064270107,433,72,42,3,16,11,27,604
064270108,280,30,3,5,5,1,7,331
064270109,258,13,5,0,0,0,21,297
064270110,300,50,7,4,7,0,21,389
064270111,330,38,3,1,1,0,16,389
064270112,274,64,16,2,11,1,12,380
064270113,267,11,18,0,2,0,32,330
064270201,195,22,12,0,30,0,19,278
064270202,181,2,10,1,6,0,4,204
064270203,143,17,21,1,36,9,17,244
064270204,348,34,23,3,50,6,54,518
064270205,225,50,18,0,16,2,14,325
064270206,175,18,12,0,32,0,9,246
064270207,256,47,17,4,15,10,37,386
064270208,243,32,14,2,6,0,9,306
064270209,303,48,12,0,6,5,8,382
064270210,273,17,22,3,21,1,48,385
064270211,85,7,27,0,11,0,12,142
064270212,180,16,8,0,13,0,4,221
064270213,233,40,23,0,5,0,5,306
064270214,182,17,17,0,12,4,6,238
064270215,178,13,30,2,5,0,30,258
064270216,173,29,46,0,24,5,25,302
064270217,231,42,29,2,3,1,26,334
064270218,296,29,7,5,0,3,20,360
064270301,247,7,8,1,0,0,6,269
064270302,372,43,27,0,80,2,38,562
064270303,212,21,5,4,1,0,10,253
064270304,229,30,6,1,0,2,6,274
064270305,261,37,5,2,5,1,12,323
064270306,335,24,5,0,4,0,20,388
064270307,261,17,17,2,0,0,11,308
064270308,249,9,8,3,1,2,8,280
064270309,189,22,5,2,1,0,13,232
064270310,353,101,39,0,110,0,41,644
064270311,312,21,8,4,3,1,16,365
064270312,359,38,37,3,80,5,19,541
064270401,262,3,8,4,1,0,24,302
064270402,349,2,22,4,8,2,9,396
064270403,452,4,9,6,12,3,25,511
064270404,301,6,8,0,0,1,16,332
064270405,314,2,8,4,11,0,7,346
064270406,307,0,12,3,3,0,27,352
064270407,329,6,3,2,4,0,16,360
064270408,334,2,8,3,3,0,16,366
064270409,387,3,8,1,5,0,19,423
064270501,442,0,11,2,2,0,7,464
064270502,239,1,0,0,3,0,8,251
064270503,248,1,19,2,1,0,22,293
064270504,376,4,5,8,2,0,18,413
064270505,433,3,11,1,3,0,13,464
064270506,336,2,5,1,0,0,11,355
064270507,404,6,7,3,5,0,16,441
064270508,230,2,8,4,5,0,15,264
064270509,225,4,8,2,1,0,10,250
064270510,284,10,7,0,1,0,5,307
064270511,287,1,18,1,7,1,12,327
064270601,297,0,13,1,0,1,5,317
064270602,445,4,18,8,5,0,5,485
064270603,295,3,2,4,0,0,6,310
064270604,462,9,2,2,2,0,24,501
064270605,177,2,7,3,0,0,7,196
064270606,247,1,3,4,6,1,5,267
064270607,218,2,8,1,0,0,18,247
064270608,190,7,22,1,1,1,3,225
064270609,367,0,12,4,2,1,28,414
064270610,229,0,2,1,1,2,6,241
064270611,223,3,3,1,4,1,14,249
064270612,246,2,6,2,0,0,5,261
064270613,232,1,0,0,3,0,6,242
064270614,236,0,2,1,1,1,2,243
064270701,379,35,10,2,5,0,7,438
064270702,376,30,21,3,15,0,23,468
064270703,317,28,8,5,5,1,22,386
064270704,335,35,17,3,6,0,10,406
064270705,313,39,5,5,2,0,10,374
064270706,249,16,1,3,10,1,26,306
064270707,226,46,7,3,7,0,8,297
064270708,282,20,3,1,1,2,10,319
064270709,293,34,9,3,1,0,10,350
064270710,401,34,11,1,2,1,14,464
064270711,265,24,2,0,4,0,9,304
064270712,322,43,8,2,0,0,11,386
064270713,231,17,3,2,2,0,3,258
064270801,346,10,5,1,4,1,4,371
064270802,418,26,4,3,2,0,12,465
064270803,344,15,5,3,0,0,10,377
064270804,412,34,2,1,1,0,7,457
064270805,333,17,12,1,2,0,5,370
064270806,425,23,8,3,3,0,20,482
064270807,353,25,5,8,20,2,17,430
064270808,192,11,6,3,3,0,14,229
064270809,209,18,9,4,2,0,8,250
064270810,396,11,2,0,0,0,17,426
064270811,385,14,3,5,3,0,8,418
064270812,407,19,6,0,12,0,13,457
064270901,407,5,9,4,10,1,9,445
064270902,384,2,6,1,8,3,16,420
064270903,519,2,5,3,6,4,15,554
064270904,545,1,10,3,3,0,10,572
064270905,423,3,10,9,5,1,14,465
064270906,390,8,3,1,2,0,7,411
064270907,358,9,2,3,1,0,13,386
064270908,305,11,5,9,7,0,9,346
064270909,142,0,0,0,0,0,1,143
064270910,269,2,3,0,0,0,2,276
064270911,261,2,1,0,6,0,1,271
064270912,254,2,0,0,0,0,0,256
064271001,412,9,10,2,0,1,24,458
064271002,238,9,3,1,3,1,8,263
064271003,203,7,1,0,2,0,18,231
064271004,413,9,8,2,1,0,33,466
064271005,378,13,12,1,1,0,13,418
064271006,310,20,12,3,0,1,11,357
064271007,377,19,10,2,2,0,16,426
064271008,366,17,5,3,2,0,27,420
064271009,424,15,2,0,0,0,17,458
064271010,230,5,2,1,2,0,36,276
064271011,179,21,7,1,0,0,15,223
064271012,368,20,10,2,3,0,9,412
064271101,379,0,8,2,2,0,22,413
064271102,335,1,4,0,1,2,23,366
064271103,389,1,13,3,9,1,15,431
064271104,335,24,5,1,3,0,10,378
064271105,306,0,6,2,2,0,14,330
064271106,371,2,10,2,4,2,21,412
064271107,310,0,2,0,3,0,25,340
064271108,376,1,3,4,1,0,10,395
064271109,351,0,11,1,3,2,11,379
064271110,249,2,4,0,0,0,11,266
064271111,265,1,3,6,3,0,11,289
064271201,435,8,10,3,11,1,33,501
064271202,424,31,11,3,5,0,25,499
064271203,172,28,8,1,22,0,4,235
064271204,204,20,4,0,2,1,13,244
064271205,338,14,1,7,0,0,19,379
064271206,391,16,12,1,6,0,12,438
064271207,211,5,2,3,1,0,15,237
064271208,196,22,1,2,1,0,4,226
064271209,215,16,6,3,1,0,5,246
064271210,197,13,0,0,0,0,15,225
064271301,362,28,5,1,2,0,27,425
064271302,445,32,9,3,3,1,11,504
064271303,315,45,2,4,0,0,11,377
064271304,494,2,7,2,1,2,3,511
064271305,492,23,16,7,5,2,18,563
064271306,224,11,4,16,6,0,8,269
064271307,242,2,21,1,21,1,53,341
064271308,282,11,18,3,9,0,25,348
064271309,256,20,10,2,9,0,14,311
064271310,395,31,10,7,5,1,20,469
064271311,427,44,7,11,4,0,16,509
064271401,260,7,17,3,4,0,8,299
064271402,272,7,8,6,0,0,18,311
064271403,192,3,5,0,0,0,3,203
064271404,220,5,0,0,0,2,5,232
064271405,222,3,0,0,0,0,2,227
064271406,111,1,2,0,0,0,5,119
064271407,363,18,1,2,0,0,20,404
064271408,540,8,3,2,0,0,16,569
064271409,286,12,2,1,0,0,8,309
064271410,621,10,8,1,0,1,32,673
064271411,617,21,6,6,1,1,12,664
064271412,115,2,0,1,1,0,5,124
064271413,772,49,9,0,0,5,32,867
064271414,162,10,1,3,0,0,12,188
064271415,241,22,4,0,7,0,6,280
064271416,347,18,13,5,7,0,6,396
064271417,210,4,9,1,0,0,6,230
064271418,224,31,9,2,9,0,20,295
064271419,290,25,6,10,6,0,5,342
064271420,169,15,13,1,0,1,5,204
064271501,265,8,3,3,2,0,14,295
064271502,190,15,1,1,2,0,4,213
064271503,258,19,5,0,0,0,9,291
064271504,398,24,11,0,1,0,31,465
064271505,231,6,8,1,5,0,14,265
064271506,267,6,11,1,1,0,5,291
064271507,210,13,4,1,4,0,3,235
064271508,244,1,3,2,1,2,8,261
064271509,227,14,6,2,1,2,2,254
064271510,199,3,5,2,0,0,6,215
064271511,171,7,2,1,1,1,6,189
064271512,324,17,4,5,3,0,23,376
064271513,207,1,4,1,2,0,14,229
064271514,196,6,0,4,6,1,5,218
064271515,275,19,13,0,0,0,5,312
064271601,390,30,15,0,0,0,23,458
064271602,452,32,13,0,0,0,47,544
064271603,338,28,2,21,0,0,7,396
064271604,200,7,2,5,2,0,4,220
064271605,412,20,8,7,33,0,9,489
064271606,287,4,0,1,1,0,11,304
064271607,334,5,0,0,4,0,2,345
064271608,226,1,2,1,2,0,2,234
064271609,352,4,0,2,0,0,6,364
064271610,206,1,1,0,0,0,11,219
064271611,401,44,11,0,0,0,28,484
064271612,379,23,27,0,0,0,36,465
064271613,143,23,2,25,0,0,6,199
064271701,359,43,3,1,18,0,5,429
064271702,296,32,13,0,0,0,8,349
064271703,240,8,1,6,0,0,2,257
064271704,200,9,0,0,0,0,10,219
064271705,212,4,0,2,0,0,1,219
064271706,169,2,0,1,0,0,0,172
064271707,979,25,3,45,0,0,16,1068
064271708,343,11,1,0,1,0,4,360
064271709,228,4,1,0,0,0,5,238
064271710,450,18,0,0,0,0,7,475
064271711,702,11,3,6,0,1,13,736
064271801,387,14,1,1,0,0,12,415
064271802,253,15,0,0,0,0,7,275
064271803,160,0,2,0,0,0,3,165
064271804,459,9,2,2,1,0,18,491
064271805,847,20,6,1,0,0,36,910
064271806,23,0,0,0,0,0,0,23
064271807,418,6,1,1,0,2,6,434
064271808,413,13,1,2,0,3,7,439
064271809,475,4,2,0,0,0,22,503
064271810,344,3,1,2,0,0,15,365
064271811,356,12,1,2,0,1,6,378
064271812,55,4,0,0,0,0,1,60
064271813,882,17,2,13,1,0,20,935
064271901,201,7,5,2,0,0,5,220
064271902,205,8,3,0,0,1,4,221
064271903,388,38,9,1,4,1,13,454
064271904,246,9,4,2,0,1,11,273
064271905,185,14,3,1,1,0,9,213
064271906,350,17,4,5,1,0,6,383
064271907,341,31,6,2,5,1,13,399
064271908,350,5,4,2,3,0,10,374
064271909,386,11,4,5,1,1,17,425
064271910,292,20,4,6,4,1,3,330
064272001,218,0,0,0,0,0,1,219
064272002,234,9,3,2,0,0,6,254
064272003,271,10,14,3,2,1,8,309
064272004,229,0,10,2,3,0,16,260
064272005,159,10,7,2,3,0,9,190
064272006,312,9,4,3,9,1,13,351
064272007,245,33,6,0,0,0,6,290
064272008,308,19,3,0,2,1,12,345
064272009,332,16,18,1,4,0,15,386
064272010,293,16,1,0,4,0,10,324
064272011,434,9,7,2,1,0,6,459
064272012,112,3,0,0,0,0,4,119
064272013,190,3,7,0,2,3,102,307
064272014,377,20,6,2,3,0,19,427
064272015,256,12,8,0,0,0,4,280
064272016,448,6,1,0,0,3,18,476
064272101,398,9,10,1,2,0,15,435
064272102,383,13,7,5,1,0,1,410
064272103,401,19,8,0,8,1,21,458
064272104,344,24,6,1,1,1,14,391
064272105,284,11,1,1,0,0,7,304
064272106,279,6,0,1,3,0,4,293
064272107,312,15,6,7,7,0,14,361
064272108,384,12,6,5,0,0,20,427
064272201,243,5,6,2,3,0,5,264
064272202,210,5,9,1,2,0,1,228
064272203,340,2,9,4,8,3,10,376
064272204,312,6,7,6,1,3,27,362
064272205,247,18,12,1,3,0,15,296
064272206,208,3,3,0,1,0,11,226
064272207,416,5,5,3,2,1,20,452
064272208,283,19,2,0,0,0,30,334
064272209,373,24,18,5,3,0,16,439
064272301,137,9,0,1,1,0,8,156
064272302,348,18,8,1,7,0,9,391
064272303,529,25,8,3,1,0,25,591
064272304,523,17,7,2,6,0,27,582
064272305,389,22,8,3,2,1,9,434
064272306,397,14,5,5,1,1,8,431
064272307,367,32,10,2,2,0,12,425
064272308,429,18,3,4,0,0,13,467
064272309,511,29,13,5,4,2,9,573
064272310,420,34,12,2,2,0,15,485
064272311,496,24,6,0,2,0,15,543
064272401,387,32,9,2,2,0,11,443
064272402,56,1,0,0,0,0,0,57
064272403,154,2,3,0,0,0,2,161
064272404,132,0,1,0,0,0,2,135
064272405,308,1,0,0,0,0,4,313
064272406,310,11,3,1,0,0,12,337
064272407,401,10,8,1,3,0,17,440
064272408,376,12,3,21,4,0,22,438
064272409,361,20,8,2,6,0,10,407
064272410,199,3,5,2,0,0,4,213
064272501,225,1,5,0,2,0,19,252
064272502,263,3,16,16,2,0,15,315
064272503,366,6,4,3,0,0,16,395
064272504,292,1,9,4,3,0,7,316
064272505,356,0,6,1,2,0,7,372
064272506,275,1,4,2,4,1,13,300
064272507,201,1,6,2,1,0,10,221
064272508,143,0,0,3,5,0,6,157
064272509,377,2,9,2,9,0,20,419
064272510,673,5,5,1,2,0,8,694
064272511,591,7,2,16,1,1,5,623
064272512,667,7,5,3,1,1,18,702
064272513,169,11,6,2,1,0,15,204
064272514,174,2,3,2,0,0,12,193
064272515,282,3,2,4,6,0,7,304
064272601,215,4,22,1,3,0,13,258
064272602,277,1,19,3,0,0,9,309
064272603,408,5,4,2,3,2,17,441
064272604,384,6,7,4,0,1,19,421
064272605,310,2,5,1,0,0,13,331
064272606,236,1,2,2,2,1,6,250
064272607,429,3,7,0,1,0,13,453
064272608,384,9,16,2,5,0,9,425
064272609,353,6,2,4,3,1,8,377
064272610,325,3,14,3,0,0,21,366
064272611,391,1,6,3,7,0,19,427
064272701,526,7,9,4,2,0,13,561
064272702,189,0,3,3,2,0,8,205
064272703,236,0,5,0,0,1,12,254
064272704,245,1,5,4,2,0,9,266
064272705,252,9,9,1,4,0,13,288
064272706,363,3,7,2,5,0,21,401
064272707,362,26,7,4,1,0,21,421
064272708,382,25,11,5,4,1,16,444
064272709,399,11,10,1,9,2,21,453
064272801,370,26,10,2,2,1,12,423
064272802,257,13,10,1,0,1,14,296
064272803,261,12,3,4,2,0,5,287
064272804,264,8,10,5,1,1,14,303
064272805,237,14,10,2,0,0,6,269
064272806,363,14,7,3,2,3,25,417
064272807,367,40,10,1,20,0,39,477
064272808,296,17,21,16,1,0,10,361
064272809,237,10,3,2,0,0,6,258
064272810,408,42,7,3,1,1,19,481
064272811,338,13,10,5,7,0,25,398
064272812,365,29,9,9,1,0,6,419
064272901,365,33,23,10,4,2,12,449
064272902,360,18,14,3,12,0,22,429
064272903,223,23,16,3,5,0,16,286
064272904,210,10,5,0,1,0,6,232
064272905,368,55,19,1,9,0,21,473
064272906,313,11,13,4,0,0,23,364
064272907,410,26,18,5,8,0,28,495
064272908,401,40,7,7,4,1,22,482
064272909,191,18,4,1,3,1,4,222
064272910,198,23,9,5,1,1,9,246
064272911,392,27,15,6,4,1,11,456
064272912,409,25,16,3,1,1,11,466
064272913,275,26,4,7,3,0,10,325
064272914,338,35,4,7,6,2,24,416
064273001,318,54,7,2,4,0,63,448
064273002,376,69,20,1,66,4,26,562
064273003,261,46,17,1,48,0,22,395
064273004,331,67,27,0,67,3,22,517
064273005,153,21,2,11,12,4,23,226
064273006,308,56,33,1,114,3,21,536
064273007,326,83,23,1,13,0,11,457
064273008,184,39,16,19,3,0,7,268
064273009,186,37,18,0,14,0,4,259
064273010,298,46,13,1,11,3,22,394
064273011,169,33,13,1,4,2,5,227
064273012,233,45,26,1,12,0,7,324
064273013,302,32,16,4,7,1,20,382
064273101,292,57,7,4,13,0,27,400
064273102,301,25,7,1,8,0,24,366
064273103,323,14,11,4,2,1,10,365
064273104,305,17,8,4,12,3,14,363
064273105,418,26,15,5,1,3,23,491
064273106,382,34,18,3,1,3,4,445
064273107,257,32,4,2,0,0,6,301
064273108,171,7,5,3,1,1,15,203
064273109,261,21,34,7,3,1,6,333
064273110,279,0,11,1,0,1,35,327
064273201,247,25,8,0,0,0,5,285
064273202,249,25,7,4,5,0,21,311
064273203,257,20,20,3,2,1,16,319
064273204,233,24,1,1,0,0,3,262
064273205,374,26,18,1,2,2,17,440
064273206,283,16,12,6,1,0,8,326
064273207,331,34,15,3,3,0,6,392
064273208,399,32,11,4,6,0,21,473
064273209,214,14,22,3,6,1,17,277
064273210,214,8,6,5,0,0,6,239
064273211,256,11,9,3,1,0,6,286
064273212,203,8,2,1,0,2,10,226
064273301,225,22,12,5,2,5,11,282
064273302,384,19,22,6,5,4,24,464
064273303,204,21,5,0,0,0,4,234
064273304,148,8,4,4,2,2,2,170
064273305,207,13,5,0,2,0,4,231
064273306,178,12,4,2,2,1,10,209
064273307,202,21,5,2,0,1,3,234
064273308,265,10,2,2,0,1,3,283
064273309,235,6,1,0,2,0,18,262
064273310,292,3,7,2,1,2,21,328
064273311,315,0,7,4,0,6,25,357
064273312,480,8,11,4,0,6,33,542
064273313,283,6,7,2,0,4,23,325
064273314,350,4,11,2,2,3,18,390
064273315,275,12,3,10,0,6,15,321
064273401,343,29,7,0,1,0,6,386
064273402,261,23,8,10,1,0,3,306
064273403,485,28,18,5,5,2,14,557
064273404,319,16,15,4,1,0,9,364
064273405,333,29,7,1,0,0,5,375
064273406,556,23,6,9,0,0,9,603
064273407,344,14,8,1,1,0,6,374
064273408,325,15,26,4,3,2,3,378
064273409,408,35,14,2,2,0,14,475
064273410,211,17,22,2,1,0,6,259
064273411,248,17,15,3,10,1,3,297
064273412,399,21,7,5,1,0,5,438
064273413,290,9,3,2,1,1,5,311
064273414,295,22,6,1,1,0,3,328
064273415,398,25,11,3,0,0,20,457
064273501,396,23,13,6,8,2,13,461
064273502,234,21,20,1,9,0,9,294
064273503,195,24,11,7,7,0,11,255
064273504,229,29,20,4,0,2,4,288
064273505,303,13,9,1,0,1,4,331
064273506,381,21,13,1,7,1,6,430
064273507,255,21,6,1,1,2,6,292
064273508,322,16,6,2,4,0,4,354
064273509,452,29,7,1,1,1,20,511
064273510,237,14,12,4,6,1,16,290
064273511,396,20,17,4,3,1,4,445
064273512,355,27,6,1,4,1,20,414
064273513,261,13,12,5,2,0,19,312
064273601,223,11,16,4,1,0,11,266
064273602,312,25,9,9,15,0,8,378
064273603,275,48,21,1,5,0,17,367
064273604,200,31,21,12,128,0,19,411
064273605,226,41,35,6,154,3,13,478
064273606,139,3,0,0,0,1,0,143
064273607,120,20,3,1,4,0,7,155
064273608,84,7,0,0,0,0,0,91
064273609,370,63,22,4,7,0,21,487
064273610,296,44,14,6,13,1,20,394
064273611,349,43,13,3,14,2,15,439
064273612,174,13,10,6,20,1,8,232
064273701,187,11,4,4,8,0,12,226
064273702,187,7,1,2,1,0,4,202
064273703,195,12,3,2,0,0,3,215
064273704,415,69,10,3,7,0,30,534
064273705,233,9,5,1,1,0,7,256
064273706,542,47,27,8,26,1,72,723
064273707,378,23,11,1,4,1,9,427
064273708,350,16,12,1,0,1,13,393
064273709,398,17,10,2,2,3,12,444
064273710,400,19,10,3,4,0,8,444
064273801,314,8,3,1,1,0,6,333
064273802,263,6,3,1,0,0,6,279
064273803,519,7,3,0,0,0,9,538
064273804,210,1,4,0,0,0,0,215
064273805,255,16,8,0,0,0,5,284
064273806,264,5,8,1,1,0,5,284
064273807,356,13,2,2,0,0,8,381
064273808,380,16,6,4,2,2,28,438
064273809,165,11,7,0,0,0,7,190
064273810,385,23,4,3,5,0,19,439
064273901,332,9,4,5,11,0,13,374
064273902,272,6,7,1,0,0,5,291
064273903,206,7,0,2,0,1,6,222
064273904,347,11,3,3,1,1,6,372
064273905,325,10,0,5,0,1,3,344
064273906,246,2,6,4,1,0,15,274
064273907,236,5,3,6,5,1,4,260
064273908,12,0,0,0,0,0,1,13
064273909,391,21,3,4,3,0,10,432
064273910,254,9,3,1,0,0,2,269
064273911,215,11,7,4,6,3,17,263
064274001,273,12,0,2,0,0,0,287
064274002,419,9,0,0,0,0,13,441
064274003,253,3,0,1,0,0,5,262
064274004,392,5,3,1,0,0,7,408
064274005,361,18,3,0,0,0,6,388
064274006,332,9,1,0,0,1,15,358
064274007,609,21,1,0,0,0,12,643
064274008,484,18,2,2,0,0,8,514
064274009,210,15,4,4,0,1,1,235
064274010,471,6,12,12,0,0,5,506
064274011,393,5,2,0,0,0,3,403
064274012,222,5,3,5,0,0,3,238
064274101,454,12,4,0,0,0,11,481
064274102,464,22,1,0,6,1,7,501
064274103,512,15,13,3,26,0,6,575
064274104,392,12,4,1,1,0,12,422
064274105,369,22,6,2,1,1,16,417
064274106,329,1,0,2,0,0,5,337
064274107,642,11,2,12,0,0,14,681
064274108,541,8,0,14,0,0,13,576
064274109,498,4,4,7,0,1,14,528
064274110,253,3,1,3,0,0,8,268
064274201,417,23,8,0,1,0,8,457
064274202,408,4,1,0,0,0,1,414
064274203,478,2,5,0,0,0,12,497
064274204,531,31,4,0,0,0,13,579
064274205,352,11,6,0,0,0,8,377
064274206,254,17,1,1,3,0,7,283
064274207,259,8,4,3,5,0,10,289
064274208,241,4,12,0,3,0,5,265
064274209,470,9,11,2,1,0,10,503
064274210,220,6,1,1,5,0,5,238
064274211,255,9,3,2,2,2,4,277
064274301,404,22,16,2,2,5,13,464
064274302,414,29,3,0,0,0,9,455
064274303,391,11,4,1,1,0,9,417
064274304,362,33,6,6,4,0,21,432
064274305,400,24,8,7,1,0,19,459
064274306,473,16,9,6,6,1,8,519
064274307,295,23,6,2,1,1,7,335
064274308,334,7,11,1,1,2,16,372
064274309,361,20,1,0,0,1,9,392
064274310,278,7,6,5,6,0,16,318
064274311,290,11,7,2,1,0,4,315
064274401,369,2,15,7,6,1,30,430
064274402,243,1,10,6,2,1,5,268
064274403,392,2,5,3,2,0,21,425
064274404,399,2,15,7,7,2,19,451
064274405,160,3,5,5,1,0,11,185
064274406,248,0,5,6,1,0,27,287
064274407,172,0,15,5,5,2,10,209
064274408,205,1,2,3,0,1,19,231
064274409,227,2,21,4,1,2,20,277
064274410,275,9,19,2,9,0,8,322
064274411,193,2,3,0,0,0,4,202
064274412,383,7,9,7,6,2,24,438
064274501,514,13,2,6,0,0,12,547
064274502,355,16,5,9,1,1,7,394
064274503,302,7,9,2,0,0,8,328
064274504,454,23,10,9,1,2,19,518
064274505,301,18,7,3,0,0,4,333
064274506,245,10,2,3,0,0,6,266
064274507,449,12,1,3,0,0,9,474
064274508,498,20,10,2,0,2,2,534
064274509,286,23,17,15,1,1,12,355
064274510,286,16,4,8,2,4,16,336
064274511,355,13,5,3,2,1,8,387
064274601,375,24,0,2,0,0,18,419
064274602,186,3,0,6,0,0,7,202
064274603,502,17,6,6,0,1,10,542
064274604,479,5,3,3,0,0,26,516
064274605,479,17,2,5,1,1,3,508
064274606,564,14,3,2,0,1,12,596
064274607,343,13,0,0,0,1,5,362
064274608,167,4,0,2,1,1,8,183
064274609,1108,25,18,5,2,8,28,1194
064274610,312,11,7,4,1,3,15,353
064274611,339,8,1,0,1,0,2,351
064274612,383,37,8,27,0,15,15,485
064274613,378,17,7,11,0,2,8,423
064274701,256,9,1,3,0,1,5,275
064274702,71,2,0,0,0,0,0,73
064274703,41,0,0,4,0,0,0,45
064274704,204,7,4,2,0,0,0,217
064274705,210,6,2,3,0,0,2,223
064274706,54,1,0,0,0,0,3,58
064274707,33,0,0,0,0,0,3,36
064274708,25,0,0,0,0,0,0,25
064274709,241,14,4,3,1,0,3,266
064274710,269,3,7,5,0,0,2,286
064274711,231,1,4,2,0,0,7,245
064274712,93,1,0,0,0,0,2,96
064274801,149,4,0,3,0,0,4,160
064274802,517,11,2,0,0,1,7,538
064274803,403,10,3,1,6,0,5,428
064274804,343,15,2,0,0,2,3,365
064274805,281,4,17,0,3,0,21,326
064274806,524,25,8,1,9,0,9,576
064274807,375,20,3,4,4,0,2,408
064274808,392,17,1,1,1,0,4,416
064274809,398,4,4,4,0,0,12,422
064274810,369,14,6,3,3,1,6,402
064274811,415,14,5,2,0,1,7,444
064274812,478,16,5,5,3,0,13,520
064274813,361,9,2,4,2,0,7,385
064274814,448,6,3,1,1,0,11,470
064274901,474,10,1,7,2,2,19,515
064274902,288,8,0,0,0,0,6,302
064274903,276,12,5,3,0,0,4,300
064274904,305,6,0,3,0,0,6,320
064274905,318,12,1,1,0,0,10,342
064274906,494,84,0,7,0,0,26,611
064274907,342,9,0,0,0,0,2,353
064274908,344,1,0,0,0,0,2,347
064274909,449,15,0,0,0,0,1,465
064274910,308,2,2,0,0,0,6,318
064274911,214,3,0,1,1,0,29,248
064274912,250,1,0,0,0,0,4,255
064275001,382,7,5,3,1,2,17,417
064275002,303,9,1,1,0,3,11,328
064275003,335,11,4,2,0,4,9,365
064275004,369,21,4,3,1,2,2,402
064275005,347,24,0,1,0,1,5,378
064275006,438,14,1,0,0,0,3,456
064275007,365,13,2,3,1,0,11,395
064275008,280,14,0,0,1,0,4,299
064275009,271,13,2,4,7,1,10,308
064275010,313,14,2,3,0,1,3,336
064275011,327,11,11,7,6,0,14,376
064275012,469,32,26,0,0,0,12,539
064275013,234,8,8,1,2,1,7,261
064275101,293,1,1,0,0,0,5,300
064275102,320,1,1,0,0,1,1,324
064275103,282,11,3,4,0,1,0,301
064275104,286,9,4,13,0,0,16,328
064275105,270,1,0,2,0,1,7,281
064275106,186,1,0,2,0,0,9,198
064275107,271,9,0,5,0,1,2,288
064275108,491,7,1,0,0,0,9,508
064275109,381,19,10,5,4,0,19,438
064275110,361,1,12,9,0,3,4,390
064275111,369,7,6,0,3,3,10,398
064275112,352,42,5,1,0,0,8,408
064275113,376,0,3,47,0,0,32,458
064275114,478,2,2,2,1,0,1,486
064275115,77,0,0,0,0,0,9,86
064275201,401,6,0,0,0,0,4,411
064275202,437,5,1,0,1,0,8,452
064275203,279,1,1,0,0,0,1,282
064275204,380,5,0,0,0,0,2,387
064275205,368,3,1,7,0,0,7,386
064275206,309,2,0,0,0,0,1,312
064275207,308,8,0,0,0,0,3,319
064275208,300,4,1,3,0,0,2,310
064275209,341,8,0,0,0,0,1,350
064275210,232,2,5,2,1,0,0,242
064275211,226,0,2,1,0,0,0,229
064275212,241,6,1,2,3,0,0,253
064275213,342,4,1,4,0,0,3,354
064275301,419,4,0,0,2,0,6,431
064275302,208,6,0,1,0,0,7,222
064275303,196,0,0,0,0,0,0,196
064275304,408,2,0,0,0,0,4,414
064275305,448,10,1,0,2,0,7,468
064275306,490,11,0,0,0,0,4,505
064275307,386,5,1,0,0,0,8,400
064275308,400,8,0,0,0,0,7,415
064275309,186,3,0,0,0,0,0,189
064275310,437,10,2,0,0,0,5,454
064275401,363,12,5,2,1,0,5,388
064275402,444,5,1,0,0,0,11,461
064275403,237,1,0,1,0,0,8,247
064275404,224,3,0,0,0,0,1,228
064275405,269,11,0,1,0,0,2,283
064275406,266,1,3,0,0,0,4,274
064275407,346,8,1,1,0,0,2,358
064275408,367,2,2,2,2,0,3,378
064275409,417,19,11,0,5,1,14,467
064275410,741,11,6,5,0,8,14,785
064275411,272,4,0,1,0,1,2,280
064275412,424,16,2,5,0,0,15,462
064275501,202,8,2,3,0,0,5,220
064275502,246,17,4,2,1,0,6,276
064275503,209,7,2,2,2,0,4,226
064275504,213,12,7,4,3,1,8,248
064275505,344,47,11,5,4,0,22,433
064275506,347,20,10,7,4,2,10,400
064275507,250,19,2,1,1,0,13,286
064275508,327,14,4,1,0,0,15,361
064275509,269,6,1,3,0,0,7,286
064275510,306,8,2,2,0,1,8,327
064275511,342,9,2,3,1,0,5,362
064275512,392,9,1,5,1,0,13,421
064275513,343,12,7,1,0,0,14,377
064275601,278,9,0,2,2,0,4,295
064275602,454,5,5,7,0,0,6,477
064275603,299,9,2,1,1,1,8,321
064275604,222,0,4,0,0,0,2,228
064275605,221,4,1,1,0,0,0,227
064275606,451,15,3,0,2,2,3,476
064275607,201,17,4,4,1,1,7,235
064275608,372,23,15,7,3,2,18,440
064275609,256,19,6,4,2,0,5,292
064275610,405,20,3,3,0,0,7,438
064275611,353,25,6,0,0,0,6,390
064275612,417,18,4,4,12,1,6,462
064275613,271,15,4,1,3,0,2,296
064275701,340,7,1,1,0,1,8,358
064275702,278,11,0,2,1,0,1,293
064275703,234,6,1,1,0,0,4,246
064275704,265,3,2,0,2,0,7,279
064275705,237,3,4,0,14,1,7,266
064275706,357,10,0,0,0,0,11,378
064275707,398,12,1,1,0,0,1,413
064275708,233,5,0,0,0,0,2,240
064275709,183,1,1,0,0,0,16,201
064275710,235,4,0,0,0,0,2,241
064275711,181,3,0,0,1,0,5,190
064275712,390,9,1,1,1,1,3,406
064275713,345,4,4,1,0,0,10,364
064275714,190,3,0,0,0,0,0,193
064275715,189,0,1,2,0,0,4,196
064275801,400,15,2,1,0,0,4,422
064275802,364,10,1,3,0,0,15,393
064275803,358,6,2,3,0,0,7,376
064275804,308,7,0,3,0,0,9,327
064275805,189,4,0,0,0,0,2,195
064275806,200,5,0,1,0,0,5,211
064275807,296,10,1,2,1,0,6,316
064275808,396,16,3,2,0,0,2,419
064275809,90,24,0,0,0,0,1,115
064275810,288,11,0,3,0,0,7,309
064275811,189,9,2,3,0,0,1,204
064275812,225,3,3,0,1,0,2,234
064275813,179,4,4,2,0,0,1,190
064275814,195,3,4,5,0,1,2,210
064275815,76,1,0,0,1,1,3,82
064275901,390,9,22,5,3,0,5,434
064275902,122,2,1,4,0,0,1,130
064275903,396,6,9,3,0,1,3,418
064275904,208,4,3,1,0,0,2,218
064275905,396,12,1,7,1,3,2,422
064275906,221,13,1,6,0,1,3,245
064275907,180,13,0,1,0,0,4,198
064275908,293,4,6,4,0,0,2,309
064275909,252,7,3,2,0,0,2,266
064275910,337,2,0,1,0,1,6,347
064275911,317,6,4,3,1,0,5,336
064275912,251,4,4,0,0,0,4,263
064275913,283,4,1,1,0,2,2,293
064276001,379,21,7,3,0,0,6,416
064276002,300,17,5,2,1,0,3,328
064276003,261,7,2,0,1,0,3,274
064276004,282,12,2,0,0,0,2,298
064276005,421,38,2,6,3,0,9,479
064276006,442,12,3,5,1,0,5,468
064276007,388,5,4,1,2,0,3,403
064276008,485,7,3,1,0,0,4,500
064276009,371,4,0,1,0,0,8,384
064276010,320,5,6,3,0,0,0,334
064276011,356,8,5,3,0,0,4,376
064276012,205,10,4,0,0,2,5,226
064276013,262,3,0,2,0,0,0,267
064276014,202,9,3,1,0,0,3,218
064276015,201,10,3,4,0,0,7,225
064276016,436,10,24,2,2,0,15,489
064276017,273,14,0,2,0,0,5,294
064276018,247,7,2,2,0,1,5,264
064276101,478,20,1,5,0,0,8,512
064276102,319,8,4,0,0,0,6,337
064276103,318,7,8,0,0,0,14,347
064276104,448,15,10,5,2,1,6,487
064276105,478,14,0,0,1,1,5,499
064276106,277,4,3,1,0,0,2,287
064276107,223,2,1,1,0,0,6,233
064276108,349,4,6,3,0,0,2,364
064276109,377,6,0,2,0,0,4,389
064276110,375,4,1,2,0,0,6,388
064276111,267,2,4,2,0,0,5,280
064276112,186,10,5,1,0,0,1,203
064276113,278,10,3,1,5,0,5,302
064276114,372,9,3,4,0,2,4,394
064276201,239,5,0,4,0,0,6,254
064276202,321,12,1,2,0,1,3,340
064276203,262,7,3,3,0,0,4,279
064276204,300,0,3,4,0,0,2,309
064276205,498,10,3,6,0,0,7,524
064276206,287,13,4,2,1,2,11,320
064276207,254,7,1,2,0,0,4,268
064276208,225,8,0,1,1,0,12,247
064276209,238,4,3,1,0,0,17,263
064276210,407,21,0,1,0,0,17,446
064276211,128,0,0,1,0,0,3,132
064276212,284,10,4,2,0,0,7,307
064276213,267,9,4,3,1,0,2,286
064276214,191,4,0,1,0,0,1,197
064276215,236,5,1,1,0,0,3,246
064276216,306,8,0,1,0,0,28,343
064276301,424,14,3,4,2,0,8,455
064276302,61,1,1,2,0,0,2,67
064276303,249,5,2,2,0,0,10,268
064276304,257,5,2,0,0,0,6,270
064276305,242,1,3,0,0,0,2,248
064276306,358,5,1,4,1,1,13,383
064276307,283,17,2,6,0,0,2,310
064276308,404,12,4,4,1,1,10,436
064276309,419,5,1,3,0,0,18,446
064276310,493,4,1,5,0,1,15,519
064276311,341,1,0,0,0,0,8,350
064276312,306,5,1,1,0,0,7,320
064276401,199,1,1,0,1,0,2,204
064276402,153,0,0,1,2,0,2,158
064276403,236,6,1,1,1,0,3,248
064276404,198,6,2,5,0,0,4,215
064276405,226,2,1,1,0,0,3,233
064276406,226,6,3,1,0,1,1,238
064276407,378,6,2,2,1,1,1,391
064276408,191,4,2,0,4,0,3,204
064276409,367,9,0,1,0,1,7,385
064276410,369,8,0,2,0,0,5,384
064276411,229,11,6,0,0,1,7,254
064276412,272,8,0,2,0,0,4,286
064276413,181,3,0,1,0,0,1,186
064276414,227,10,3,2,2,0,3,247
064276415,195,6,0,3,0,0,1,205
064276416,112,2,2,6,0,0,1,123
064276417,275,30,2,0,0,0,18,325
064276501,383,7,3,3,0,1,6,403
064276502,330,5,2,2,0,0,6,345
064276503,283,5,0,0,0,1,5,294
064276504,382,3,0,0,0,0,1,386
064276505,199,1,1,0,0,1,1,203
064276506,132,3,1,0,1,0,2,139
064276507,336,3,5,0,0,0,4,348
064276508,190,5,0,0,2,0,4,201
064276509,180,2,2,0,0,0,1,185
064276510,215,5,2,4,0,0,3,229
064276511,418,1,1,0,0,0,9,429
064276512,231,5,0,1,0,0,3,240
064276513,243,2,1,2,1,0,2,251
064276514,242,4,1,3,0,0,1,251
064276515,302,3,4,2,0,0,6,317
064276516,432,10,0,1,2,0,10,455
064276517,474,13,0,0,0,0,7,494
064276601,244,1,2,0,0,0,1,248
064276602,282,1,3,2,0,0,5,293
064276603,411,8,0,1,0,0,5,425
064276604,355,1,1,1,0,0,3,361
064276605,375,2,2,1,1,0,5,386
064276606,294,4,1,0,0,0,2,301
064276607,276,0,1,1,1,0,7,286
064276608,265,10,6,6,4,0,11,302
064276609,255,5,2,1,0,0,5,268
064276610,299,5,2,2,2,1,6,317
064276611,281,1,0,1,0,0,5,288
064276701,293,17,1,1,0,0,11,323
064276702,251,7,1,13,0,0,2,274
064276703,250,10,1,11,0,0,10,282
064276704,618,16,0,6,0,1,15,656
064276705,251,0,0,4,0,0,5,260
064276706,310,9,0,1,0,0,6,326
064276707,262,0,1,4,0,0,13,280
064276708,245,1,10,3,1,0,4,264
064276709,217,3,3,3,0,0,4,230
064276710,206,7,2,3,0,0,7,225
064276711,219,1,9,2,0,0,6,237
064276712,293,5,3,4,1,0,1,307
064276713,252,1,0,4,0,1,8,266
064276714,231,4,2,25,0,0,9,271
064276715,205,5,0,1,0,0,6,217
064276716,202,6,1,4,0,0,4,217
064276717,292,1,5,7,0,2,2,309
064276718,327,8,0,0,0,0,4,339
064276801,255,4,5,0,0,2,4,270
064276802,336,12,5,6,1,2,9,371
064276803,198,22,3,1,0,0,10,234
064276804,234,12,2,2,0,0,8,258
064276805,261,14,10,0,14,1,15,315
064276806,325,20,10,8,0,0,11,374
064276807,233,6,2,0,1,0,2,244
064276808,259,16,6,1,3,0,2,287
064276809,300,12,2,4,0,0,3,321
064276810,253,4,3,4,0,0,3,267
064276901,210,3,0,0,0,0,5,218
064276902,310,5,0,0,0,0,3,318
064276903,272,11,7,3,0,0,6,299
064276904,319,9,0,0,0,1,0,329
064276905,382,3,1,1,0,1,6,394
064276906,205,5,0,0,0,0,9,219
064276907,323,12,4,3,1,0,5,348
064276908,272,4,1,1,1,0,4,283
064276909,436,18,2,3,11,0,10,480
064276910,190,19,4,2,2,1,10,228
064276911,226,20,4,0,1,0,2,253
064276912,246,6,4,0,0,0,2,258
064276913,414,14,5,0,0,0,16,449
064276914,305,7,4,5,1,0,8,330
064276915,356,2,1,4,0,0,8,371
064276916,271,10,5,2,0,0,3,291
064276917,283,5,3,3,0,0,7,301
064277001,176,6,2,0,0,0,8,192
064277002,281,8,4,3,1,2,10,309
064277003,259,14,3,3,0,0,4,283
064277004,407,7,2,3,0,0,8,427
064277005,338,4,4,2,1,2,6,357
064277006,231,7,3,0,0,1,4,246
064277007,202,3,2,1,0,0,0,208
064277008,247,11,0,7,0,0,5,270
064277009,155,1,2,2,0,0,2,162
064277010,246,5,2,1,0,1,5,260
064277011,268,5,1,1,0,0,2,277
064277012,312,4,3,1,0,0,6,326
064277013,222,0,1,1,1,0,3,228
064277014,302,1,3,3,2,0,10,321
064277015,215,3,2,1,0,0,3,224
064277016,199,9,1,2,0,0,1,212
064277017,186,5,0,0,0,0,4,195
064277018,177,4,0,0,0,0,5,186
064277101,354,6,1,1,0,0,6,368
064277102,375,8,1,0,1,0,15,400
064277103,213,2,3,3,0,1,0,222
064277104,175,5,0,6,1,1,3,191
064277105,180,3,0,4,0,0,1,188
064277106,255,10,0,6,0,9,6,286
064277107,393,16,2,5,0,0,18,434
064277108,206,2,2,0,0,2,4,216
064277109,219,2,0,0,0,1,3,225
064277110,184,9,2,1,0,0,2,198
064277111,284,6,0,0,0,0,0,290
064277112,433,3,13,3,0,1,9,462
064277113,282,5,0,0,0,0,6,293
064277114,321,4,0,0,0,0,6,331
064277115,312,6,3,2,2,1,4,330
064277116,375,10,1,6,6,0,1,399
064277201,262,2,1,0,0,1,2,268
064277202,263,10,0,1,0,1,7,282
064277203,215,6,1,1,1,0,7,231
064277204,262,10,2,3,0,0,14,291
064277205,304,7,4,1,0,0,10,326
064277206,230,5,1,1,1,2,5,245
064277207,260,5,0,4,0,0,3,272
064277208,225,0,2,1,0,0,4,232
064277209,284,6,3,1,0,0,2,296
064277210,270,5,0,2,4,0,4,285
064277211,457,5,1,0,1,0,5,469
064277212,321,4,2,4,0,0,2,333
064277301,370,6,0,0,0,0,3,379
064277302,420,8,2,6,2,0,10,448
064277303,291,3,0,2,1,0,2,299
064277304,244,7,0,9,0,0,18,278
064277305,290,6,2,3,2,2,4,309
064277306,357,8,3,6,0,0,3,377
064277307,259,3,2,1,1,0,8,274
064277308,437,10,3,1,0,1,5,457
064277309,362,1,1,1,0,0,8,373
064277310,424,6,4,16,0,0,13,463
064277311,188,4,0,2,0,0,7,201
064277312,240,6,0,1,1,0,3,251
064277313,343,4,1,0,0,0,5,353
064277314,232,0,0,0,0,0,6,238
064277315,262,1,0,4,0,0,1,268
064277316,281,0,1,13,0,1,3,299
064277401,356,4,0,2,0,0,4,366
064277402,452,5,1,4,1,0,9,472
064277403,302,4,3,0,0,1,2,312
064277404,186,0,1,0,0,0,3,190
064277405,289,5,2,3,5,0,5,309
064277406,429,6,1,4,0,1,9,450
064277407,363,9,6,3,3,0,11,395
064277408,284,14,2,0,0,0,11,311
064277409,241,6,1,0,3,0,3,254
064277410,273,6,0,1,0,0,2,282
064277411,403,8,6,8,0,0,2,427
064277412,411,4,4,7,0,0,5,431
064277413,258,3,2,0,0,0,1,264
064277414,370,8,0,2,0,0,0,380
064277415,229,2,0,1,0,1,4,237
064277416,241,4,0,2,0,0,0,247
064277417,297,5,4,3,0,0,7,316
064277418,709,9,1,1,1,0,12,733
064277501,258,3,0,3,0,0,3,267
064277502,323,0,3,2,0,0,3,331
064277503,292,13,2,1,1,0,8,317
064277504,306,9,0,10,1,0,5,331
064277505,448,4,0,2,0,0,2,456
064277506,213,5,1,3,0,1,2,225
064277507,355,10,1,5,2,0,18,391
064277508,312,1,2,25,1,1,12,354
064277509,243,3,1,0,0,0,7,254
064277510,369,6,0,3,0,0,4,382
064277511,374,8,2,0,1,0,1,386
064277512,297,2,1,1,0,0,4,305
064277513,269,1,1,0,1,0,6,278
064277514,264,1,0,0,0,0,2,267
064277515,325,2,3,0,1,0,0,331
064277516,348,4,0,2,0,0,2,356
064277601,400,3,0,2,2,0,11,418
064277602,214,6,0,2,0,0,16,238
064277603,460,2,0,0,0,0,14,476
064277604,428,7,0,0,0,0,5,440
064277605,392,11,1,3,1,0,8,416
064277606,391,12,6,1,1,0,0,411
064277607,419,4,2,1,0,0,10,436
064277608,345,12,15,37,0,0,45,454
064277609,370,19,1,5,0,2,3,400
064277610,368,21,0,3,1,0,1,394
064277611,438,12,11,0,1,1,9,472
064277612,454,6,1,5,0,3,3,472
064277613,220,6,10,22,0,0,12,270
064277614,231,0,1,0,0,0,14,246
064277615,365,10,4,1,0,0,27,407
064277616,372,9,2,5,6,0,27,421
064277617,250,5,2,3,0,0,18,278
064277618,250,9,0,0,0,0,23,282
064277701,334,6,1,4,0,0,5,350
064277702,403,9,1,0,0,1,2,416
064277703,363,5,3,0,0,0,6,377
064277704,451,22,3,0,0,0,18,494
064277705,244,2,1,0,0,0,2,249
064277706,378,4,2,4,0,0,12,400
064277707,281,6,2,0,0,0,3,292
064277708,238,13,1,1,0,0,3,256
064277709,226,7,3,0,0,0,4,240
064277710,377,9,3,2,1,0,3,395
064277711,303,3,0,4,0,0,7,317
064277712,414,17,2,3,0,0,10,446
064277713,284,9,2,4,1,1,8,309
064277714,251,14,2,1,0,0,11,279
064277715,230,6,3,3,0,0,7,249
064277716,266,10,2,0,0,4,5,287
064277801,166,1,0,0,0,0,11,178
064277802,414,4,2,0,0,0,3,423
064277803,292,8,1,0,0,0,13,314
064277804,273,10,0,3,0,0,3,289
064277805,402,7,0,1,0,0,8,418
064277806,241,5,0,2,0,0,1,249
064277807,384,4,2,7,1,1,4,403
064277808,227,1,1,1,0,0,2,232
064277809,303,4,0,0,0,0,3,310
064277810,276,4,0,2,0,1,1,284
064277811,262,14,0,1,0,1,3,281
064277812,368,7,0,2,1,2,5,385
064277813,355,4,0,0,1,0,10,370
064277901,303,5,3,2,0,0,4,317
064277902,254,8,0,1,0,0,5,268
064277903,255,15,2,3,0,0,4,279
064277904,305,3,3,0,0,0,7,318
064277905,434,8,1,0,0,0,3,446
064277906,287,4,4,4,0,0,7,306
064277907,200,5,0,0,0,0,3,208
064277908,223,5,1,3,1,1,7,241
064277909,280,2,0,2,2,0,5,291
064277910,333,12,1,0,0,1,11,358
064277911,452,12,0,0,0,1,5,470
064278001,264,0,0,0,0,1,2,267
064278002,427,10,0,2,0,0,2,441
064278003,411,3,0,1,1,0,3,419
064278004,256,0,0,0,0,0,8,264
064278005,255,7,2,4,0,0,5,273
064278006,412,9,1,3,0,0,7,432
064278007,284,2,0,1,0,0,3,290
064278008,368,5,1,0,0,0,7,381
064278009,246,2,1,0,0,0,7,256
064278010,202,0,1,1,0,1,2,207
064278011,203,7,2,6,0,0,1,219
064278012,223,13,3,15,0,0,1,255
064278013,202,4,0,0,0,1,3,210
064278014,213,1,0,2,0,0,4,220
064278015,192,5,0,1,4,0,7,209
064278016,248,3,1,2,0,0,5,259
064278101,336,2,1,4,0,0,5,348
064278102,239,1,1,2,0,0,6,249
064278103,302,9,1,0,0,1,5,318
064278104,226,0,0,1,0,0,7,234
064278105,159,7,0,2,0,0,2,170
064278106,111,3,3,11,1,2,7,138
064278107,103,4,1,3,0,0,5,116
064278108,20,2,0,0,0,0,1,23
064278109,65,6,1,21,0,0,7,100
064278110,88,0,0,4,0,0,3,95
064278111,249,8,4,18,0,0,4,283
064278112,64,0,0,1,0,0,0,65
064278201,356,0,0,0,0,0,3,359
064278202,267,4,2,2,0,0,3,278
064278203,331,7,1,1,0,0,5,345
064278204,278,2,1,0,0,0,5,286
064278205,239,1,2,0,0,0,2,244
064278206,54,0,1,0,0,0,2,57
064278207,413,3,0,3,0,0,0,419
064278208,323,0,0,13,1,2,4,343
064278209,376,2,0,0,0,0,0,378
064278210,277,8,1,1,0,0,4,291
064278211,231,4,0,0,0,0,3,238
064278212,239,6,0,1,0,1,4,251
064278213,316,9,4,0,0,2,3,334
064278301,367,9,1,3,0,1,2,383
064278302,330,5,1,2,0,0,3,341
064278303,330,10,3,2,0,0,3,348
064278304,316,8,3,3,0,0,8,338
064278305,191,4,7,5,3,2,12,224
064278306,329,1,1,1,0,0,7,339
064278307,272,1,1,0,0,1,8,283
064278308,299,4,0,7,0,0,9,319
064278309,280,1,5,1,0,0,7,294
064278310,316,5,1,2,0,0,2,326
064278311,304,7,2,1,0,0,7,321
064278312,298,4,0,6,0,1,1,310
064278313,389,9,3,2,0,0,10,413
064278314,326,5,7,2,4,0,5,349
064278401,241,9,0,133,0,0,5,388
064278402,256,11,0,111,0,0,10,388
064278403,245,0,1,6,2,0,7,261
064278404,366,8,3,2,1,0,15,395
064278405,445,17,3,5,0,1,12,483
064278406,312,4,1,10,0,0,5,332
064278407,357,11,2,3,0,0,3,376
064278408,375,5,3,2,0,0,5,390
064278409,476,8,2,2,0,0,3,491
064278410,299,9,0,1,0,0,5,314
064278411,429,8,3,4,1,0,9,454
064278412,357,27,0,21,0,0,6,411
064278413,407,4,0,18,0,0,6,435
064278414,237,10,0,31,0,1,3,282
064278415,507,19,1,11,0,0,17,555
064278416,385,9,2,6,1,0,13,416
064278417,414,18,5,12,0,0,2,451
064278501,477,3,2,8,0,1,5,496
064278502,474,3,2,1,0,1,1,482
064278503,351,3,3,4,2,0,2,365
064278504,291,9,2,5,0,1,15,323
064278505,257,5,1,0,0,0,3,266
064278506,368,8,3,1,0,1,4,385
064278507,315,8,4,3,2,2,12,346
064278508,212,2,4,2,2,1,14,237
064278509,437,3,14,0,3,4,22,483
064278510,254,5,6,4,1,1,14,285
064278511,340,8,1,8,1,1,12,371
064278512,315,11,0,5,0,2,4,337
064278513,399,10,1,4,0,0,6,420
064278601,389,20,6,3,4,3,11,436
064278602,292,17,8,4,0,4,2,327
064278603,348,1,10,10,1,6,9,385
064278604,295,3,7,2,0,1,4,312
064278605,273,16,5,2,0,0,6,302
064278606,279,6,8,3,0,1,6,303
064278607,340,19,3,4,0,8,13,387
064278608,250,11,1,3,0,3,10,278
064278609,274,5,2,13,0,1,3,298
064278610,282,5,2,5,9,3,5,311
064278611,257,9,0,2,0,1,3,272
064278612,286,7,0,1,0,0,5,299
064278613,332,6,4,2,1,2,4,351
064278614,325,6,1,1,0,0,7,340
064278701,298,5,2,3,0,1,3,312
064278702,269,0,0,4,3,0,9,285
064278703,258,3,1,0,0,0,4,266
064278704,343,3,1,1,0,2,5,355
064278705,423,12,11,2,1,0,7,456
064278706,269,0,4,2,0,3,3,281
064278707,282,3,4,6,6,0,4,305
064278708,464,0,6,4,0,0,2,476
064278709,226,0,1,3,0,2,1,233
064278710,292,1,2,7,0,1,3,306
064278711,42,0,0,1,0,0,1,44
064278712,233,4,1,0,1,1,6,246
064278713,309,5,7,5,0,3,5,334
064278714,269,9,4,1,1,0,5,289
064278715,219,2,0,2,0,1,0,224
064278801,315,11,8,1,0,0,8,343
064278802,503,8,2,9,1,0,4,527
064278803,418,8,6,4,0,2,4,442
064278804,329,8,1,4,1,1,4,348
064278805,366,11,0,2,0,1,6,386
064278806,257,5,4,8,0,0,7,281
064278807,296,19,5,2,0,0,5,327
064278808,382,4,11,0,0,0,7,404
064278809,375,7,3,4,0,0,5,394
064278810,332,5,1,0,17,0,11,366
064278811,187,2,2,3,1,3,2,200
064278812,293,1,7,4,0,0,18,323
064278813,363,2,13,2,0,1,11,392
064278901,364,3,2,24,0,0,12,405
064278902,285,5,0,2,0,0,6,298
064278903,465,5,7,2,1,1,6,487
064278904,498,8,1,0,0,1,12,520
064278905,485,12,3,4,0,2,2,508
064278906,384,12,2,4,1,0,3,406
064278907,485,12,0,5,0,0,5,507
064278908,424,6,1,7,1,0,6,445
064278909,223,5,2,0,0,0,1,231
064278910,275,2,1,5,0,0,4,287
064278911,481,14,0,3,0,1,6,505
064278912,454,14,1,1,0,2,4,476
064278913,500,19,2,2,0,1,6,530
064278914,484,10,0,2,0,0,2,498
064279001,422,9,8,7,0,1,7,454
064279002,430,9,2,1,0,0,8,450
064279003,187,3,5,1,0,0,1,197
064279004,260,13,0,3,0,0,4,280
064279005,260,2,0,0,0,0,2,264
064279006,309,8,1,1,0,1,7,327
064279007,293,1,0,2,0,0,6,302
064279008,349,0,3,2,0,1,2,357
064279009,558,10,2,2,0,0,2,574
064279010,563,13,1,2,1,6,17,603
064279011,252,12,2,1,7,12,3,289
064279012,171,8,2,4,0,9,5,199
064279013,236,16,3,3,0,3,8,269
064279014,294,12,0,3,0,1,1,311
064279101,288,4,0,3,0,0,4,299
064279102,136,1,1,1,0,0,2,141
064279103,320,12,0,1,0,0,7,340
064279104,313,11,2,2,0,0,2,330
064279105,245,8,0,1,0,0,3,257
064279106,294,8,2,2,0,2,6,314
064279107,288,2,1,3,0,0,5,299
064279108,305,5,3,1,0,1,4,319
064279109,265,1,1,2,0,0,0,269
064279110,172,10,2,0,1,0,0,185
064279111,192,2,0,0,0,0,2,196
064279112,369,1,1,2,0,2,12,387
064279113,111,11,2,24,1,109,11,269
064279114,76,2,3,4,0,73,19,177
064279115,102,3,25,6,1,105,3,245
064279116,86,1,3,1,0,63,26,180
064279201,359,11,0,13,0,1,9,393
064279202,351,15,3,5,0,5,2,381
064279203,205,11,3,1,1,2,15,238
064279204,385,18,1,2,0,1,11,418
064279205,372,6,2,1,0,2,5,388
064279206,467,24,2,31,0,0,17,541
064279207,500,21,0,8,1,0,4,534
064279208,474,5,0,6,0,1,8,494
064279209,390,15,0,6,0,12,1,424
064279210,391,14,1,4,1,1,5,417
064279211,368,12,0,1,1,1,8,391
064279212,353,10,4,2,0,4,7,380
064279213,321,7,3,11,0,0,6,348
064279214,390,1,0,1,0,2,5,399
064279215,223,14,2,6,0,0,7,252
064279216,304,7,1,7,0,0,4,323
064279217,213,3,1,1,0,0,3,221
064279218,202,2,0,1,0,0,5,210
064279219,371,15,3,6,1,1,7,404
064279301,316,2,4,4,1,2,9,338
064279302,348,6,0,3,0,0,7,364
064279303,291,9,2,3,0,0,3,308
064279304,343,5,2,7,0,1,8,366
064279305,298,22,3,22,1,5,28,379
064279306,478,12,6,5,0,1,8,510
064279307,407,9,1,5,0,3,10,435
064279308,416,9,1,3,5,11,10,455
064279309,420,6,11,5,1,4,8,455
064279310,429,13,3,2,1,0,14,462
064279311,465,5,2,3,0,1,5,481
064279312,379,13,3,1,1,0,7,404
064279313,411,2,1,2,1,0,9,426
064279314,416,7,0,4,0,0,9,436
064279315,443,24,4,50,0,1,10,532
064279401,358,8,1,5,0,0,8,380
064279402,383,7,3,6,0,5,3,407
064279403,425,7,1,2,0,1,1,437
064279404,440,4,2,1,0,4,7,458
064279405,465,11,1,6,2,0,6,491
064279406,499,11,1,1,0,0,10,522
064279407,246,7,3,7,1,0,8,272
064279408,285,15,1,9,1,5,5,321
064279409,390,11,2,7,0,0,9,419
064279410,344,9,5,4,0,2,17,381
064279411,386,9,1,2,0,3,10,411
064279412,383,9,2,3,2,2,5,406
064279413,361,14,2,3,0,0,3,383
064279501,287,3,1,4,0,1,1,297
064279502,373,10,0,2,0,0,16,401
064279503,431,8,3,2,0,1,11,456
064279504,513,12,3,5,0,1,3,537
064279505,418,7,1,10,0,3,8,447
064279506,381,6,2,5,0,1,8,403
064279507,708,5,1,0,0,3,15,732
064279508,370,5,0,0,0,0,2,377
064279509,322,10,5,2,0,0,1,340
064279510,398,12,2,6,1,8,14,441
064279511,373,10,1,0,0,0,4,388
064279512,498,4,1,6,1,3,1,514
064279513,345,4,2,23,2,0,4,380
064279514,342,15,4,6,2,3,4,376
064279601,377,3,3,4,0,0,17,404
064279602,341,14,0,18,0,1,23,397
064279603,322,12,2,10,0,0,3,349
064279604,329,6,1,6,0,1,5,348
064279605,218,12,1,5,0,1,7,244
064279606,421,21,4,3,2,21,17,489
064279607,272,6,0,0,0,2,3,283
064279608,389,20,8,13,1,10,16,457
064279609,478,25,5,10,0,5,11,534
064279610,444,34,3,7,0,2,19,509
064279611,289,12,1,2,0,2,7,313
064279612,333,17,1,9,0,0,15,375
064279613,36,6,0,5,0,2,1,50
064279614,349,12,0,2,0,4,9,376
064279615,243,23,4,13,0,4,5,292
064279616,119,40,6,22,0,34,12,233
064279701,269,9,3,17,0,5,29,332
064279702,384,4,4,6,0,0,7,405
064279703,359,22,1,8,0,1,17,408
064279704,390,18,12,17,1,31,14,483
064279705,199,12,3,13,0,0,1,228
064279706,449,28,2,8,0,1,13,501
064279707,347,9,3,21,0,24,18,422
064279708,343,21,1,7,1,13,22,408
064279709,264,8,3,11,1,22,9,318
064279710,217,17,0,4,0,10,14,262
064279711,97,14,2,3,3,11,21,151
064279712,112,11,1,6,0,2,6,138
064279713,240,15,3,4,0,6,16,284
064279714,361,25,2,8,0,1,5,402
064279715,207,7,1,4,1,2,9,231
064279716,119,7,1,2,0,2,11,142
064279717,247,13,1,27,0,2,3,293
064279718,170,4,2,12,0,1,12,201
064279719,214,14,1,9,0,2,7,247
064279720,337,3,8,8,0,3,8,367
064279721,303,46,1,21,0,0,7,378
064279722,194,22,0,4,0,1,5,226
064279723,258,11,0,1,0,1,3,274
064279724,245,8,1,1,0,2,13,270
064340101,397,12,0,4,0,0,5,418
064340102,265,12,2,5,0,0,12,296
064340103,260,2,11,2,6,2,17,300
064340104,259,27,4,2,0,0,19,311
064340105,331,26,12,1,5,0,9,384
064340106,368,20,4,8,1,0,13,414
064340107,216,39,9,3,0,0,2,269
064340108,238,17,13,2,5,1,29,305
064340109,249,39,5,8,0,1,16,318
064340110,301,20,14,3,5,0,9,352
064340111,273,38,12,5,4,0,14,346
064340201,233,24,3,3,2,2,8,275
064340202,53,1,0,0,0,0,5,59
064340203,278,14,3,5,1,1,11,313
064340204,213,16,13,2,1,0,24,269
064340205,292,33,9,6,0,0,23,363
064340206,288,17,14,3,4,0,23,349
064340207,59,4,1,0,1,0,5,70
064340208,193,16,5,2,4,0,4,224
064340209,52,6,3,1,1,1,2,66
064340210,194,13,12,0,12,1,16,248
064340211,347,37,9,6,11,1,18,429
064340212,297,13,12,1,17,6,24,370
064340301,332,14,11,6,3,0,13,379
064340302,281,26,10,1,10,0,17,345
064340303,482,42,15,9,19,3,31,601
064340304,245,17,9,9,5,1,21,307
064340305,320,10,7,5,10,0,48,400
064340306,242,7,4,1,2,0,8,264
064340307,305,27,7,1,7,0,16,363
064340308,441,54,9,6,4,1,26,541
064340309,487,30,17,5,12,4,19,574
064340310,309,31,6,3,11,1,14,375
064340401,359,40,6,2,0,2,16,425
064340402,266,21,10,7,2,0,6,312
064340403,291,35,10,1,1,0,14,352
064340404,206,23,6,3,4,1,13,256
064340405,240,21,3,0,0,1,2,267
064340406,350,20,6,3,4,1,22,406
064340407,209,19,5,1,1,0,4,239
064340408,143,14,3,2,1,0,20,183
064340409,179,14,5,0,6,0,15,219
064340410,354,19,19,5,8,3,12,420
064340501,405,23,4,5,1,0,19,457
064340502,368,30,7,4,10,1,20,440
064340503,270,21,2,0,6,0,5,304
064340504,291,9,0,2,2,0,25,329
064340505,311,19,10,3,2,0,13,358
064340506,224,14,7,0,1,0,9,255
064340507,343,16,5,0,2,1,30,397
064340508,298,21,2,4,1,1,10,337
064340601,328,17,10,4,7,2,23,391
064340602,248,18,3,1,1,0,15,286
064340603,299,19,2,2,0,1,16,339
064340604,296,15,9,6,2,2,11,341
064340605,271,16,1,2,3,1,10,304
064340606,378,37,15,8,4,0,8,450
064340607,317,17,10,6,3,0,11,364
064340608,344,15,4,3,5,5,24,400
064340609,312,8,5,2,0,0,1,328
064340701,217,2,0,0,0,0,7,226
064340702,213,10,2,0,0,0,2,227
064340703,268,23,15,1,1,0,14,322
064340704,214,4,7,0,1,0,19,245
064340705,268,4,0,1,0,0,4,277
064340706,145,5,6,3,1,1,7,168
064340707,1009,91,18,0,0,0,50,1168
064340708,148,14,4,2,1,0,6,175
064340709,149,4,1,5,1,0,13,173
064340710,212,12,1,0,0,0,9,234
064340711,150,9,0,0,0,0,24,183
064340801,200,12,1,3,0,0,6,222
064340802,396,16,2,1,0,0,11,426
064340803,210,11,1,1,0,1,6,230
064340804,286,6,0,1,0,0,4,297
064340805,283,8,7,0,1,0,7,306
064340806,448,7,7,0,4,1,10,477
064340807,203,1,0,0,0,0,2,206
064340808,82,1,0,1,0,0,0,84
064340809,226,1,0,0,0,0,5,232
064340810,323,3,0,1,0,0,6,333
064340811,260,0,0,0,0,0,0,260
064340812,410,1,0,0,0,0,2,413
064340813,273,8,0,2,0,0,14,297
064340814,223,12,2,3,1,0,9,250
064340815,380,8,1,1,7,1,8,406
064340816,385,19,2,2,1,0,3,412
064340901,241,7,2,0,1,0,3,254
064340902,265,1,0,0,0,0,8,274
064340903,297,4,0,0,0,0,2,303
064340904,191,0,0,0,0,0,8,199
064340905,146,5,0,3,0,0,4,158
064340906,257,2,0,1,0,0,1,261
064340907,234,1,0,0,1,0,3,239
064340908,232,9,0,0,1,0,0,242
064340909,191,6,0,0,0,0,7,204
064340910,211,6,2,3,1,0,6,229
064340911,171,3,0,1,0,0,3,178
064340912,209,3,0,2,0,0,2,216
064340913,221,4,0,1,0,0,6,232
064340914,329,5,1,1,2,0,9,347
064340915,293,5,3,2,0,0,9,312
064340916,187,8,1,0,0,0,1,197
064340917,184,9,0,0,0,0,3,196
064340918,232,2,1,1,0,0,2,238
064341001,254,5,3,0,1,0,11,274
064341002,165,9,2,1,0,0,19,196
064341003,196,10,4,4,2,0,0,216
064341004,190,3,6,3,4,0,5,211
064341005,208,8,2,2,1,0,7,228
064341006,303,1,12,3,0,0,10,329
064341007,325,26,3,3,0,0,7,364
064341008,361,19,1,2,4,0,6,393
064341009,339,5,4,4,0,0,18,370
064341010,295,9,1,3,1,1,10,320
064341011,326,14,0,0,0,0,7,347
064341012,257,8,2,2,0,0,4,273
064341101,294,9,4,5,2,0,5,319
064341102,368,15,2,3,0,0,4,392
064341103,245,6,5,1,3,0,6,266
064341104,267,8,3,2,0,0,6,286
064341105,242,14,5,2,5,1,8,277
064341106,189,9,2,11,0,1,3,215
064341107,197,9,2,1,3,1,7,220
064341108,198,14,2,1,1,0,3,219
064341109,247,5,0,3,0,0,1,256
064341110,187,7,1,4,0,0,4,203
064341111,285,8,1,2,0,0,2,298
064341112,374,9,4,4,7,1,26,425
064341113,353,32,9,0,3,1,8,406
064341114,211,12,0,2,1,0,1,227
064341201,326,8,6,3,4,0,8,355
064341202,366,24,8,0,6,4,15,423
064341203,323,26,8,2,4,1,9,373
064341204,343,22,14,3,5,0,13,400
064341205,312,12,5,3,2,1,12,347
064341206,337,22,5,3,0,0,9,376
064341207,346,22,2,0,0,1,8,379
064341208,296,5,2,5,2,1,29,340
064341301,328,21,9,5,3,1,18,385
064341302,217,11,1,10,2,1,11,253
064341303,273,22,5,4,3,0,14,321
064341304,184,15,7,1,2,0,2,211
064341305,339,28,2,7,0,1,14,391
064341306,276,22,8,3,1,0,10,320
064341307,289,21,11,5,1,2,8,337
064341308,341,31,4,5,3,1,33,418
064341309,339,17,4,3,0,1,11,375
064341310,312,10,3,3,1,0,6,335
064341311,391,16,3,4,3,0,13,430
064341312,296,15,1,3,3,0,5,323
064341401,264,15,4,3,2,0,24,312
064341402,215,19,4,4,7,0,29,278
064341403,229,24,8,2,4,1,18,286
064341404,282,27,1,3,2,0,11,326
064341405,246,23,14,6,15,0,10,314
064341406,302,20,1,6,0,2,14,345
064341407,300,16,7,1,6,0,11,341
064341408,326,12,3,1,3,2,30,377
064341501,180,21,16,2,16,0,17,252
064341502,296,59,36,1,56,2,43,493
064341503,177,1,55,1,47,1,24,306
064341504,213,26,15,5,2,0,9,270
064341505,216,26,21,2,4,1,16,286
064341506,197,29,14,4,25,0,17,286
064341507,243,33,11,3,8,0,40,338
064341508,226,23,32,0,8,1,24,314
064341509,185,33,14,4,10,0,8,254
064341510,177,29,4,2,3,0,33,248
064341511,173,26,37,1,24,0,19,280
064341512,147,33,17,1,21,2,15,236
064341513,327,30,49,8,11,2,23,450
064341514,241,51,10,8,11,0,15,336
064341515,296,36,22,2,4,0,13,373
064341601,303,8,2,2,2,0,17,334
064341602,267,7,10,1,10,0,23,318
064341603,299,4,20,4,9,0,31,367
064341604,224,3,4,2,1,0,11,245
064341605,194,20,6,2,8,0,17,247
064341606,179,12,40,0,1,1,2,235
064341607,239,21,26,6,3,0,19,314
064341608,187,9,8,1,0,0,8,213
064341609,333,21,9,3,4,1,10,381
064341610,359,29,8,5,7,0,12,420
064341611,314,4,2,4,2,0,17,343
064341612,413,16,8,4,0,0,25,466
064341613,363,19,23,4,4,0,16,429
064341701,262,12,9,4,1,0,5,293
064341702,318,7,18,1,6,0,23,373
064341703,322,20,20,5,1,1,48,417
064341704,292,28,9,10,3,0,14,356
064341705,294,14,12,5,6,0,13,344
064341706,186,16,1,5,4,0,19,231
064341707,158,10,5,3,7,0,11,194
064341708,254,12,26,1,3,2,6,304
064341709,246,6,6,2,2,1,17,280
064341710,130,12,6,2,2,0,3,155
064341711,256,12,1,0,9,0,20,298
064341801,346,16,10,5,3,0,7,387
064341802,225,18,1,6,2,0,9,261
064341803,368,28,6,1,1,0,19,423
064341804,210,17,15,9,12,0,4,267
064341805,314,34,11,8,10,1,18,396
064341806,380,18,60,8,19,0,20,505
064341807,183,34,15,2,6,1,18,259
064341808,255,12,9,3,2,0,14,295
064341809,178,39,17,0,5,0,11,250
064341810,165,24,5,0,7,1,22,224
064341811,194,23,16,9,12,0,10,264
064341812,197,1,40,2,2,1,18,261
064341813,301,14,16,5,4,0,20,360
064341814,113,19,7,0,1,0,6,146
064341901,301,14,5,4,3,4,15,346
064341902,348,24,14,4,2,4,21,417
064341903,347,34,11,4,3,0,13,412
064341904,304,22,12,2,1,0,18,359
064341905,349,23,6,3,3,0,24,408
064341906,303,25,4,7,0,0,22,361
064341907,299,21,14,6,1,1,10,352
064341908,230,18,9,5,4,0,17,283
064341909,277,22,12,2,8,0,13,334
064342001,247,2,7,3,3,0,15,277
064342002,320,7,7,3,1,1,8,347
064342003,347,0,13,9,6,1,17,393
064342004,200,1,2,0,14,0,5,222
064342005,318,12,11,0,1,0,11,353
064342006,389,0,9,1,2,0,11,412
064342007,216,0,2,2,2,1,16,239
064342008,330,3,3,3,0,2,11,352
064342009,277,1,4,3,5,1,26,317
064342010,270,4,5,2,1,0,5,287
064342101,328,2,4,0,3,0,8,345
064342102,245,1,2,3,10,0,10,271
064342103,261,2,15,3,1,0,13,295
064342104,186,1,4,3,0,0,7,201
064342105,243,0,1,1,1,0,8,254
064342106,176,3,2,1,0,0,9,191
064342107,185,4,6,3,2,0,17,217
064342108,245,8,1,0,1,0,11,266
064342109,209,1,5,3,7,1,17,243
064342110,190,3,4,2,1,0,12,212
064342111,202,0,2,5,1,0,8,218
064342112,279,2,9,3,7,1,13,314
064342113,331,3,6,4,4,0,14,362
064342201,260,7,2,0,0,0,24,293
064342202,210,1,0,0,0,0,0,211
064342203,188,1,1,1,1,0,7,199
064342204,291,3,1,3,0,0,7,305
064342205,185,1,2,1,4,0,6,199
064342206,188,1,0,0,0,1,1,191
064342207,203,1,1,0,3,0,9,217
064342208,211,1,2,1,5,0,5,225
064342209,282,1,0,0,0,0,2,285
064342210,429,0,3,0,0,1,11,444
064342211,293,1,2,0,0,0,6,302
064342212,256,2,2,3,3,0,9,275
064342213,359,0,4,0,0,0,20,383
064342214,255,4,1,3,1,0,5,269
064342301,309,19,3,4,0,0,8,343
064342302,254,6,3,1,0,0,4,268
064342303,329,9,0,0,0,0,14,352
064342304,286,5,0,1,0,0,10,302
064342305,352,11,0,3,0,0,4,370
064342306,376,5,0,0,0,1,1,383
064342307,150,3,0,0,0,0,5,158
064342308,329,2,0,1,0,0,13,345
064342309,239,3,0,0,0,0,5,247
064342310,236,4,2,1,0,0,1,244
064342311,363,3,0,1,0,0,10,377
064342312,194,2,0,0,0,0,4,200
064342313,9,1,0,0,0,0,1,11
064342314,211,6,0,0,0,0,0,217
064342315,216,1,0,0,0,0,7,224
064342401,187,8,3,4,0,0,7,209
064342402,190,5,9,11,0,0,1,216
064342403,206,13,6,1,3,0,20,249
064342404,217,18,5,0,1,0,6,247
064342405,248,3,2,0,2,0,23,278
064342406,234,5,10,0,4,0,11,264
064342407,221,5,1,1,0,0,10,238
064342408,355,12,3,2,0,0,6,378
064342409,266,12,2,4,2,0,10,296
064342410,228,23,4,5,8,1,13,282
064342501,379,7,4,0,0,0,17,407
064342502,207,0,10,1,1,2,10,231
064342503,161,7,6,2,1,0,2,179
064342504,181,16,3,0,0,0,5,205
064342505,215,10,2,5,0,0,3,235
064342506,195,4,0,0,0,0,7,206
064342507,225,0,1,0,0,0,1,227
064342508,298,21,3,0,0,0,13,335
064342509,193,5,1,2,1,0,11,213
064342510,220,3,3,2,3,0,1,232
064342511,243,7,0,2,0,0,6,258
064342512,203,2,3,0,0,0,8,216
064342513,254,9,5,2,1,0,5,276
064342514,225,0,1,0,0,0,32,258
064342515,189,12,0,0,0,0,4,205
064342516,314,8,2,1,0,0,12,337
064342517,234,12,4,1,2,0,15,268
064342518,185,8,2,1,1,1,7,205
064342601,310,6,0,0,0,0,5,321
064342602,180,0,0,0,0,0,0,180
064342603,332,48,1,82,0,0,32,495
064342604,314,11,0,0,0,0,8,333
064342605,67,0,0,0,0,0,0,67
064342606,110,2,0,0,0,0,2,114
064342607,142,3,0,0,0,0,2,147
064342608,204,3,2,0,0,0,4,213
064342609,149,2,0,0,0,1,7,159
064342610,306,3,1,4,0,0,8,322
064342611,174,3,0,0,0,0,10,187
064342612,139,6,0,0,1,0,1,147
064342613,278,1,2,1,1,0,6,289
064342614,266,2,0,0,0,0,3,271
064342615,136,1,1,1,0,0,3,142
064342616,231,4,0,2,8,0,2,247
064342617,183,4,0,0,0,0,2,189
064342618,258,6,0,2,0,0,7,273
064342619,279,9,0,0,1,0,4,293
064342701,270,12,10,1,10,1,4,308
064342702,281,12,5,5,1,0,20,324
064342703,423,11,5,0,3,0,6,448
064342704,215,18,2,4,1,1,6,247
064342705,163,17,5,0,12,0,7,204
064342706,299,20,4,0,0,0,4,327
064342707,247,12,1,0,1,0,2,263
064342708,232,11,4,0,1,0,5,253
064342709,341,23,5,3,3,0,9,384
064342710,378,23,10,4,1,0,8,424
064342801,292,11,7,2,5,0,6,323
064342802,330,10,2,2,6,0,8,358
064342803,362,21,6,0,5,0,6,400
064342804,276,8,2,0,1,0,7,294
064342805,262,12,5,3,0,0,2,284
064342806,294,17,4,5,1,0,4,325
064342807,258,6,4,1,0,0,4,273
064342808,432,21,5,3,3,1,13,478
064342809,346,25,1,0,2,0,31,405
064342810,365,14,6,4,1,1,9,400
064342811,201,18,5,4,0,1,10,239
064342812,230,18,2,4,2,0,4,260
064342813,219,16,5,2,3,0,16,261
064342814,276,8,4,3,4,0,9,304
064342901,310,12,6,3,4,0,23,358
064342902,377,23,7,5,4,0,16,432
064342903,294,19,8,6,3,1,16,347
064342904,290,15,9,3,0,0,15,332
064342905,267,28,7,4,1,0,14,321
064342906,285,30,5,1,0,0,6,327
064342907,320,29,4,1,3,0,7,364
064342908,211,8,5,3,3,0,3,233
064342909,330,31,4,6,0,0,5,376
064342910,182,13,7,6,5,0,7,220
064342911,185,8,6,2,2,0,11,214
064343001,226,13,11,2,1,0,13,266
064343002,222,20,4,3,0,0,15,264
064343003,283,24,5,1,2,1,15,331
064343004,311,25,3,1,9,0,9,358
064343005,307,33,14,3,9,0,24,390
064343006,294,20,12,6,4,0,33,369
064343007,343,26,16,6,3,2,16,412
064343008,227,23,3,3,3,0,11,270
064343009,302,17,11,4,1,0,17,352
064343101,341,23,14,7,8,3,21,417
064343102,198,13,7,5,0,0,13,236
064343103,266,12,10,7,4,0,25,324
064343104,215,19,1,5,1,0,7,248
064343105,366,57,44,5,4,1,10,487
064343106,287,51,14,0,8,1,39,400
064343107,166,21,6,3,5,0,10,211
064343108,183,23,7,1,2,0,23,239
064343109,216,65,19,2,26,2,18,348
064343110,172,22,26,3,52,2,20,297
064343111,188,26,4,4,12,1,8,243
064343112,235,22,6,3,6,1,13,286
064343113,297,58,74,3,23,0,11,466
064343114,270,26,17,3,28,2,11,357
064343115,139,24,8,1,30,0,11,213
064343201,334,32,19,5,19,0,11,420
064343202,313,64,18,4,30,2,19,450
064343203,214,22,18,2,40,2,21,319
064343204,150,53,27,5,32,0,8,275
064343205,172,41,29,1,11,0,3,257
064343206,161,13,25,10,9,0,8,226
064343207,301,19,14,3,9,3,12,361
064343208,256,14,8,7,0,0,11,296
064343209,338,26,5,3,0,0,24,396
064343210,326,26,8,1,3,0,10,374
064343211,246,22,10,6,0,0,15,299
064343212,234,29,6,3,7,1,10,290
064343213,291,17,9,3,18,0,27,365
064343301,275,1,7,2,4,0,36,325
064343302,351,21,10,0,8,1,6,397
064343303,331,12,10,3,2,0,21,379
064343304,234,9,3,2,1,1,23,273
064343305,320,14,9,8,4,2,11,368
064343306,312,11,2,4,5,0,15,349
064343307,319,31,6,4,2,0,6,368
064343308,214,18,6,3,0,0,10,251
064343401,323,15,3,4,1,1,27,374
064343402,364,20,9,5,2,0,16,416
064343403,260,22,1,2,2,2,12,301
064343404,225,3,3,0,2,0,15,248
064343405,224,11,4,2,2,0,9,252
064343406,252,13,2,0,2,0,4,273
064343407,272,8,1,0,1,3,10,295
064343408,223,8,6,3,4,0,12,256
064343409,197,5,2,2,2,0,17,225
064343410,327,12,3,3,0,0,17,362
064343411,339,13,4,5,6,0,12,379
064343412,414,23,4,1,3,2,13,460
064343413,316,5,3,2,1,1,16,344
064343414,261,8,2,4,0,0,2,277
064343501,340,15,4,5,1,0,8,373
064343502,197,8,5,3,4,0,18,235
064343503,170,11,3,3,1,1,12,201
064343504,395,19,1,1,1,2,12,431
064343505,120,26,0,0,3,1,4,154
064343506,284,3,5,3,1,0,24,320
064343507,255,3,2,0,0,0,11,271
064343508,232,1,8,1,1,0,7,250
064343509,264,18,5,1,1,0,2,291
064343510,255,7,1,0,0,0,18,281
064343511,274,6,1,0,0,0,18,299
064343512,90,4,0,1,0,0,6,101
064343513,238,15,1,1,1,0,7,263
064343601,356,9,14,7,2,1,19,408
064343602,378,15,2,4,4,1,16,420
064343603,308,24,11,3,8,1,14,369
064343604,316,10,8,5,7,0,18,364
064343605,270,18,11,6,8,0,12,325
064343606,328,13,6,5,7,0,27,386
064343607,245,19,6,5,1,0,9,285
064343608,212,16,5,1,0,0,19,253
064343701,213,25,8,5,0,1,3,255
064343702,262,21,19,6,3,0,22,333
064343703,231,8,4,3,2,0,9,257
064343704,286,17,7,4,1,0,12,327
064343705,315,11,9,8,1,0,21,365
064343706,301,32,9,4,2,0,20,368
064343707,287,29,11,4,2,0,7,340
064343708,232,14,11,5,3,0,18,283
064343801,164,14,8,2,5,0,4,197
064343802,299,24,6,7,8,0,15,359
064343803,328,27,12,3,6,0,26,402
064343804,329,38,14,5,22,1,18,427
064343805,262,34,7,0,17,0,29,349
064343806,313,24,26,6,4,0,19,392
064343807,216,21,10,2,7,0,16,272
064343808,319,20,13,1,7,1,23,384
064343809,247,16,17,6,5,0,12,303
064343901,270,34,18,2,10,0,9,343
064343902,221,22,10,1,6,0,21,281
064343903,259,31,8,3,2,0,25,328
064343904,205,14,8,0,0,0,8,235
064343905,301,29,11,42,1,1,13,398
064343906,278,34,9,1,7,0,26,355
064343907,258,30,8,7,1,0,6,310
064343908,164,16,2,1,0,0,6,189
064343909,206,7,0,1,0,0,10,224
064344001,319,11,7,4,5,0,25,371
064344002,350,36,10,0,1,0,13,410
064344003,181,11,6,2,0,0,9,209
064344004,138,14,11,5,11,0,19,198
064344005,190,10,2,5,9,0,7,223
064344006,206,7,1,4,0,0,11,229
064344007,220,20,4,1,2,0,10,257
064344008,366,19,5,0,0,1,14,405
064344101,248,23,11,5,2,0,16,305
064344102,257,9,10,5,3,0,15,299
064344103,374,30,7,2,0,0,25,438
064344104,309,12,4,5,1,0,12,343
064344105,296,0,5,3,0,4,22,330
064344106,274,4,2,0,1,0,7,288
064344107,177,10,3,0,0,0,8,198
064344108,312,26,9,7,0,0,13,367
064344201,286,14,3,1,0,0,15,319
064344202,265,13,2,5,9,1,25,320
064344203,191,18,11,2,1,0,5,228
064344204,261,13,8,2,0,0,4,288
064344205,202,19,6,0,0,0,9,236
064344206,262,14,9,1,6,0,11,303
064344207,208,8,3,1,0,0,9,229
064344208,255,7,7,10,2,0,19,300
064344301,355,16,7,1,1,0,23,403
064344302,261,19,4,2,8,0,14,308
064344303,358,26,9,3,0,0,25,421
064344304,296,24,8,2,4,1,24,359
064344305,221,10,4,6,0,0,17,258
064344306,265,13,5,0,0,0,11,294
064344307,249,18,10,3,1,0,10,291
064344308,223,20,2,5,3,0,7,260
064344401,152,3,0,1,2,0,3,161
064344402,236,0,3,0,0,0,12,251
064344403,245,8,0,0,1,0,3,257
064344404,171,14,1,2,3,0,3,194
064344405,255,7,1,4,1,0,14,282
064344406,443,7,5,2,1,0,10,468
064344407,406,21,1,1,3,0,6,438
064344408,222,7,6,1,0,0,5,241
064344409,199,10,2,0,1,0,11,223
064344410,273,12,1,2,1,0,24,313
064344411,249,20,2,0,0,0,6,277
064344412,356,15,10,3,1,0,28,413
064344501,324,25,3,2,1,0,13,368
064344502,444,6,1,2,0,0,9,462
064344503,242,2,0,1,0,0,2,247
064344504,246,3,2,1,1,0,1,254
064344505,342,11,2,1,0,0,8,364
064344506,220,3,0,1,0,0,11,235
064344507,296,1,1,3,0,0,5,306
064344508,283,7,1,3,0,0,2,296
064344509,239,7,1,0,2,0,3,252
064344510,224,11,0,0,0,0,4,239
064344511,344,16,9,2,0,0,6,377
064344512,460,22,3,6,1,1,19,512
064900101,182,8,0,0,0,0,4,194
064900102,302,2,0,0,0,0,14,318
064900103,194,3,0,0,0,0,24,221
064900104,223,4,0,0,0,0,7,234
064900105,246,6,0,0,0,0,6,258
064900106,216,3,0,0,0,0,6,225
064900107,223,2,0,0,0,0,31,256
064900108,168,6,0,0,0,0,7,181
064900109,160,2,0,0,0,0,16,178
064900110,164,1,0,0,0,0,6,171
064900111,199,6,0,0,0,0,8,213
064900112,228,2,0,0,0,0,13,243
064900113,141,4,0,0,0,0,2,147
064900114,150,5,0,0,0,0,11,166
064900201,368,11,2,0,1,0,10,392
064900202,333,6,0,1,0,0,5,345
064900203,247,3,0,0,0,0,2,252
064900204,249,7,0,0,0,0,8,264
064900205,352,4,3,2,0,0,2,363
064900206,303,17,1,0,0,0,4,325
064900207,379,2,0,1,0,0,6,388
064900208,437,3,1,1,0,0,10,452
064900209,413,22,1,1,31,0,7,475
064900210,334,9,1,4,0,0,8,356
064900301,294,2,0,1,2,1,8,308
064900302,310,9,1,3,0,1,5,329
064900303,207,0,4,0,1,0,8,220
064900304,115,0,0,0,0,0,1,116
064900305,160,1,1,1,1,0,7,171
064900306,332,11,1,4,0,0,7,355
064900307,219,11,0,2,0,1,4,237
064900308,197,1,1,0,0,0,4,203
064900309,312,12,2,0,6,0,13,345
064900310,466,12,0,6,0,0,29,513
064900311,130,1,0,3,1,0,7,142
064900312,241,5,0,0,0,0,18,264
064900313,313,13,0,0,3,0,7,336
064900401,304,10,3,2,2,0,5,326
064900402,278,6,0,3,0,1,2,290
064900403,254,6,0,2,0,0,4,266
064900404,222,2,1,1,0,0,1,227
064900405,303,4,1,0,0,0,2,310
064900406,268,18,2,3,1,1,5,298
064900407,375,18,0,8,0,0,13,414
064900408,229,1,0,0,0,0,5,235
064900409,194,6,1,2,0,0,2,205
064900410,236,5,0,0,0,0,15,256
064900411,313,8,2,2,6,0,16,347
064900412,153,3,2,0,0,0,2,160
064900413,217,5,1,3,0,0,13,239
064900414,432,34,2,1,3,0,4,476
064900501,236,5,0,0,0,0,2,243
064900502,310,6,4,1,5,0,7,333
064900503,231,6,2,4,0,1,7,251
064900504,193,4,1,0,0,0,2,200
064900505,226,5,2,1,0,0,8,242
064900506,209,2,3,2,0,0,7,223
064900507,242,7,1,1,4,0,2,257
064900508,356,8,3,2,5,0,13,387
064900509,223,14,2,0,0,0,4,243
064900510,314,14,2,4,0,0,5,339
064900511,259,9,1,0,0,0,5,274
064900512,428,10,1,0,2,0,14,455
064900513,189,10,5,0,0,0,8,212
064900514,316,15,1,2,0,0,4,338
064900515,337,5,0,0,5,0,6,353
064900516,438,5,0,3,15,1,9,471
064900601,250,1,5,4,3,0,20,283
064900602,354,27,9,6,2,0,15,413
064900603,244,7,5,2,1,2,5,266
064900604,338,23,9,3,9,1,14,397
064900605,198,5,4,4,4,2,8,225
064900606,208,15,2,2,3,2,25,257
064900607,316,10,5,4,30,0,9,374
064900608,360,7,1,3,0,1,9,381
064900609,181,15,3,0,1,0,8,208
064900610,221,18,3,1,0,0,5,248
064900611,267,1,2,2,2,0,4,278
064900612,334,37,27,2,0,0,17,417
064900613,349,34,25,0,1,1,1,411
064900614,352,32,2,2,0,0,7,395
064900615,304,14,6,0,0,0,7,331
064900701,198,0,0,0,0,0,5,203
064900702,218,3,4,0,1,1,9,236
064900703,299,1,7,5,6,0,14,332
064900704,252,1,1,1,3,0,7,265
064900705,342,1,10,2,0,2,11,368
064900706,321,3,8,0,3,0,12,347
064900707,269,1,2,1,0,0,9,282
064900708,186,3,0,0,0,0,12,201
064900709,165,1,0,0,0,0,8,174
064900710,270,2,8,1,3,0,15,299
064900711,179,0,1,0,0,0,6,186
064900712,280,2,18,4,3,0,14,321
064900713,218,1,4,0,4,1,2,230
064900714,236,1,0,1,0,0,8,246
064900715,222,0,0,2,0,0,4,228
064900801,229,1,4,0,1,0,8,243
064900802,230,2,14,5,0,0,12,263
064900803,390,5,6,2,5,0,21,429
064900804,172,7,2,4,1,0,6,192
064900805,155,12,10,4,3,0,15,199
064900806,218,9,10,1,25,0,11,274
064900807,191,8,20,0,1,0,4,224
064900808,349,25,9,7,5,0,11,406
064900809,359,20,11,8,2,2,23,425
064900901,326,20,17,2,4,0,9,378
064900902,269,22,3,2,1,1,23,321
064900903,190,10,3,1,0,2,12,218
064900904,144,10,2,0,0,1,4,161
064900905,371,19,9,2,0,1,14,416
064900906,330,22,6,9,7,0,12,386
064900907,246,16,5,5,3,0,15,290
064900908,255,20,4,3,4,1,16,303
064900909,211,32,12,0,3,0,2,260
064901001,221,8,2,0,0,0,13,244
064901002,365,50,6,1,1,0,10,433
064901003,296,24,13,5,0,1,19,358
064901004,348,31,11,3,4,1,14,412
064901005,351,35,14,4,5,0,27,436
064901006,205,16,10,4,2,0,10,247
064901007,205,27,1,1,4,1,3,242
064901008,276,12,7,1,9,0,19,324
064901009,236,7,2,1,0,0,5,251
064901010,313,22,4,8,2,1,15,365
064901011,364,20,7,4,1,0,8,404
064901012,307,29,4,9,4,0,14,367
064901013,317,32,6,6,5,0,17,383
064901014,228,21,3,9,3,1,13,278
064901015,254,30,12,9,16,5,7,333
064901101,173,25,9,5,2,0,21,235
064901102,276,21,15,2,9,0,3,326
064901103,272,24,10,3,3,0,17,329
064901104,304,19,11,4,4,1,12,355
064901105,342,20,37,5,3,3,18,428
064901106,168,33,23,2,9,2,4,241
064901107,164,18,16,0,19,0,25,242
064901108,169,45,9,2,6,1,21,253
064901109,208,22,11,4,10,1,29,285
064901110,213,30,13,3,19,5,16,299
064901111,184,32,32,4,34,2,8,296
064901112,229,16,36,0,12,5,59,357
064901113,290,36,22,7,0,1,16,372
064901114,303,24,12,4,3,0,11,357
064901115,217,25,8,3,5,0,18,276
064901116,354,28,33,1,9,1,20,446
064901117,330,45,23,7,30,4,12,451
064901118,247,22,11,5,10,0,9,304
064901201,267,28,5,4,1,1,12,318
064901202,334,19,8,1,2,0,15,379
064901203,330,22,14,11,0,0,11,388
064901204,173,13,1,4,9,2,14,216
064901205,188,14,5,2,2,0,10,221
064901206,346,25,27,4,3,0,26,431
064901207,325,6,8,6,2,2,12,361
064901208,280,28,7,2,0,1,6,324
064901209,297,17,5,5,0,3,13,340
064901210,316,13,4,5,1,1,19,359
064901301,368,14,4,2,3,0,19,410
064901302,333,5,2,1,2,0,10,353
064901303,301,6,2,1,5,1,8,324
064901304,201,0,1,0,0,1,7,210
064901305,210,0,2,1,1,0,2,216
064901306,324,1,1,9,0,0,7,342
064901307,212,3,1,2,0,2,6,226
064901308,273,1,3,3,0,0,6,286
064901309,326,8,1,0,6,0,12,353
064901310,367,9,5,2,0,0,20,403
064901311,327,2,3,2,1,1,23,359
064901312,280,4,0,0,0,0,8,292
064901313,269,0,0,0,0,0,3,272
064901314,343,0,0,6,2,0,6,357
064901315,412,2,1,2,0,0,16,433
064901401,254,12,5,2,0,0,6,279
064901402,337,16,3,2,2,0,5,365
064901403,175,7,1,2,2,1,3,191
064901404,240,9,1,0,0,1,3,254
064901405,240,10,0,0,2,0,1,253
064901406,169,3,3,0,1,0,10,186
064901407,266,9,0,0,1,0,7,283
064901408,207,5,0,0,1,1,6,220
064901409,225,6,2,1,1,0,15,250
064901410,263,13,1,0,0,0,5,282
064901411,266,6,1,0,0,0,5,278
064901412,233,5,0,0,0,0,8,246
064901501,242,1,0,3,0,0,7,253
064901502,277,1,1,3,0,0,12,294
064901503,179,0,0,1,0,0,8,188
064901504,190,3,1,0,0,0,9,203
064901505,192,2,0,0,0,0,5,199
064901506,73,0,0,1,0,0,2,76
064901507,156,2,0,1,0,0,6,165
064901508,155,5,0,2,0,0,6,168
064901509,97,1,0,1,0,0,6,105
064901510,252,7,1,1,0,0,5,266
064901511,241,3,1,3,0,0,10,258
064901601,407,11,1,3,5,0,6,433
064901602,189,14,1,1,1,0,6,212
064901603,316,16,1,2,1,0,3,339
064901604,144,5,1,6,0,0,5,161
064901605,262,71,10,12,3,0,8,366
064901606,203,3,0,3,0,0,2,211
064901607,266,8,10,4,3,1,7,299
064901608,286,16,1,0,2,0,16,321
064901609,323,22,2,1,0,1,15,364
064901701,351,9,3,0,0,1,24,388
064901702,290,4,0,0,0,0,5,299
064901703,193,1,0,1,0,0,7,202
064901704,319,12,0,2,0,0,8,341
064901705,375,8,1,5,0,0,8,397
064901706,340,6,3,0,0,0,5,354
064901707,347,31,2,1,3,0,14,398
064901708,359,8,1,2,0,0,6,376
064901709,262,15,1,1,6,0,12,297
064901801,374,6,1,1,2,0,7,391
064901802,311,0,10,2,2,0,27,352
064901803,338,1,6,0,8,2,16,371
064901804,344,1,9,4,0,2,9,369
064901805,211,2,6,7,4,1,4,235
064901806,190,0,2,1,1,1,3,198
064901807,300,2,3,4,0,0,5,314
064901808,313,0,13,2,0,1,8,337
064901809,340,11,5,2,1,1,4,364
064901810,264,12,2,0,0,0,2,280
064901811,333,0,4,7,2,0,16,362
064901812,402,2,6,5,3,0,11,429
064901813,432,1,2,1,0,0,17,453
064901814,385,15,9,6,4,1,6,426
064901815,398,1,3,1,2,0,10,415
064901816,248,1,5,2,3,0,12,271
064901901,333,26,4,4,5,2,16,390
064901902,278,28,9,1,2,1,7,326
064901903,239,14,6,2,0,0,16,277
064901904,212,17,7,1,0,2,11,250
064901905,272,12,19,6,1,1,13,324
064901906,255,20,5,1,3,0,8,292
064901907,357,7,2,3,1,0,18,388
064901908,238,11,3,4,0,0,3,259
064901909,168,6,2,7,3,0,10,196
064901910,319,21,11,5,2,0,7,365
064901911,221,11,4,1,0,0,2,239
064901912,199,8,4,3,1,0,2,217
064902001,300,1,0,3,3,2,33,342
064902002,264,13,0,6,2,0,16,301
064902003,330,6,3,2,2,0,14,357
064902004,209,6,5,2,1,1,18,242
064902005,276,9,16,2,3,1,14,321
064902006,289,24,1,4,2,1,7,328
064902007,359,1,9,3,1,1,31,405
064902008,242,0,2,3,1,1,19,268
064902009,207,9,8,10,0,0,8,242
064902101,383,35,7,7,18,0,35,485
064902102,322,31,10,5,1,1,19,389
064902103,340,33,11,1,11,0,11,407
064902104,232,9,3,0,0,0,17,261
064902105,331,18,9,1,7,0,23,389
064902106,297,34,10,1,1,0,14,357
064902107,312,36,20,1,7,1,36,413
064902108,154,21,8,2,6,1,40,232
064902109,210,25,5,4,6,0,5,255
064902110,333,30,33,10,10,0,3,419
064902201,263,36,6,5,9,0,11,330
064902202,222,36,21,3,13,1,18,314
064902203,253,35,30,6,30,1,13,368
064902204,201,44,26,1,45,0,9,326
064902205,222,40,22,0,11,0,9,304
064902206,267,59,48,0,39,2,23,438
064902207,173,34,25,0,116,0,15,363
064902208,102,0,11,0,67,1,38,219
064902209,197,49,24,1,76,1,6,354
064902210,364,75,25,1,55,0,55,575
064902211,237,40,15,1,55,1,20,369
064902212,46,5,7,1,57,0,4,120
064902301,273,17,3,2,1,0,10,306
064902302,236,16,15,3,9,1,8,288
064902303,280,25,10,1,2,1,23,342
064902304,234,17,7,1,1,1,7,268
064902305,264,27,4,4,1,0,12,312
064902306,295,36,12,7,10,0,13,373
064902307,231,31,11,8,11,1,12,305
064902308,112,35,93,4,1,0,3,248
064902309,244,44,44,2,20,0,16,370
064902310,141,33,13,1,7,0,6,201
064902311,194,53,11,1,11,0,8,278
064902312,208,29,19,8,18,3,9,294
064902313,173,22,11,3,27,0,12,248
064902401,259,15,12,2,5,0,9,302
064902402,344,40,12,2,12,0,25,435
064902403,192,35,16,6,57,2,21,329
064902404,373,62,24,3,37,3,10,512
064902405,280,37,8,3,7,2,18,355
064902406,257,32,15,6,8,0,17,335
064902407,209,42,28,2,8,1,17,307
064902408,165,27,50,4,5,0,41,292
064902409,159,33,15,1,36,0,5,249
064902410,241,63,17,21,46,3,32,423
064902411,197,27,57,2,11,0,3,297
064902501,316,16,5,5,1,0,17,360
064902502,289,23,5,5,1,0,4,327
064902503,266,18,4,2,1,0,19,310
064902504,247,33,2,1,5,1,8,297
064902505,247,33,7,2,3,2,11,305
064902506,270,16,7,1,7,0,13,314
064902507,273,31,4,14,4,0,4,330
064902508,331,20,13,1,3,2,19,389
064902601,310,20,8,0,5,3,6,352
064902602,258,21,8,1,3,0,2,293
064902603,322,16,6,3,1,0,7,355
064902604,155,5,0,0,1,1,19,181
064902605,232,6,7,1,0,1,4,251
064902606,322,16,10,5,3,0,8,364
064902607,344,11,9,9,4,1,10,388
064902608,231,21,2,2,6,2,2,266
064902609,155,14,7,2,3,1,10,192
064902610,367,30,5,5,2,1,11,421
064902611,276,6,3,4,1,2,14,306
064902612,245,21,3,0,0,0,8,277
064902613,298,9,15,9,1,1,23,356
064902701,279,22,14,0,0,0,3,318
064902702,397,17,2,2,0,0,11,429
064902703,309,16,2,0,1,1,13,342
064902704,257,26,4,5,3,2,6,303
064902705,382,17,4,6,0,2,3,414
064902706,299,13,3,2,0,1,2,320
064902707,306,26,5,2,3,0,7,349
064902708,275,6,4,12,4,4,3,308
064902709,270,3,0,6,0,0,12,291
064902710,440,14,4,4,1,3,22,488
064902711,415,17,1,1,3,0,15,452
064902712,400,12,1,3,0,0,16,432
064902713,157,5,1,0,2,0,6,171
064902801,250,10,1,4,0,0,4,269
064902802,193,5,1,1,0,0,6,206
064902803,361,12,3,3,3,0,11,393
064902804,420,18,3,3,1,0,5,450
064902805,300,27,5,10,1,0,12,355
064902806,410,15,6,1,5,1,21,459
064902807,227,2,3,1,3,1,14,251
064902808,194,10,4,2,0,0,9,219
064902809,186,4,1,1,0,0,1,193
064902810,386,19,4,3,0,1,18,431
064902811,290,10,4,0,2,0,9,315
064902901,333,16,3,8,0,1,6,367
064902902,427,22,1,2,0,0,10,462
064902903,249,3,3,1,1,0,4,261
064902904,343,20,2,3,0,0,4,372
064902905,295,5,4,1,2,1,4,312
064902906,280,3,0,1,0,0,20,304
064902907,398,7,0,1,0,0,10,416
064902908,469,19,0,0,0,0,0,488
064902909,401,12,1,2,2,0,5,423
064902910,326,5,12,0,1,0,9,353
064902911,405,15,5,5,1,1,17,449
064903001,237,7,0,3,1,0,5,253
064903002,495,8,3,3,0,0,8,517
064903003,248,6,0,7,0,0,12,273
064903004,271,5,4,1,0,0,7,288
064903005,449,28,3,2,0,0,4,486
064903006,238,21,1,8,1,2,7,278
064903007,296,6,1,0,0,0,7,310
064903008,302,26,4,5,0,0,13,350
064903009,297,10,10,2,4,1,8,332
064903010,351,26,7,4,0,0,6,394
064903101,205,11,2,1,0,0,4,223
064903102,246,4,1,0,1,0,5,257
064903103,389,6,1,3,0,0,6,405
064903104,349,7,0,1,0,0,4,361
064903105,307,5,0,1,0,0,4,317
064903106,348,8,0,0,0,0,15,371
064903107,323,5,2,1,0,0,10,341
064903108,317,4,5,3,0,0,10,339
064903109,269,6,1,0,3,0,6,285
064903110,249,8,1,0,0,1,5,264
064903201,394,9,1,0,11,0,4,419
064903202,324,10,0,2,0,0,1,337
064903203,314,9,0,0,0,0,5,328
064903204,260,5,1,1,0,0,13,280
064903205,182,3,0,2,0,0,4,191
064903206,347,5,0,1,0,0,22,375
064903207,269,5,0,2,1,0,4,281
064903208,357,3,6,1,1,0,13,381
064903209,227,7,2,0,0,0,2,238
064903210,292,14,0,7,0,0,4,317
064903301,191,11,0,0,0,1,8,211
064903302,234,4,0,1,1,0,7,247
064903303,345,14,3,3,0,0,6,371
064903304,246,9,1,4,6,0,5,271
064903305,358,18,2,3,1,0,9,391
064903306,334,1,2,6,1,2,6,352
064903307,205,4,2,1,0,0,14,226
064903308,243,4,2,2,0,0,9,260
064903309,263,4,0,0,0,0,0,267
064903310,285,11,3,0,0,0,1,300
064903401,355,22,1,16,3,0,29,426
064903402,309,0,1,3,0,0,2,315
064903403,239,3,5,0,2,0,9,258
064903404,309,5,1,1,0,0,5,321
064903405,312,4,1,2,0,0,2,321
064903406,283,4,0,2,0,0,4,293
064903407,220,7,0,0,0,0,5,232
064903408,147,11,1,5,1,0,0,165
064903409,181,5,0,0,0,0,2,188
064903410,274,5,0,1,0,0,3,283
064903411,269,4,0,2,0,0,3,278
064903412,261,1,3,0,0,0,9,274
064903413,326,4,0,1,0,0,1,332
064903414,324,0,1,3,0,0,7,335
064903415,193,2,0,0,0,0,6,201
064903501,224,11,14,5,1,1,29,285
064903502,237,4,4,5,1,0,1,252
064903503,373,42,3,26,0,0,46,490
064903504,444,43,0,35,1,0,83,606
064903505,346,25,1,22,0,0,24,418
064903506,500,31,0,32,0,0,28,591
064903507,396,23,0,13,0,1,12,445
064903508,350,15,2,1,2,0,2,372
064903509,203,2,0,3,0,0,7,215
064903510,228,1,0,1,0,0,5,235
064903511,216,1,1,0,1,0,8,227
064903512,248,1,0,0,0,0,4,253
064903513,388,3,0,0,0,0,8,399
064903514,296,13,0,1,3,0,6,319
064903515,215,3,1,1,0,0,0,220
064903516,188,3,0,0,0,0,19,210
064903517,269,5,3,1,0,2,5,285
064903518,305,9,0,0,0,1,10,325
064903601,302,6,0,0,0,0,4,312
064903602,339,2,1,1,1,0,5,349
064903603,249,7,6,2,0,0,2,266
064903604,218,3,0,0,0,0,2,223
064903605,248,11,0,2,3,0,3,267
064903606,271,11,2,0,6,0,4,294
064903607,254,1,0,0,0,0,3,258
064903608,264,8,0,2,0,0,10,284
064903609,214,5,0,1,1,0,1,222
064903610,318,7,0,3,0,0,0,328
064903611,197,0,0,0,0,0,1,198
064903612,204,3,0,0,0,0,7,214
064903701,296,9,4,0,8,1,7,325
064903702,162,6,2,0,1,0,10,181
064903703,242,4,0,0,0,0,6,252
064903704,210,15,1,0,1,0,1,228
064903705,248,7,0,0,0,0,4,259
064903706,334,4,1,2,0,1,10,352
064903707,151,8,0,0,0,0,2,161
064903708,167,1,1,0,0,0,8,177
064903709,517,5,1,1,0,0,34,558
064903710,259,4,0,1,0,0,13,277
064903711,444,16,0,2,2,0,9,473
064903712,255,4,3,2,1,1,6,272
064903713,410,12,8,4,0,1,9,444
064903714,346,8,0,3,1,0,19,377
064903801,167,3,0,1,0,0,0,171
064903802,284,4,0,1,1,0,2,292
064903803,132,2,0,0,0,0,4,138
064903804,178,2,2,2,0,0,6,190
064903805,347,3,0,1,0,1,7,359
064903806,274,1,0,2,0,1,3,281
064903807,270,5,0,2,0,0,7,284
064903808,368,3,0,2,0,0,14,387
064903809,188,5,2,1,2,0,2,200
064903810,206,1,0,1,0,0,3,211
064903811,297,11,3,0,0,1,2,314
064903812,180,8,0,6,0,0,5,199
064903813,161,1,1,1,0,0,3,167
064903814,187,0,1,1,1,0,3,193
064903815,170,6,0,0,0,0,17,193
064903816,392,13,1,2,1,0,7,416
064903817,401,10,1,1,0,2,4,419
064903901,303,0,1,12,0,0,10,326
064903902,170,0,0,4,0,2,5,181
064903903,754,4,3,11,2,0,15,789
064903904,383,0,1,0,0,0,1,385
064903905,407,1,8,4,0,0,6,426
064903906,330,3,1,1,0,0,26,361
064903907,151,1,0,1,1,0,2,156
064903908,248,4,2,5,0,0,11,270
064903909,291,0,0,3,0,0,2,296
064903910,212,6,0,1,3,0,6,228
064903911,366,3,2,1,0,0,5,377
064903912,218,0,0,0,0,0,4,222
064903913,153,0,1,0,0,0,1,155
064903914,310,0,1,1,0,0,1,313
064903915,524,8,1,19,4,0,17,573
064903916,349,4,8,14,0,0,17,392
064904001,164,0,0,0,0,0,3,167
064904002,190,0,0,0,0,0,2,192
064904003,264,0,0,0,0,0,9,273
064904004,365,1,1,2,0,0,7,376
064904005,262,0,0,3,0,0,8,273
064904006,416,3,0,4,0,0,9,432
064904007,354,0,2,0,0,0,2,358
064904008,372,1,1,3,0,0,5,382
064904009,563,7,1,2,0,0,5,578
064904010,332,2,3,2,4,0,6,349
064904011,311,2,0,9,0,0,7,329
064904012,283,7,1,5,0,0,17,313
064904013,398,19,0,4,0,0,6,427
064904101,27,0,0,0,0,0,0,27
064904102,18,0,0,0,0,0,3,21
064904201,253,16,4,2,0,0,8,283
064904202,333,14,9,1,4,0,16,377
064904203,239,6,15,2,1,0,13,276
064904204,300,21,18,6,6,1,8,360
064904205,214,17,11,2,0,0,1,245
064904206,280,15,3,9,1,0,7,315
064904207,294,7,4,3,2,0,14,324
064904208,268,16,9,0,0,0,10,303
064904301,12,0,0,0,0,0,0,12
064904302,236,6,9,2,3,0,20,276
064904303,268,13,3,3,0,0,2,289
064904304,331,17,11,3,6,0,5,373
064904305,2,0,0,0,0,0,0,2
064904306,308,0,0,0,0,0,2,310
064904307,242,5,4,1,1,0,3,256
064904308,178,11,0,0,0,0,1,190
064904309,434,17,3,3,0,1,6,464
064904310,346,17,3,3,6,0,4,379
064904311,201,11,4,2,1,0,5,224
064904312,260,12,0,0,0,0,5,277
064904313,214,14,7,4,6,0,7,252
064904314,211,9,10,6,11,0,15,262
064904401,290,24,4,1,3,0,15,337
064904402,382,32,2,7,3,3,9,438
064904403,255,9,1,1,0,1,4,271
064904404,316,20,1,3,7,0,18,365
064904405,368,12,3,4,1,0,3,391
064904406,371,18,5,2,0,0,34,430
064904407,347,15,6,8,6,5,10,397
064904408,341,11,4,1,0,0,16,373
064904409,402,14,2,6,6,0,8,438
064904410,215,5,1,1,0,0,7,229
064904411,195,7,3,1,3,0,2,211
064904412,241,9,0,1,1,0,8,260
064904413,250,7,1,2,3,0,2,265
064904501,248,14,3,1,0,0,1,267
064904502,337,22,2,2,0,0,10,373
064904503,317,14,2,2,0,0,7,342
064904504,402,18,7,2,1,0,8,438
064904505,374,22,5,4,3,1,13,422
064904506,342,11,4,0,2,0,5,364
064904507,189,8,2,1,1,0,5,206
064904508,226,20,3,1,3,0,3,256
064904601,292,14,3,4,6,0,19,338
064904602,260,12,9,7,12,2,18,320
064904603,266,22,11,3,4,0,12,318
064904604,271,23,7,2,2,0,15,320
064904605,125,12,5,1,9,1,10,163
064904606,175,26,4,5,1,1,8,220
064904607,294,22,13,3,3,0,13,348
064904608,245,20,6,2,2,0,9,284
064904609,271,19,8,2,7,0,16,323
064904610,25,0,1,0,0,0,1,27
064904611,341,9,4,4,4,0,12,374
064904612,256,14,7,0,2,0,27,306
064904701,66,2,0,0,0,0,0,68
064904702,294,16,7,7,3,0,14,341
064904703,178,8,3,4,0,0,3,196
064904704,221,18,3,0,13,1,4,260
064904705,285,14,6,1,0,0,10,316
064904706,234,11,13,2,10,0,15,285
064904707,333,24,11,4,1,3,9,385
064904708,283,11,6,1,0,0,13,314
064904709,222,24,6,2,0,1,10,265
064904710,237,14,2,4,1,0,8,266
064904711,301,32,3,6,2,3,24,371
064904712,262,15,4,4,5,1,19,310
064904713,255,15,11,1,3,0,22,307
064904801,285,26,10,4,3,3,11,342
064904802,268,19,27,8,8,1,12,343
064904803,241,41,10,9,5,0,15,321
064904804,335,45,10,8,10,0,15,423
064904805,174,6,7,3,12,1,17,220
064904806,141,8,6,3,4,0,15,177
064904807,278,31,9,5,8,0,7,338
064904808,302,28,12,4,5,0,9,360
064904809,208,28,8,1,16,1,16,278
064904810,253,19,6,3,1,0,12,294
064904811,233,6,3,3,1,2,14,262
064904901,257,7,13,0,5,2,13,297
064904902,307,2,9,1,2,1,20,342
064904903,260,9,2,0,1,0,6,278
064904904,476,3,12,2,5,1,13,512
064904905,237,4,4,0,5,0,14,264
064904906,353,0,8,5,1,1,14,382
064904907,273,1,6,2,5,0,7,294
064904908,186,3,4,1,0,0,6,200
064904909,200,1,2,0,1,0,5,209
064904910,299,1,24,6,2,1,4,337
064904911,299,9,6,0,5,0,27,346
064905001,350,13,3,4,0,3,19,392
064905002,399,0,9,4,2,2,21,437
064905003,288,2,26,2,0,0,13,331
064905004,87,0,0,0,1,0,2,90
064905005,214,2,3,4,0,1,5,229
064905006,372,2,10,7,4,1,8,404
064905007,333,0,6,3,1,0,14,357
064905008,299,4,5,3,1,1,16,329
064905009,206,0,6,3,1,0,8,224
064905010,381,9,2,3,3,1,5,404
064905011,193,1,2,4,1,0,8,209
064905101,246,15,1,7,4,0,5,278
064905102,265,5,2,2,0,1,10,285
064905103,200,9,3,2,0,3,4,221
064905104,168,8,6,4,0,0,11,197
064905105,369,31,8,7,0,0,5,420
064905106,330,20,2,5,1,1,10,369
064905107,350,16,7,1,1,1,5,381
064905108,342,26,5,5,3,0,4,385
064905109,265,19,2,1,1,2,11,301
064905110,180,11,0,1,2,0,15,209
064905111,180,11,2,3,2,0,13,211
065150101,175,0,1,1,0,1,10,188
065150102,1,0,0,0,0,0,0,1
065150103,414,4,1,3,0,0,9,431
065150104,371,2,3,4,0,0,5,385
065150105,439,2,2,5,0,0,6,454
065150106,323,2,3,0,0,0,2,330
065150107,251,1,0,2,0,2,1,257
065150108,472,1,1,2,0,0,17,493
065150109,233,0,0,1,0,0,4,238
065150110,391,2,1,0,0,0,7,401
065150111,406,5,2,1,2,0,13,429
065150112,453,4,3,11,0,0,6,477
065150113,508,3,3,4,0,1,8,527
065150201,85,5,1,2,0,2,2,97
065150202,276,15,7,3,7,0,9,317
065150203,159,6,2,1,0,4,7,179
065150204,28,0,2,0,0,0,0,30
065150205,157,2,0,3,0,23,10,195
065150206,194,6,5,7,0,72,5,289
065150207,345,10,2,4,0,7,17,385
065150208,363,46,6,21,0,14,15,465
065150209,338,12,0,0,0,1,9,360
065150210,508,10,1,3,0,0,13,535
065150211,343,7,1,14,0,0,35,400
065150212,235,6,0,4,0,1,2,248
065150213,204,2,1,1,0,0,1,209
065150214,362,3,3,5,0,1,12,386
065150215,329,11,1,5,0,1,6,353
065150216,260,1,2,10,0,0,6,279
065150301,289,3,3,5,1,1,10,312
065150302,337,0,3,6,1,0,10,357
065150303,311,12,0,1,1,0,3,328
065150304,347,7,0,4,0,0,10,368
065150305,208,5,3,1,0,1,7,225
065150306,276,6,2,3,0,0,4,291
065150307,268,9,2,3,0,2,8,292
065150308,258,2,2,2,0,2,7,273
065150309,241,4,1,2,0,1,2,251
065150310,270,9,0,0,0,0,8,287
065150311,273,9,3,2,0,1,2,290
065150312,266,10,1,2,0,0,10,289
065150313,228,10,5,1,0,1,4,249
065150314,273,5,8,3,0,3,5,297
065150401,305,7,4,13,3,4,6,342
065150402,225,2,0,0,0,0,4,231
065150403,313,9,1,5,3,1,7,339
065150404,189,24,10,6,1,29,13,272
065150405,260,16,0,7,0,6,7,296
065150406,311,3,1,1,1,1,10,328
065150407,309,4,1,0,0,0,1,315
065150408,304,11,1,1,0,0,4,321
065150409,285,8,2,1,0,0,1,297
065150410,269,5,0,1,0,0,1,276
065150411,156,4,0,1,0,0,6,167
065150501,212,1,0,0,0,0,1,214
065150502,234,2,0,2,0,1,2,241
065150503,364,0,1,3,1,3,5,377
065150504,382,1,2,2,1,1,3,392
065150505,287,0,11,1,3,1,5,308
065150506,352,1,14,6,3,1,7,384
065150507,327,2,3,0,0,0,9,341
065150508,206,1,1,2,0,2,2,214
065150509,307,2,3,6,1,0,6,325
065150510,93,0,0,0,0,1,2,96
065150511,405,3,8,15,1,5,25,462
065150512,442,4,6,4,3,5,13,477
065150601,225,1,2,3,0,1,0,232
065150602,325,11,9,0,1,2,18,366
065150603,190,11,3,0,0,1,11,216
065150604,269,4,4,2,1,0,1,281
065150605,158,2,0,2,0,1,1,164
065150606,337,19,0,1,2,0,5,364
065150607,353,11,5,4,0,0,5,378
065150608,260,9,2,2,1,1,5,280
065150609,383,8,4,2,0,1,12,410
065150610,234,12,1,3,2,1,10,263
065150611,203,2,8,1,0,0,2,216
065150612,214,11,2,5,0,1,6,239
065150613,166,5,1,1,0,0,9,182
065150614,221,12,4,0,0,2,12,251
065150615,217,14,1,0,0,0,7,239
065150616,273,11,1,2,2,0,4,293
065150701,465,4,6,11,3,3,14,506
065150702,315,6,4,1,0,2,9,337
065150703,249,6,0,1,4,0,4,264
065150704,450,9,1,1,1,0,8,470
065150705,249,3,1,1,0,0,2,256
065150706,336,8,2,1,0,1,2,350
065150707,368,11,3,3,1,1,3,390
065150708,318,8,1,9,0,1,1,338
065150709,407,8,3,6,0,1,4,429
065150710,205,0,3,2,0,1,4,215
065150711,140,1,0,0,0,0,5,146
065150712,402,12,2,2,0,0,13,431
065150713,229,18,2,2,2,2,6,261
065150714,207,7,5,0,1,0,1,221
065150801,320,19,2,2,0,5,17,365
065150802,280,10,4,6,1,3,6,310
065150803,283,4,1,5,0,2,4,299
065150804,230,3,0,2,0,0,7,242
065150805,218,13,1,1,1,0,2,236
065150806,219,3,1,1,0,1,4,229
065150807,340,16,2,2,0,0,6,366
065150808,360,31,5,4,2,0,7,409
065150809,323,2,12,3,0,0,12,352
065150810,291,9,1,1,0,0,1,303
065150811,313,8,1,1,1,0,3,327
065150812,295,27,3,3,3,1,15,347
065150901,240,14,3,6,0,2,9,274
065150902,367,25,6,5,0,0,10,413
065150903,254,6,2,4,0,6,7,279
065150904,231,3,0,2,0,1,2,239
065150905,403,13,2,3,1,0,4,426
065150906,256,0,5,1,2,1,10,275
065150907,208,12,2,1,2,0,7,232
065150908,238,1,0,0,2,4,6,251
065150909,387,6,5,3,0,0,7,408
065150910,397,25,3,5,2,1,5,438
065150911,285,13,2,2,3,4,4,313
065150912,334,4,6,1,0,0,5,350
065150913,407,7,1,0,0,0,5,420
065150914,300,8,4,0,0,1,1,314
065151001,241,15,0,1,1,0,2,260
065151002,436,13,1,1,0,0,8,459
065151003,382,20,1,2,1,0,7,413
065151004,261,13,3,1,5,1,11,295
065151005,272,13,8,4,5,13,8,323
065151006,320,11,2,2,0,19,10,364
065151007,77,5,3,2,0,92,7,186
065151008,354,25,2,2,0,19,13,415
065151009,308,6,1,0,2,0,4,321
065151010,211,17,1,0,0,5,4,238
065151011,229,7,0,1,0,0,1,238
065151012,155,6,1,1,0,0,3,166
065151013,299,4,4,0,0,1,9,317
065151014,322,10,1,3,0,0,2,338
065151015,290,6,3,0,0,0,5,304
065151101,348,14,1,4,5,1,17,390
065151102,397,7,35,8,12,2,28,489
065151103,351,15,2,3,1,0,9,381
065151104,207,0,1,2,0,0,13,223
065151105,213,0,0,3,0,0,15,231
065151106,223,20,3,0,0,2,1,249
065151107,245,12,2,2,0,3,6,270
065151108,216,6,3,3,0,2,7,237
065151109,326,10,3,3,0,0,14,356
065151110,358,10,7,1,0,0,6,382
065151111,229,3,0,1,0,2,5,240
065151112,221,4,0,1,0,0,9,235
065151113,270,7,1,1,0,1,18,298
065151201,210,6,2,3,1,0,3,225
065151202,235,15,3,9,0,2,7,271
065151203,221,7,0,0,0,0,1,229
065151204,176,3,1,1,0,0,4,185
065151205,255,7,1,1,3,0,8,275
065151206,269,3,6,3,0,0,7,288
065151207,376,5,5,6,6,1,10,409
065151208,181,11,1,2,0,1,2,198
065151209,400,8,7,3,0,1,9,428
065151210,238,0,2,0,0,0,4,244
065151211,249,6,0,3,1,1,6,266
065151212,293,0,4,1,0,0,5,303
065151213,206,0,0,1,0,0,3,210
065151214,274,2,0,3,0,1,0,280
065151215,238,1,1,2,0,0,3,245
065151216,242,8,0,0,1,0,3,254
065151217,189,5,0,0,0,0,1,195
065151301,294,7,0,3,0,0,8,312
065151302,320,8,1,1,0,1,3,334
065151303,173,8,0,1,0,1,1,184
065151304,290,10,1,2,0,0,6,309
065151305,463,3,7,1,4,0,40,518
065151306,424,28,4,7,3,0,7,473
065151307,253,21,0,3,1,1,18,297
065151308,292,15,4,3,0,0,5,319
065151309,435,16,2,1,6,2,2,464
065151310,367,14,7,3,1,0,5,397
065151311,427,33,1,1,0,0,1,463
065151312,329,4,1,1,0,0,2,337
065151313,310,20,2,1,1,0,5,339
065151314,258,6,4,3,0,0,3,274
065151401,273,3,4,0,0,0,6,286
065151402,257,7,0,0,0,0,6,270
065151403,327,2,1,2,0,0,5,337
065151404,414,15,3,3,0,0,8,443
065151405,147,2,0,1,0,0,2,152
065151406,231,2,0,1,0,0,2,236
065151407,193,4,1,1,0,0,8,207
065151408,412,6,2,4,0,2,9,435
065151409,232,7,0,0,0,0,1,240
065151410,378,13,0,1,0,0,4,396
065151411,251,2,0,1,0,0,10,264
065151501,398,22,2,3,1,2,3,431
065151502,271,5,0,4,0,4,6,290
065151503,310,13,2,4,0,1,3,333
065151504,342,15,5,9,2,12,1,386
065151505,288,2,1,0,0,0,13,304
065151506,340,11,0,3,0,1,6,361
065151507,356,7,1,4,2,1,4,375
065151508,348,4,0,4,0,1,5,362
065151509,329,3,1,2,1,2,3,341
065151510,335,4,2,0,0,0,2,343
065151511,234,2,1,4,0,0,8,249
065151512,265,14,0,5,0,1,3,288
065151513,333,15,2,3,0,0,11,364
065151601,283,19,8,3,0,10,10,333
065151602,277,27,2,2,6,2,7,323
065151603,230,11,2,6,0,15,9,273
065151604,202,3,0,0,0,0,14,219
065151605,219,14,4,5,4,1,7,254
065151606,277,4,7,4,1,41,5,339
065151607,367,28,1,12,1,4,5,418
065151608,353,24,6,1,0,11,12,407
065151609,253,21,5,11,2,6,1,299
065151701,351,21,1,8,1,5,21,408
065151702,341,22,4,10,0,15,15,407
065151703,183,2,3,2,2,13,12,217
065151704,172,25,3,7,2,37,22,268
065151705,203,16,7,11,0,57,16,310
065151706,365,23,2,10,0,4,193,597
065151707,287,28,2,11,0,16,17,361
065151708,133,11,1,13,0,14,4,176
065151709,113,14,2,1,3,10,9,152
065151710,315,9,8,2,0,6,20,360
065151801,439,9,1,0,0,0,9,458
065151802,267,11,0,3,0,1,4,286
065151803,382,10,0,0,0,0,6,398
065151804,342,8,2,2,0,1,4,359
065151805,269,11,0,1,0,1,1,283
065151806,334,2,0,2,0,0,7,345
065151807,280,2,0,3,0,0,1,286
065151808,277,8,0,0,1,0,1,287
065151809,156,6,0,2,0,1,1,166
065151810,243,8,0,2,0,0,11,264
065151811,216,0,0,0,0,0,2,218
065151812,342,2,4,0,0,0,10,358
065151813,319,26,4,8,1,2,1,361
065151901,412,14,9,5,1,1,12,454
065151902,280,4,3,2,0,0,0,289
065151903,400,13,1,24,0,1,11,450
065151904,363,8,0,2,0,0,11,384
065151905,261,3,1,0,0,0,6,271
065151906,229,2,0,1,0,0,1,233
065151907,488,8,3,2,0,0,3,504
065151908,347,8,2,3,0,1,2,363
065151909,301,15,2,9,1,0,8,336
065151910,421,5,1,4,0,2,1,434
065151911,465,12,7,2,0,0,7,493
065151912,216,21,2,2,0,0,3,244
065151913,146,9,3,0,1,4,0,163
065151914,171,4,0,0,0,0,1,176
065152001,460,8,2,0,0,3,1,474
065152002,234,9,2,3,0,0,4,252
065152003,258,4,0,4,0,0,7,273
065152004,216,1,1,1,0,0,5,224
065152005,269,1,0,0,0,0,1,271
065152006,210,5,7,0,0,0,6,228
065152007,237,3,0,2,0,0,7,249
065152008,309,5,1,6,0,0,6,327
065152009,270,6,0,3,0,0,4,283
065152010,418,15,1,2,0,1,7,444
065152011,220,6,0,0,0,0,8,234
065152012,221,4,3,2,0,1,2,233
065152013,331,9,1,4,0,2,6,353
065152014,427,7,1,0,0,0,9,444
065152015,368,25,6,0,0,0,3,402
065152101,100,28,3,1,1,60,6,199
065152102,133,25,0,4,0,20,25,207
065152103,184,7,5,8,5,11,16,236
065152104,201,15,0,2,0,5,11,234
065152105,229,9,0,4,0,5,12,259
065152106,247,13,3,1,0,0,5,269
065152107,194,11,1,0,1,1,3,211
065152108,244,0,1,2,0,0,6,253
065152109,331,12,0,1,0,0,9,353
065152110,302,14,2,1,1,3,3,326
065152111,294,6,10,2,4,1,5,322
065152112,233,0,7,9,0,4,4,257
065152113,290,20,0,7,0,4,5,326
065152114,214,7,0,2,1,4,1,229
065152115,188,1,6,21,0,2,6,224
065390101,350,20,4,4,2,10,17,407
065390102,337,10,1,8,0,0,4,360
065390103,245,7,1,4,0,0,2,259
065390104,280,4,1,3,0,3,15,306
065390105,374,14,5,4,8,1,10,416
065390106,337,15,0,2,0,3,5,362
065390107,261,2,0,2,0,0,2,267
065390108,286,2,2,4,0,0,23,317
065390109,233,3,1,0,1,0,3,241
065390110,223,7,1,1,0,0,1,233
065390111,347,8,4,2,0,1,9,371
065390112,258,6,3,1,3,1,5,277
065390113,231,14,0,1,0,0,3,249
065390114,350,21,6,6,1,2,13,399
065390201,221,16,1,2,0,1,6,247
065390202,208,4,0,1,0,1,9,223
065390203,262,10,0,4,1,1,2,280
065390204,420,37,4,5,1,1,15,483
065390205,246,7,1,3,0,0,6,263
065390206,406,22,9,2,0,1,16,456
065390207,350,5,2,2,1,0,10,370
065390208,375,34,10,4,0,1,18,442
065390209,199,22,2,0,2,0,5,230
065390210,219,9,1,0,1,2,19,251
065390211,270,25,5,3,1,3,3,310
065390212,238,10,12,4,2,3,1,270
065390213,255,6,3,0,0,1,4,269
065390214,218,9,0,3,0,6,10,246
065390301,297,16,7,0,0,0,7,327
065390302,311,34,3,1,0,0,5,354
065390303,277,9,0,0,0,3,7,296
065390304,298,8,2,3,0,0,5,316
065390305,316,47,14,2,4,0,12,395
065390306,273,29,12,4,2,1,6,327
065390307,331,41,18,2,2,1,9,404
065390308,184,23,2,0,1,1,5,216
065390309,265,8,2,4,1,2,16,298
065390310,426,12,6,8,0,3,13,468
065390311,403,25,9,9,4,4,12,466
065390401,414,20,10,7,2,4,15,472
065390402,446,4,11,5,2,5,17,490
065390403,386,3,5,6,0,0,14,414
065390404,434,2,3,2,0,0,6,447
065390405,283,1,1,6,0,2,5,298
065390406,441,4,9,3,1,3,15,476
065390407,183,2,6,4,44,3,7,249
065390408,375,2,4,2,2,3,18,406
065390409,422,2,9,4,1,3,21,462
065390410,252,4,5,0,5,2,16,284
065390411,334,3,8,4,1,2,17,369
065390412,265,1,2,7,0,0,10,285
065390413,216,0,5,3,2,0,26,252
065390414,174,1,6,2,2,1,3,189
065390501,272,5,6,5,0,1,3,292
065390502,393,7,12,8,0,6,17,443
065390503,427,5,4,5,0,0,13,454
065390504,321,4,3,5,0,0,8,341
065390505,258,1,4,0,0,1,5,269
065390506,262,1,1,3,1,1,2,271
065390507,390,0,2,9,0,1,12,414
065390508,341,4,7,3,1,0,3,359
065390509,410,6,4,3,0,1,15,439
065390601,405,3,5,0,1,0,10,424
065390602,230,0,9,5,1,8,8,261
065390603,257,0,1,1,0,0,0,259
065390604,241,1,2,0,0,0,5,249
065390605,207,0,6,0,2,2,14,231
065390606,371,0,2,1,3,2,27,406
065390607,438,1,7,4,2,0,6,458
065390608,315,1,2,6,3,0,10,337
065390609,278,4,4,4,0,0,4,294
065390701,378,25,6,7,1,1,5,423
065390702,302,14,6,5,2,0,15,344
065390703,407,31,8,5,3,0,10,464
065390704,472,16,3,3,2,0,6,502
065390705,316,11,0,3,0,0,12,342
065390706,313,12,1,2,2,0,5,335
065390707,187,8,1,0,1,0,5,202
065390708,289,9,0,2,0,1,8,309
065390709,436,23,7,3,1,2,19,491
065390801,207,9,1,3,3,0,4,227
065390802,279,1,5,1,12,2,10,310
065390803,359,2,5,3,1,0,7,377
065390804,253,5,3,1,0,0,4,266
065390805,374,10,2,2,0,0,5,393
065390806,245,10,1,1,0,1,7,265
065390807,253,2,3,1,0,0,4,263
065390808,457,18,3,2,1,0,7,488
065390809,330,2,1,4,1,1,1,340
065390810,288,1,3,5,0,0,7,304
065390811,250,4,2,1,0,0,4,261
065390812,711,11,7,2,0,1,17,749
065390813,309,8,0,4,0,0,4,325
065390814,295,11,3,1,0,1,5,316
065390815,289,1,0,1,0,0,1,292
065390901,14,0,0,0,0,0,2,16
065390902,148,2,0,1,0,0,2,153
065390903,258,7,1,1,1,0,1,269
065390904,332,1,3,1,0,2,3,342
065390905,344,9,2,3,0,0,1,359
065390906,386,4,1,2,0,0,7,400
065390907,493,8,2,5,2,0,8,518
065390908,407,11,2,2,0,0,2,424
065390909,85,1,1,1,0,0,1,89
065390910,376,4,2,2,1,2,6,393
065390911,130,0,0,0,0,0,3,133
065390912,320,9,1,3,0,0,3,336
065391001,323,8,0,4,0,1,3,339
065391002,336,3,1,2,0,0,9,351
065391003,315,3,3,4,2,0,4,331
065391004,270,12,3,0,0,0,6,291
065391005,213,4,2,2,0,0,11,232
065391006,242,6,3,0,0,0,3,254
065391007,653,30,2,3,1,0,21,710
065391008,490,5,0,2,0,0,4,501
065391009,385,14,0,5,0,0,11,415
065391010,430,17,7,1,1,1,5,462
065391011,409,16,5,2,0,0,2,434
065391012,461,14,6,5,2,0,6,494
065391013,382,7,3,2,0,0,3,397
065391014,363,5,3,3,0,1,6,381
065391015,256,4,1,2,1,2,1,267
065391016,433,14,7,7,1,3,82,547
065391017,98,3,0,5,0,52,3,161
065391101,279,15,4,8,3,0,5,314
065391102,395,13,1,7,1,0,5,422
065391103,273,16,0,0,0,1,2,292
065391104,293,16,5,5,1,0,4,324
065391105,256,3,1,1,0,0,1,262
065391106,220,7,1,9,0,1,9,247
065391107,486,26,3,2,0,1,6,524
065391108,403,5,0,0,0,0,12,420
065391109,330,6,3,13,1,1,13,367
065391110,343,7,1,0,0,0,3,354
065391111,339,8,5,2,1,1,6,362
065391112,226,0,3,9,0,1,2,241
065391113,287,17,0,0,0,0,4,308
065391114,382,3,1,3,1,0,5,395
065391115,366,22,3,6,1,6,5,409
065391116,359,4,2,6,1,2,8,382
065391201,317,9,1,5,1,0,1,334
065391202,281,11,1,1,1,0,3,298
065391203,301,8,0,3,0,0,6,318
065391204,464,9,4,4,1,1,6,489
065391205,296,5,1,10,0,0,6,318
065391206,323,6,7,1,1,3,8,349
065391207,311,8,5,4,1,0,3,332
065391208,370,13,4,8,0,2,9,406
065391209,297,12,0,0,1,0,13,323
065391210,317,5,0,5,0,1,4,332
065391211,293,13,1,2,0,0,3,312
065391212,375,14,1,2,0,1,2,395
065391213,283,2,1,1,0,0,1,288
065391214,290,8,0,4,2,0,8,312
065391215,252,4,2,0,1,2,3,264
065391301,455,7,3,5,5,2,16,493
065391302,270,1,0,2,0,1,8,282
065391303,270,0,3,2,0,4,11,290
065391304,362,14,2,2,0,0,2,382
065391305,264,7,1,0,0,0,1,273
065391306,313,5,2,1,0,0,1,322
065391307,291,9,3,1,1,1,14,320
065391308,334,15,3,3,1,1,11,368
065391309,201,5,0,1,0,2,2,211
065391401,340,23,10,10,4,2,7,396
065391402,187,16,4,3,0,0,4,214
065391403,298,21,10,1,1,1,15,347
065391404,216,16,2,6,2,1,13,256
065391405,218,17,5,4,1,0,7,252
065391406,394,6,11,1,1,1,10,424
065391407,436,14,2,2,0,3,6,463
065391408,290,10,3,4,0,0,3,310
065391409,433,15,6,3,1,3,9,470
065391410,249,5,8,6,0,1,12,281
065391411,257,18,5,3,0,0,6,289
065391412,233,18,2,3,0,0,3,259
065391413,242,3,0,3,0,0,1,249
065391414,251,11,2,0,0,0,10,274
065391415,250,8,4,2,1,2,6,273
065391416,256,16,1,2,1,2,3,281
065391501,228,14,8,2,0,2,17,271
065391502,247,20,16,7,3,3,39,335
065391503,194,11,8,1,3,4,3,224
065391504,375,34,19,18,42,0,14,502
065391505,152,22,13,2,34,0,15,238
065391506,241,12,11,1,6,1,22,294
065391507,306,41,46,3,9,0,10,415
065391508,241,23,14,9,3,0,8,298
065391509,245,5,1,0,2,0,10,263
065391510,206,16,1,2,0,1,6,232
065391511,277,6,1,2,1,1,15,303
065391601,234,17,4,3,0,0,2,260
065391602,397,8,9,3,0,1,16,434
065391603,181,12,3,7,1,1,7,212
065391604,186,21,22,3,6,1,4,243
065391605,200,15,37,24,57,2,24,359
065391606,295,53,27,20,49,1,35,480
065391607,400,21,5,4,4,1,10,445
065391608,210,19,7,4,4,0,10,254
065391609,197,9,7,3,2,0,5,223
065391610,300,24,10,3,1,2,7,347
065391611,338,27,24,12,3,2,14,420
065391701,288,5,0,0,0,2,12,307
065391702,274,6,3,3,3,6,2,297
065391703,275,8,3,0,0,1,11,298
065391704,222,13,3,2,0,0,14,254
065391705,342,11,1,10,0,1,4,369
065391706,255,7,0,2,0,0,4,268
065391707,224,1,0,0,0,0,1,226
065391708,236,13,3,6,0,1,4,263
065391709,165,10,5,3,1,0,12,196
065391710,273,7,5,3,0,0,6,294
065391711,226,11,2,1,0,1,3,244
065391712,239,17,1,1,0,0,10,268
065391713,257,15,6,4,1,0,10,293
065391714,210,6,2,0,0,0,0,218
065391715,219,11,0,3,3,0,7,243
065391716,186,17,9,2,6,1,7,228
065391717,216,12,11,4,3,0,16,262
065391801,316,27,2,1,0,0,2,348
065391802,258,13,7,13,1,11,5,308
065391803,351,4,0,2,0,0,12,369
065391804,290,17,11,5,0,1,18,342
065391805,344,8,6,1,0,2,8,369
065391806,371,12,4,2,1,0,6,396
065391807,397,8,1,6,0,0,3,415
065391808,368,6,0,2,0,0,7,383
065391809,339,14,2,3,0,1,6,365
065391901,306,5,2,0,0,1,3,317
065391902,334,0,1,1,0,1,3,340
065391903,293,0,1,5,2,1,10,312
065391904,280,2,4,3,1,12,3,305
065391905,320,1,9,6,0,3,10,349
065391906,241,0,5,6,0,1,4,257
065391907,262,9,1,1,0,2,7,282
065391908,272,1,0,2,0,0,6,281
065391909,280,0,8,4,1,0,7,300
065392001,224,2,4,2,0,0,3,235
065392002,12,0,1,0,1,0,2,16
065392003,275,3,4,2,0,1,6,291
065392004,260,0,0,2,0,0,8,270
065392005,283,1,0,3,0,0,0,287
065392006,321,8,3,2,0,0,3,337
065392007,210,1,4,3,1,0,7,226
065392008,427,5,4,5,2,0,5,448
065392009,401,3,5,6,1,10,5,431
065392010,387,0,1,1,3,0,5,397
065392011,372,3,1,6,0,0,4,386
065392012,400,6,5,7,0,1,5,424
065392013,241,4,1,4,0,0,0,250
065392014,245,0,3,4,0,0,1,253
065392101,264,21,3,2,0,0,3,293
065392102,228,10,5,4,0,2,4,253
065392103,366,41,9,3,3,1,19,442
065392104,432,11,8,6,4,2,24,487
065392105,233,10,4,2,1,1,5,256
065392106,256,14,9,1,1,0,2,283
065392107,278,18,5,1,2,0,8,312
065392108,228,6,6,2,3,0,7,252
065392201,447,19,9,5,0,1,8,489
065392202,477,6,1,3,5,0,11,503
065392203,431,24,9,1,1,0,4,470
065392204,335,19,4,4,1,0,1,364
065392205,405,24,2,6,1,1,10,449
065392206,402,23,6,4,2,0,18,455
065392207,415,17,0,1,0,0,3,436
065392208,430,15,2,4,0,1,6,458
065392301,268,8,1,2,0,1,11,291
065392302,340,7,2,0,0,0,7,356
065392303,300,5,0,2,0,0,4,311
065392304,245,4,3,6,1,1,3,263
065392305,390,12,1,4,0,0,8,415
065392306,365,10,7,6,1,4,4,397
065392307,260,3,1,0,0,0,3,267
065392308,301,8,2,2,0,0,6,319
065392309,326,8,2,1,0,0,4,341
065392310,291,9,0,3,0,0,11,314
065392311,331,6,2,2,0,2,7,350
065392312,366,3,0,3,0,2,1,375
065392313,307,4,1,1,0,1,3,317
065392314,270,11,0,2,1,1,6,291
065392401,443,22,7,8,2,1,5,488
065392402,277,3,1,4,0,0,7,292
065392403,212,9,2,1,6,0,7,237
065392404,379,5,0,3,0,1,3,391
065392405,279,3,0,1,2,0,7,292
065392406,270,9,3,1,0,1,13,297
065392407,225,6,3,3,2,0,4,243
065392408,191,6,1,1,1,0,6,206
065392409,195,2,1,0,0,0,6,204
065392410,208,2,1,3,0,0,1,215
065392411,272,6,2,4,0,1,9,294
065392412,226,3,0,1,0,0,1,231
065392413,242,2,1,0,1,0,1,247
065392414,381,8,1,0,0,0,6,396
065392415,432,6,3,2,0,0,2,445
065392501,442,14,5,4,0,0,10,475
065392502,283,8,2,2,0,0,8,303
065392503,434,8,2,1,0,0,8,453
065392504,242,10,2,3,1,1,7,266
065392505,255,11,0,8,3,0,6,283
065392506,266,4,1,1,0,0,1,273
065392507,320,7,3,13,1,0,9,353
065392508,378,8,5,3,0,0,5,399
065392509,373,9,1,7,0,0,11,401
065392510,336,9,1,1,0,0,5,352
065392511,255,2,1,2,0,0,7,267
065392512,210,8,0,1,0,0,4,223
065392601,415,19,4,2,0,3,8,451
065392602,446,26,2,6,0,2,7,489
065392603,257,5,1,5,0,0,3,271
065392604,248,6,4,2,0,0,3,263
065392605,332,11,4,3,0,2,6,358
065392606,325,9,1,3,1,0,4,343
065392607,451,8,2,8,0,1,7,477
065392608,391,4,2,1,1,0,7,406
065392609,331,2,2,1,0,1,9,346
065392610,324,13,4,0,0,0,2,343
065392611,281,9,2,6,0,0,18,316
065392612,372,13,1,2,0,3,5,396
065392613,196,4,3,1,0,0,2,206
065392614,236,6,1,0,0,0,5,248
065392701,377,1,0,1,0,0,12,391
065392702,331,3,0,3,0,0,2,339
065392703,375,3,2,12,0,2,17,411
065392704,314,3,0,2,0,0,2,321
065392705,288,5,2,3,3,1,8,310
065392706,358,4,4,4,0,0,4,374
065392707,332,7,5,6,0,0,14,364
065392708,370,0,0,0,0,0,1,371
065392709,309,0,0,0,0,0,5,314
065392710,281,4,0,0,2,1,4,292
065392711,306,4,0,0,0,0,3,313
065392712,373,0,0,1,0,0,8,382
065392801,242,8,0,4,0,1,1,256
065392802,312,8,1,0,0,0,6,327
065392803,294,3,0,2,0,0,9,308
065392804,369,13,2,2,0,1,5,392
065392805,330,8,0,1,0,0,3,342
065392806,402,12,1,3,0,0,5,423
065392807,335,5,3,2,0,0,14,359
065392808,406,12,1,7,1,0,14,441
065392809,290,8,2,2,0,0,5,307
065392810,397,4,0,0,0,0,0,401
065392811,382,15,3,9,1,1,4,415
065392812,284,3,0,3,0,2,9,301
065392901,37,13,0,0,0,1,2,53
065392902,48,14,0,0,0,0,2,64
065392903,71,0,0,0,0,0,3,74
065392904,70,4,0,3,0,4,5,86
065392905,86,9,1,0,0,5,1,102
065392906,135,4,2,1,0,1,2,145
065392907,140,13,1,1,0,7,10,172
065392908,99,11,0,3,0,2,1,116
065392909,129,8,2,3,0,1,4,147
065392910,37,2,0,0,0,2,5,46
065392911,180,4,1,5,0,3,8,201
065392912,66,5,2,4,0,5,8,90
065392913,20,11,0,1,0,0,0,32
065392914,212,24,2,0,0,1,2,241
065392915,128,4,0,0,0,0,6,138
065392916,375,21,0,5,0,3,16,420
065392917,18,0,0,0,0,0,0,18
065392918,238,8,3,3,0,0,4,256
065392919,203,2,3,4,0,0,7,219
065392920,412,15,0,1,0,0,10,438
065392921,300,10,2,5,0,0,5,322
065392922,333,11,0,5,0,4,2,355
065392923,294,12,3,3,0,2,6,320
065392924,388,9,3,4,0,1,4,409
065392925,249,7,3,1,0,0,16,276
065393001,444,17,1,5,0,1,11,479
065393002,410,19,1,5,0,3,5,443
065393003,289,12,4,0,0,0,7,312
065393004,388,20,1,4,0,1,7,421
065393005,295,15,0,5,1,0,9,325
065393006,204,4,2,11,0,2,3,226
065393007,195,8,4,1,0,2,2,212
065393008,224,7,4,1,0,1,10,247
065393009,360,16,2,3,0,4,10,395
065393010,304,11,4,5,2,2,8,336
065393011,319,13,5,2,0,0,1,340
065393012,262,5,3,3,0,3,14,290
065393013,351,5,2,4,0,0,16,378
065393014,374,27,0,11,1,1,5,419
065393015,304,9,3,4,0,2,4,326
065393016,327,11,4,7,0,3,10,362
065393101,334,18,3,3,3,1,15,377
065393102,385,10,4,4,0,0,14,417
065393103,337,18,1,2,0,10,5,373
065393104,446,15,0,7,0,4,10,482
065393105,306,17,5,6,0,5,11,350
065393106,400,6,1,6,1,5,12,431
065393107,438,23,0,5,0,2,6,474
065393108,278,3,0,2,0,3,3,289
065393109,323,7,0,7,0,0,5,342
065393110,364,11,1,7,0,0,7,390
065393111,378,18,6,1,1,0,0,404
065393112,358,31,6,3,3,1,9,411
065393113,321,7,2,4,0,5,15,354
065393114,203,12,2,3,0,0,3,223
065393115,282,15,3,10,0,0,4,314
065393116,363,14,3,4,0,1,7,392
065393117,367,20,1,6,0,2,5,401
065393201,346,5,1,8,0,0,6,366
065393202,305,6,0,1,0,0,6,318
065393203,347,4,0,1,0,0,7,359
065393204,254,8,0,7,0,0,9,278
065393205,327,9,2,5,1,0,4,348
065393206,359,7,0,5,0,0,10,381
065393207,294,11,1,6,0,0,4,316
065393208,313,18,0,3,0,2,5,341
065393209,212,6,0,3,0,0,5,226
065393210,256,0,2,6,0,0,2,266
065393211,364,13,2,1,0,0,13,393
065393212,44,1,0,2,0,2,3,52
065393213,206,5,1,1,0,2,3,218
065393214,259,13,2,7,0,0,14,295
065393215,384,18,10,11,0,2,7,432
065393301,320,18,1,2,1,0,6,348
065393302,237,8,6,1,1,1,10,264
065393303,269,14,3,3,0,1,8,298
065393304,218,3,1,3,1,0,10,236
065393305,188,3,0,0,0,0,1,192
065393306,245,8,2,3,0,11,16,285
065393307,397,16,1,5,0,1,11,431
065393308,379,8,3,5,2,3,11,411
065393309,422,20,1,6,0,0,6,455
065393310,274,14,5,7,2,1,6,309
065393311,142,6,1,4,1,0,8,162
065393312,325,19,4,3,3,6,10,370
065393313,366,12,1,11,0,8,11,409
065393314,183,12,3,1,0,0,4,203
065393315,146,2,0,2,0,1,0,151
065393316,10,0,0,0,0,1,7,18
065393401,291,11,4,8,0,0,2,316
065393402,303,4,1,0,0,1,9,318
065393403,303,4,0,2,0,1,22,332
065393404,294,9,1,1,0,0,6,311
065393405,331,12,1,5,2,1,6,358
065393406,272,12,0,3,0,0,7,294
065393407,329,2,2,3,0,0,4,340
065393408,346,12,5,5,1,2,4,375
065393409,354,4,1,2,0,0,3,364
065393410,296,4,4,4,0,8,9,325
065393411,268,13,1,4,0,3,2,291
065393412,275,11,2,6,0,2,6,302
065393413,343,12,5,17,1,2,18,398
065393414,403,18,1,4,1,2,5,434
065393415,256,20,7,2,0,8,8,301
065393416,45,3,0,0,0,1,7,56
065393417,279,11,2,2,1,0,1,296
065393418,202,1,2,0,0,1,3,209
065600101,347,5,1,2,1,2,4,362
065600102,348,19,0,0,1,1,5,374
065600103,342,7,3,1,1,1,5,360
065600104,313,3,3,6,0,1,5,331
065600105,439,8,2,7,1,1,14,472
065600106,235,13,0,0,0,0,2,250
065600107,251,3,1,0,0,0,5,260
065600108,339,4,0,1,0,0,5,349
065600109,337,24,2,5,0,0,9,377
065600110,342,8,1,4,1,0,15,371
065600111,305,8,0,6,1,0,5,325
065600112,296,10,0,0,0,1,7,314
065600113,271,18,1,0,0,2,4,296
065600114,418,11,0,3,0,0,9,441
065600115,268,15,5,6,0,2,11,307
065600201,370,10,3,3,1,0,5,392
065600202,394,5,2,2,0,0,14,417
065600203,355,5,0,1,2,0,6,369
065600204,428,5,0,1,0,0,4,438
065600205,333,8,2,2,0,0,4,349
065600206,380,10,2,8,1,0,9,410
065600207,341,19,3,6,0,0,1,370
065600208,386,1,1,2,0,0,8,398
065600209,388,3,0,1,0,0,2,394
065600210,381,13,3,2,3,0,7,409
065600211,900,31,3,35,0,2,26,997
065600212,305,8,5,10,0,3,10,341
065600213,320,18,0,15,0,0,9,362
065600214,356,15,8,23,0,3,11,416
065600215,379,38,0,17,0,1,11,446
065600216,674,53,6,45,0,37,30,845
065600301,920,19,2,11,1,0,19,972
065600302,428,0,10,4,0,0,9,451
065600303,274,0,11,4,3,0,8,300
065600304,239,1,2,1,0,2,7,252
065600305,254,5,0,2,1,0,5,267
065600306,266,7,1,0,0,0,0,274
065600307,448,15,1,2,0,1,3,470
065600308,401,31,0,50,0,5,13,500
065600309,338,10,0,1,0,0,5,354
065600310,360,17,1,2,0,5,2,387
065600311,373,14,2,12,0,0,6,407
065600312,312,10,1,2,0,3,6,334
065600313,217,8,2,3,1,1,12,244
065600314,217,3,3,9,0,1,3,236
065600315,338,11,0,8,0,0,12,369
065600316,78,5,2,4,0,9,5,103
065600401,264,0,0,10,3,4,3,284
065600402,249,0,1,7,3,6,0,266
065600403,476,0,5,17,0,2,11,511
065600404,425,2,3,1,2,0,4,437
065600405,267,0,0,12,0,0,1,280
065600406,213,8,0,0,0,0,13,234
065600407,215,2,1,0,0,0,20,238
065600408,271,0,1,2,0,0,40,314
065600409,290,0,4,0,0,0,5,299
065600410,335,0,5,0,0,0,1,341
065600411,253,1,0,4,0,0,1,259
065600412,276,0,3,4,0,0,19,302
065600413,280,8,1,4,0,3,23,319
065600414,264,8,0,3,0,2,20,297
065600415,242,10,0,6,0,1,22,281
065600416,291,6,2,5,0,1,8,313
065600417,289,4,4,0,0,5,8,310
065600418,277,0,0,0,0,0,0,277
065600419,360,2,1,8,2,3,8,384
065600420,356,4,9,11,3,3,12,398
065600501,205,2,2,1,0,3,3,216
065600502,368,3,2,3,0,4,12,392
065600503,172,3,0,1,0,3,1,180
065600504,326,8,0,1,0,0,5,340
065600505,82,3,0,1,0,1,2,89
065600506,55,3,0,0,0,0,0,58
065600507,339,2,6,0,0,0,7,354
065600508,83,0,3,1,0,1,0,88
065600509,76,0,2,0,0,0,0,78
065600510,351,6,5,4,0,1,4,371
065600511,273,13,0,1,0,1,5,293
065600512,257,12,1,1,0,0,6,277
065600513,363,12,2,2,0,1,5,385
065600514,326,6,1,1,0,1,13,348
065600515,262,8,1,2,2,13,12,300
065600601,338,1,0,4,0,3,8,354
065600602,389,0,1,2,1,3,10,406
065600603,398,7,6,3,1,8,10,433
065600604,241,1,0,6,1,0,6,255
065600605,646,8,4,5,0,1,16,680
065600606,412,2,3,5,0,0,11,433
065600607,1109,24,4,14,0,13,15,1179
065600608,358,0,2,0,0,0,11,371
065600609,404,4,6,4,3,3,23,447
065600610,324,1,4,7,5,0,12,353
065600611,344,3,0,12,3,0,1,363
065600612,335,0,0,0,0,0,0,335
065600613,192,0,1,2,0,1,3,199
065600614,209,1,0,5,0,0,9,224
065600615,253,1,0,1,0,0,7,262
065600616,309,1,1,1,0,0,0,312
065600617,325,2,2,3,0,7,2,341
065600618,277,1,3,4,0,2,3,290
065600701,234,0,0,4,1,12,6,257
065600702,327,10,2,0,0,3,5,347
065600703,357,0,0,0,0,0,5,362
065600704,258,30,0,0,1,0,9,298
065600705,353,1,1,0,2,0,4,361
065600706,401,7,2,0,0,0,2,412
065600707,207,2,1,11,0,2,9,232
065600708,86,2,0,1,0,2,0,91
065600709,222,9,0,10,0,0,3,244
065600710,200,5,1,7,0,0,2,215
065600711,191,3,0,1,0,2,2,199
065600712,204,6,0,9,0,6,1,226
065600713,275,1,1,9,0,4,5,295
065600714,345,3,1,8,0,2,7,366
065600715,370,3,3,1,0,1,3,381
065600716,429,4,1,24,0,4,8,470
065600717,396,0,9,19,1,12,12,449
065600718,301,2,2,5,0,15,14,339
065600801,314,10,9,6,1,8,9,357
065600802,302,17,3,4,0,5,15,346
065600803,276,27,5,3,1,8,8,328
065600804,276,16,2,11,2,10,14,331
065600805,270,15,2,11,0,24,11,333
065600806,289,11,2,15,0,9,21,347
065600807,327,17,0,3,0,13,3,363
065600808,366,13,4,4,1,1,12,401
065600809,290,12,4,2,1,6,20,335
065600810,290,9,4,4,0,1,3,311
065600811,235,13,6,8,0,2,8,272
065600812,214,16,1,4,1,4,10,250
065600901,180,1,12,0,0,4,24,221
065600902,85,7,3,1,0,0,4,100
065600903,47,8,0,1,0,0,1,57
065600904,122,2,3,0,0,4,4,135
065600905,88,0,2,0,0,2,11,103
065600906,88,1,4,0,0,4,8,105
065600907,108,0,2,0,0,0,0,110
065600908,69,4,2,5,0,4,5,89
065600909,90,2,4,0,0,8,8,112
065600910,49,5,1,4,0,14,5,78
065600911,43,3,1,1,0,0,2,50
065600912,79,1,5,4,0,4,8,101
065601001,160,39,5,4,1,9,3,221
065601002,264,16,3,7,0,15,6,311
065601003,292,17,11,7,0,9,7,343
065601004,335,24,2,4,1,1,6,373
065601005,383,13,2,4,0,3,5,410
065601006,353,18,0,1,0,5,9,386
065601007,429,22,8,3,1,15,12,490
065601008,348,16,5,11,1,4,6,391
065601009,330,17,2,5,1,6,11,372
065601010,383,7,4,1,1,0,5,401
065601011,318,18,2,7,1,9,13,368
065601012,312,10,3,10,0,5,12,352
065601013,323,20,0,3,0,1,11,358
065601101,265,10,3,0,0,0,7,285
065601102,368,11,1,2,0,1,3,386
065601103,230,4,1,2,0,1,3,241
065601104,233,7,6,1,1,2,4,254
065601105,218,0,0,1,0,0,7,226
065601106,248,10,2,3,0,4,4,271
065601107,370,17,5,12,1,17,15,437
065601108,343,20,3,10,2,9,8,395
065601109,361,15,4,3,0,1,10,394
065601110,419,12,3,4,0,2,4,444
065601111,377,18,2,6,1,3,14,421
065601112,333,20,1,12,0,17,5,388
065601113,389,28,3,21,2,3,19,465
065601114,323,18,9,4,2,10,13,379
065601115,299,34,11,8,2,14,15,383
065601116,219,29,3,5,1,37,6,300
065601117,221,19,7,16,2,28,8,301
065601201,299,3,1,4,2,2,8,319
065601202,268,9,4,5,0,0,10,296
065601203,350,7,2,5,1,1,4,370
065601204,223,13,0,1,0,1,3,241
065601205,322,5,0,4,0,0,8,339
065601206,250,7,1,0,1,0,14,273
065601207,259,9,1,2,2,1,1,275
065601208,235,9,3,4,0,0,4,255
065601209,394,12,3,8,7,0,5,429
065601210,247,18,5,2,0,2,3,277
065601211,206,18,4,0,2,0,9,239
065601212,256,3,0,1,0,2,1,263
065601213,251,18,0,1,0,0,5,275
065601214,403,32,9,13,3,3,20,483
065601215,238,4,3,6,0,3,13,267
065601216,240,19,2,6,1,1,14,283
065601301,313,9,2,2,0,0,11,337
065601302,291,3,2,0,0,0,3,299
065601303,437,3,6,6,0,0,9,461
065601304,311,8,1,3,0,0,1,324
065601305,336,7,4,0,0,0,6,353
065601306,271,9,1,0,0,0,14,295
065601307,403,11,3,4,0,3,11,435
065601308,332,9,1,4,5,1,7,359
065601309,303,8,3,4,0,1,8,327
065601310,411,16,4,2,1,2,9,445
065601311,434,9,7,3,0,3,6,462
065601401,361,18,0,4,0,2,15,400
065601402,382,10,5,4,5,0,6,412
065601403,324,11,2,5,0,0,10,352
065601404,309,6,0,2,0,1,23,341
065601405,351,4,2,0,0,1,3,361
065601406,358,12,0,0,0,1,1,372
065601407,245,4,6,2,0,0,5,262
065601408,520,26,0,12,1,1,5,565
065601409,220,3,0,1,0,0,11,235
065601410,211,3,0,2,0,0,2,218
065601411,238,10,0,2,0,0,4,254
065601412,338,9,1,0,0,0,11,359
065601413,312,10,0,9,0,0,0,331
065601414,297,6,1,5,1,0,7,317
065601501,268,0,3,7,0,1,4,283
065601502,195,1,3,0,0,0,8,207
065601503,260,2,2,10,0,0,1,275
065601504,267,0,2,5,0,0,0,274
065601505,240,1,2,1,0,2,4,250
065601506,261,3,3,2,0,0,5,274
065601507,208,2,3,2,0,0,4,219
065601508,705,6,4,460,0,0,25,1200
065601509,432,5,0,3,0,0,12,452
065601510,282,1,0,4,0,2,2,291
065601511,365,1,0,0,0,1,8,375
065601512,369,0,9,3,0,0,6,387
065601513,351,2,1,2,0,0,4,360
065601514,340,8,3,2,2,0,6,361
065601515,370,8,2,10,1,0,8,399
065601516,345,49,18,29,5,0,15,461
065601601,325,16,3,16,2,6,16,384
065601602,242,11,2,10,0,3,6,274
065601603,305,6,5,3,0,0,9,328
065601604,310,10,7,16,0,6,7,356
065601605,277,12,2,2,0,0,3,296
065601606,366,6,10,4,0,0,7,393
065601607,289,8,7,4,4,0,7,319
065601608,383,16,3,2,0,2,6,412
065601609,325,15,1,4,0,1,7,353
065601610,334,19,5,8,0,3,10,379
065601611,370,13,7,2,1,0,7,400
065601612,443,12,0,0,0,3,7,465
065601613,371,19,3,6,0,4,8,411
065601614,362,14,2,11,3,4,15,411
065601615,240,10,4,2,1,15,18,290
065601616,227,21,11,5,12,31,21,328
065601701,350,9,6,6,1,0,9,381
065601702,293,13,4,15,1,4,17,347
065601703,185,6,0,12,0,7,12,222
065601704,77,8,0,2,0,5,2,94
065601705,225,19,5,24,0,34,17,324
065601706,219,24,1,12,0,39,14,309
065601707,153,15,6,4,2,92,16,288
065601708,77,1,1,6,0,69,4,158
065601709,53,29,2,2,0,57,4,147
065601710,114,77,2,3,0,42,25,263
065601711,176,73,1,1,0,76,11,338
065601712,132,5,3,24,1,84,7,256
065601713,225,14,0,4,1,6,6,256
065601714,183,7,0,9,0,6,7,212
065601715,157,6,0,3,0,11,4,181
065601716,239,4,0,8,0,1,9,261
065601717,228,10,0,5,1,0,3,247
065601718,178,1,3,10,0,17,5,214
065601719,346,28,1,4,0,3,0,382
065601720,209,11,2,3,0,13,14,252
065601721,212,13,0,9,0,5,8,247
065601722,220,54,2,16,1,125,16,434
065601723,223,52,4,8,0,78,26,391
065601724,243,60,7,13,1,131,36,491
065601801,198,29,5,10,1,6,11,260
065601802,333,33,8,8,0,17,44,443
065601803,211,19,3,11,0,2,10,256
065601804,220,8,4,15,0,4,7,258
065601805,175,27,3,4,0,35,18,262
065601806,506,31,14,21,1,109,23,705
065601807,216,59,2,9,0,52,5,343
065601808,182,16,1,8,0,59,12,278
065601809,388,17,1,3,0,7,16,432
065601810,437,10,1,14,0,9,12,483
065601811,394,13,5,9,0,16,7,444
065601812,257,3,6,3,1,2,59,331
065601813,258,13,5,11,1,25,7,320
065601814,394,17,2,2,2,2,10,429
065601815,349,20,4,5,3,2,15,398
065601901,252,7,1,16,1,8,8,293
065601902,284,10,1,11,0,3,10,319
065601903,363,17,0,7,0,0,22,409
065601904,301,19,1,12,0,7,6,346
065601905,189,27,6,9,1,5,4,241
065601906,196,4,2,2,1,11,23,239
065601907,283,26,5,9,2,9,9,343
065601908,262,11,3,7,1,4,2,290
065601909,282,17,3,10,0,31,6,349
065601910,371,25,4,10,0,25,18,453
065601911,252,18,1,12,1,14,11,309
065601912,218,34,7,7,0,6,8,280
065601913,190,12,0,9,1,13,2,227
065601914,241,15,0,8,0,3,15,282
065601915,306,12,2,4,0,7,14,345
065601916,196,12,0,3,1,6,9,227
065601917,159,2,0,4,1,40,7,213
065601918,124,14,1,4,0,36,30,209
065601919,179,18,1,12,0,6,9,225
065601920,193,35,0,1,0,14,14,257
065602001,449,11,0,1,0,0,1,462
065602002,333,6,2,4,0,2,15,362
065602003,371,23,4,4,0,1,5,408
065602004,329,10,1,5,0,7,7,359
065602005,254,6,0,1,1,0,6,268
065602006,300,8,0,0,0,1,3,312
065602007,306,20,0,3,0,0,3,332
065602008,271,4,4,2,0,0,7,288
065602009,319,10,0,18,0,1,6,354
065602010,313,9,1,2,0,1,4,330
065602011,217,3,0,1,0,0,3,224
065602012,276,8,2,0,0,1,6,293
065602013,401,23,1,8,1,1,10,445
065602014,311,8,0,1,0,0,9,329
065602101,355,27,10,11,0,33,7,443
065602102,204,19,7,11,0,19,7,267
065602103,231,11,1,12,0,3,22,280
065602104,194,17,1,16,0,24,7,259
065602105,245,15,1,12,0,26,9,308
065602106,259,22,1,14,0,40,18,354
065602107,381,12,1,5,0,3,10,412
065602108,355,12,8,8,0,5,5,393
065602109,379,16,2,11,1,3,21,433
065602110,209,33,1,8,1,45,4,301
065602111,420,5,8,5,1,14,12,465
065602112,216,5,0,1,0,2,0,224
065602113,305,17,1,0,1,1,5,330
065602201,279,28,2,13,0,17,15,354
065602202,318,52,7,11,3,17,34,442
065602203,330,31,4,12,2,60,16,455
065602204,317,18,2,1,1,4,8,351
065602205,380,15,8,5,2,3,9,422
065602206,249,5,0,5,0,0,9,268
065602207,239,25,4,2,0,5,7,282
065602208,384,16,9,3,0,1,15,428
065602209,325,24,2,0,0,0,3,354
065602210,316,13,2,6,0,0,14,351
065602301,322,14,4,8,5,0,9,362
065602302,279,6,2,3,1,0,4,295
065602303,248,18,6,5,1,17,6,301
065602304,407,14,2,0,0,1,3,427
065602305,317,16,2,4,1,2,8,350
065602306,326,22,3,8,3,4,10,376
065602307,327,33,31,6,4,4,8,413
065602308,192,21,18,0,10,2,7,250
065602309,188,25,6,1,13,2,25,260
065602310,224,25,38,3,15,1,14,320
065602311,173,20,10,4,34,0,25,266
065602312,183,19,6,3,13,0,18,242
065602313,318,18,13,5,15,2,17,388
065602314,210,14,5,3,0,1,7,240
065602315,239,16,9,2,7,1,6,280
065602316,283,13,6,10,0,2,11,325
065602317,376,38,30,5,13,1,10,473
065602401,198,35,20,1,9,1,6,270
065602402,185,24,14,6,3,0,14,246
065602403,246,22,4,3,3,0,21,299
065602404,277,17,12,1,6,0,9,322
065602405,247,18,8,1,0,0,5,279
065602406,259,12,2,3,0,0,7,283
065602407,303,26,7,4,1,2,6,349
065602408,267,20,6,2,0,2,10,307
065602409,212,20,5,4,0,0,6,247
065602410,197,21,5,4,2,2,9,240
065602411,271,39,20,2,17,1,36,386
065602412,180,30,2,5,2,0,2,221
065602413,200,16,3,4,7,0,6,236
065602414,220,20,5,3,3,0,1,252
065602415,195,32,12,5,3,1,6,254
065602416,278,21,5,4,0,5,5,318
065602417,349,11,0,6,0,1,11,378
065602501,236,16,1,0,2,0,8,263
065602502,250,22,2,1,1,2,4,282
065602503,361,27,11,2,3,1,13,418
065602504,447,19,5,4,10,7,12,504
065602505,209,16,5,1,0,0,15,246
065602506,233,13,7,1,0,1,6,261
065602507,274,11,1,2,0,0,27,315
065602508,319,6,1,9,0,1,6,342
065602509,435,27,6,8,1,3,6,486
065602510,463,34,10,1,1,1,18,528
065602511,236,15,4,6,0,2,18,281
065602512,243,6,1,9,0,4,10,273
065602513,407,17,2,1,1,0,13,441
065602514,327,19,6,5,1,3,5,366
065680101,116,0,4,1,1,4,15,141
065680102,262,5,15,1,0,0,10,293
065680103,348,9,5,4,0,0,10,376
065680201,295,21,7,7,14,4,15,363
065680202,187,17,10,1,12,0,14,241
065680203,322,25,6,4,2,1,28,388
065680204,220,3,9,5,0,0,19,256
065680205,290,12,5,0,0,0,10,317
065680206,331,17,12,1,3,0,12,376
065680207,310,17,14,8,3,0,5,357
065680208,347,5,2,3,0,0,10,367
065680209,360,0,0,2,2,0,16,380
065680210,223,1,3,1,7,1,14,250
065680211,344,3,12,7,6,1,30,403
065680212,258,11,1,1,2,0,9,282
065680301,312,13,6,5,1,0,21,358
065680302,357,22,6,5,0,0,9,399
065680303,351,18,4,2,0,1,14,390
065680304,227,11,5,2,0,2,1,248
065680305,198,13,4,2,0,0,2,219
065680306,225,5,0,3,0,0,5,238
065680307,195,16,2,2,1,1,6,223
065680308,290,12,0,0,0,0,7,309
065680309,300,7,2,0,1,0,2,312
065680310,207,9,0,6,0,0,0,222
065680311,334,20,8,0,1,1,14,378
065680312,328,25,3,3,2,0,14,375
065680313,407,15,9,0,1,0,24,456
065680314,554,16,2,0,1,0,5,578
065680315,511,8,0,0,0,0,5,524
065680316,298,2,0,0,1,0,2,303
065680401,227,12,10,1,0,1,10,261
065680402,230,19,0,2,3,1,13,268
065680403,215,20,11,4,0,0,9,259
065680404,272,16,3,2,1,0,13,307
065680405,331,27,6,5,0,0,7,376
065680406,175,16,9,5,2,2,5,214
065680407,279,19,1,3,6,0,10,318
065680408,320,34,4,2,3,0,13,376
065680409,350,45,7,3,1,0,11,417
065680410,291,34,5,4,2,0,6,342
065680411,366,32,7,6,8,0,37,456
065680501,283,21,10,4,4,0,10,332
065680502,429,25,10,2,1,3,24,494
065680503,235,14,14,0,0,1,8,272
065680504,225,3,3,0,2,1,20,254
065680505,364,37,13,5,4,3,11,437
065680506,317,29,13,8,3,0,17,387
065680507,313,29,6,2,3,0,18,371
065680508,346,27,17,4,6,0,13,413
065680509,218,21,4,5,2,0,14,264
065680510,206,31,3,3,3,2,10,258
065680601,393,28,13,5,0,2,12,453
065680602,291,5,11,4,0,1,34,346
065680603,292,16,9,5,0,0,14,336
065680604,331,39,11,3,6,0,6,396
065680605,311,22,6,6,4,3,18,370
065680606,371,53,18,7,19,1,44,513
065680607,390,49,19,4,11,1,20,494
065680608,288,36,6,2,5,2,17,356
065680609,336,28,3,6,3,0,25,401
065680610,225,20,16,3,15,4,21,304
065680611,160,19,18,6,8,1,23,235
065680701,304,24,4,1,2,1,28,364
065680702,301,14,4,2,0,0,10,331
065680703,205,12,1,1,1,0,5,225
065680704,240,27,2,2,0,0,6,277
065680705,287,15,4,4,1,2,7,320
065680706,352,18,0,11,7,0,28,416
065680707,287,24,5,9,7,0,9,341
065680708,266,23,3,3,3,0,8,306
065680801,303,19,8,3,3,1,19,356
065680802,320,14,7,1,1,0,8,351
065680803,233,9,7,2,0,0,8,259
065680804,355,20,8,4,1,0,4,392
065680805,369,27,6,5,4,1,21,433
065680806,332,16,10,7,0,1,8,374
065680807,298,26,5,1,1,0,10,341
065680808,334,23,7,3,2,1,11,381
065680901,187,7,7,2,0,0,4,207
065680902,249,16,3,1,1,0,10,280
065680903,389,17,4,4,1,1,16,432
065680904,214,14,4,0,4,0,9,245
065680905,193,9,3,4,2,0,10,221
065680906,267,18,3,4,3,0,12,307
065680907,367,26,4,4,1,2,26,430
065680908,175,11,2,1,1,2,5,197
065680909,256,27,6,2,0,0,18,309
065680910,369,28,20,5,3,1,14,440
065680911,220,15,1,3,0,0,25,264
065680912,202,24,2,0,0,0,7,235
065681001,321,10,6,3,1,0,12,353
065681002,145,9,2,2,0,0,4,162
065681003,137,12,0,1,0,0,7,157
065681004,295,19,9,2,0,0,4,329
065681005,282,27,4,3,4,0,6,326
065681006,182,15,6,2,5,0,7,217
065681007,195,10,8,0,2,0,6,221
065681008,327,9,5,1,0,1,10,353
065681009,297,23,7,2,3,2,14,348
065681010,216,16,7,3,0,0,10,252
065681011,222,17,2,4,0,2,5,252
065681012,327,14,3,5,2,3,10,364
065681013,351,13,9,1,2,0,9,385
065681014,271,37,6,0,1,1,21,337
065681015,257,16,8,0,0,0,19,300
065681016,285,32,3,8,1,0,14,343
065681017,226,8,0,0,0,0,6,240
065681101,288,27,13,1,4,0,12,345
065681102,333,29,5,2,1,1,12,383
065681103,226,33,2,6,3,0,12,282
065681104,190,34,26,12,5,0,14,281
065681105,277,34,46,5,48,4,47,461
065681106,274,14,5,2,3,0,10,308
065681107,270,5,7,6,4,2,29,323
065681108,336,16,8,5,0,2,11,378
065681109,240,15,5,2,17,3,12,294
065681110,225,35,31,15,11,0,20,337
065681111,252,11,6,2,11,1,4,287
065681112,319,28,8,7,4,2,14,382
065681201,248,12,10,3,4,0,7,284
065681202,329,29,13,8,2,0,19,400
065681203,324,22,2,4,3,1,16,372
065681204,227,26,4,4,3,0,7,271
065681205,346,17,7,1,1,1,31,404
065681206,385,22,0,1,1,0,12,421
065681207,371,28,9,6,1,1,19,435
065681208,218,31,0,0,0,0,11,260
065681209,233,12,6,4,2,0,7,264
065681210,268,15,17,7,4,0,4,315
065681301,218,9,5,4,0,1,32,269
065681302,200,4,8,5,8,0,19,244
065681303,260,33,5,1,3,0,21,323
065681304,316,26,19,5,2,0,12,380
065681305,325,18,10,3,3,0,11,370
065681306,375,33,17,2,2,1,13,443
065681307,423,29,9,2,8,0,17,488
065681308,330,33,8,3,5,1,6,386
065681309,362,16,2,2,0,0,6,388
065681310,324,10,4,5,0,0,8,351
065681401,182,0,0,0,0,0,3,185
065681402,298,23,12,3,2,0,23,361
065681403,416,6,14,3,36,0,31,506
065681404,259,22,10,1,4,2,26,324
065681405,176,15,4,5,0,0,2,202
065681406,201,23,17,5,0,0,4,250
065681407,325,61,39,8,0,0,20,453
065681408,207,19,16,0,6,1,8,257
065681409,342,54,22,13,5,4,3,443
065681410,351,36,10,4,2,0,17,420
065681501,260,0,4,3,6,0,11,284
065681502,346,1,13,0,1,1,15,377
065681503,324,2,15,1,2,0,17,361
065681504,393,1,5,7,3,0,14,423
065681505,308,0,8,3,0,1,4,324
065681506,290,0,6,3,0,0,9,308
065681507,330,0,11,5,5,4,7,362
065681508,412,2,20,1,3,1,16,455
065681509,216,3,5,1,1,1,2,229
065681510,297,0,6,3,1,3,18,328
065681601,307,0,2,10,5,0,5,329
065681602,311,0,4,2,0,0,1,318
065681603,212,1,8,4,0,0,7,232
065681604,411,3,8,6,0,2,14,444
065681605,325,0,8,6,1,0,12,352
065681606,342,0,7,3,4,0,15,371
065681607,247,0,3,1,6,1,6,264
065681608,217,1,5,9,0,0,5,237
065681609,408,0,8,6,1,2,9,434
065681610,368,0,12,4,0,0,11,395
065681611,313,0,6,4,0,1,10,334
065681612,360,1,14,8,2,3,13,401
065681701,336,3,10,3,1,0,19,372
065681702,307,0,5,4,1,0,9,326
065681703,236,6,3,2,2,0,1,250
065681704,198,2,7,2,3,1,6,219
065681705,379,10,14,9,3,3,15,433
065681706,377,26,6,10,0,1,15,435
065681707,364,26,11,3,4,0,23,431
065681708,335,27,2,4,0,1,15,384
065681709,230,17,13,2,0,0,8,270
065681710,291,22,6,4,1,0,16,340
065681711,306,32,2,0,2,0,12,354
065681712,277,26,4,0,0,0,10,317
065681801,228,40,14,3,7,3,14,309
065681802,165,21,47,9,58,1,1,302
065681803,177,36,18,2,15,0,23,271
065681804,236,59,21,3,24,0,15,358
065681805,254,32,12,1,13,5,11,328
065681806,177,51,5,1,13,2,4,253
065681807,325,45,10,7,7,3,10,407
065681808,252,17,3,3,1,0,6,282
065681809,351,15,5,3,1,2,18,395
065681810,314,22,4,4,1,1,17,363
065681811,296,35,12,3,2,0,0,348
065681812,318,29,10,6,1,0,22,386
065681813,247,30,5,2,0,0,7,291
065681814,219,9,8,3,0,2,16,257
065681901,230,15,1,1,1,0,16,264
065681902,348,28,7,2,0,0,15,400
065681903,406,26,6,0,7,6,8,459
065681904,225,14,6,4,2,0,5,256
065681905,258,17,6,5,0,0,4,290
065681906,399,23,24,3,0,0,12,461
065681907,335,17,5,3,0,2,6,368
065681908,361,21,4,2,0,1,1,390
065681909,336,25,4,4,0,1,8,378
065681910,213,12,5,1,4,2,13,250
065681911,361,11,2,6,1,3,10,394
065682001,339,39,12,4,5,2,19,420
065682002,236,8,8,1,7,4,28,292
065682003,313,23,30,12,26,3,7,414
065682004,289,14,22,5,12,1,29,372
065682005,271,35,8,7,14,7,25,367
065682006,221,30,12,3,7,1,6,280
065682007,215,16,11,5,4,0,10,261
065682008,356,32,14,6,1,1,23,433
065682009,397,20,6,2,2,5,17,449
065682010,297,29,9,4,5,1,14,359
065682011,404,21,8,3,3,2,25,466
065682012,308,30,3,5,2,2,6,356
065682013,246,9,3,2,4,1,16,281
065682014,240,21,5,1,1,0,5,273
065682101,173,26,33,3,70,0,22,327
065682102,143,25,46,1,56,3,29,303
065682103,148,40,19,2,13,0,6,228
065682104,262,57,25,3,23,1,11,382
065682105,142,34,17,3,106,1,14,317
065682106,121,55,32,1,136,1,14,360
065682107,41,7,3,0,93,1,13,158
065682108,134,30,23,0,72,1,25,285
065682109,161,37,55,4,128,8,24,417
065682110,168,40,21,2,38,1,6,276
065682111,119,24,57,0,28,0,20,248
065682112,246,47,24,1,22,10,32,382
065682113,362,21,34,1,12,4,25,459
065682201,182,14,17,0,2,0,11,226
065682202,138,3,15,0,1,0,3,160
065682203,140,6,45,0,3,0,10,204
065682204,183,15,0,0,0,0,8,206
065682205,116,10,31,0,2,1,10,170
065682206,240,9,30,0,2,0,10,291
065682207,141,12,30,0,2,0,8,193
065682208,197,10,16,0,1,0,9,233
065682209,169,14,2,0,0,0,12,197
065682210,188,6,0,0,0,0,2,196
065682211,144,2,0,0,0,0,0,146
065682212,170,9,33,0,3,0,12,227
065682213,280,14,60,0,4,0,17,375
065682214,345,33,7,0,3,0,24,412
065682215,159,11,15,0,1,0,7,193
065682216,208,22,17,0,2,0,15,264
065682217,193,11,6,0,3,0,10,223
065682218,128,7,52,0,3,0,9,199
065682301,184,10,4,1,4,0,8,211
065682302,226,21,19,2,3,2,10,283
065682303,284,21,32,6,5,1,14,363
065682304,209,13,19,2,4,3,16,266
065682305,220,22,20,1,1,0,7,271
065682306,339,29,10,5,3,1,17,404
065682307,331,17,12,2,1,0,7,370
065682308,397,23,12,1,4,1,10,448
065682309,311,23,3,3,4,0,18,362
065682310,234,8,2,1,0,0,12,257
065682311,237,20,0,1,0,0,1,259
065682401,327,37,7,5,1,0,4,381
065682402,297,9,5,1,0,1,23,336
065682403,189,17,2,2,2,0,11,223
065682404,379,34,7,4,0,0,17,441
065682405,337,35,7,8,2,1,3,393
065682406,247,23,6,0,0,0,12,288
065682407,265,15,7,7,2,0,6,302
065682408,379,16,7,5,2,0,10,419
065682409,213,9,1,5,0,0,5,233
065682410,213,9,2,9,0,0,4,237
065682501,168,8,3,0,0,0,4,183
065682502,306,16,7,1,1,1,12,344
065682503,339,14,4,2,0,0,16,375
065682504,386,20,2,3,0,1,11,423
065682505,201,18,4,7,0,2,2,234
065682506,401,18,3,1,1,0,7,431
065682507,378,9,1,6,1,1,10,406
065682508,355,0,3,5,1,3,8,375
065682509,291,3,0,0,0,0,8,302
065682510,290,8,0,0,1,0,5,304
065682511,325,1,3,6,0,0,22,357
065682512,370,9,4,2,2,1,23,411
065682601,201,16,3,0,0,0,6,226
065682602,343,22,11,3,1,4,12,396
065682603,314,7,7,4,1,0,12,345
065682604,203,7,1,2,0,0,9,222
065682605,164,11,4,1,1,0,3,184
065682606,186,19,4,2,2,0,7,220
065682607,364,17,4,3,5,0,12,405
065682608,223,13,5,1,0,0,9,251
065682609,198,6,4,3,1,0,8,220
065682610,358,16,4,1,1,0,16,396
065682611,347,7,2,4,1,3,16,380
065682612,351,27,6,2,5,0,12,403
065682701,11,1,0,0,0,0,0,12
065682702,330,20,0,1,0,0,12,363
065682703,294,9,0,3,0,1,6,313
065682704,249,11,3,4,1,1,8,277
065682705,222,9,4,2,0,0,29,266
065682706,279,28,0,2,1,2,1,313
065682707,344,7,0,0,0,0,30,381
065682708,265,21,2,1,0,0,3,292
065682709,308,16,1,2,0,0,6,333
065682710,260,20,3,7,1,2,7,300
065682711,295,14,4,3,0,1,12,329
065682801,429,20,10,3,0,3,15,480
065682802,348,14,4,1,1,2,20,390
065682803,481,28,2,5,0,0,7,523
065682804,228,10,1,1,0,0,7,247
065682805,392,5,3,5,0,2,9,416
065682806,342,7,1,1,0,0,8,359
065682807,211,11,1,1,0,0,2,226
065682808,273,10,0,3,0,1,6,293
065682809,344,21,0,1,0,0,10,376
065682810,380,15,1,2,0,0,1,399
065682901,325,13,1,5,0,0,5,349
065682902,297,7,6,2,3,1,19,335
065682903,238,8,4,0,0,0,3,253
065682904,251,2,2,4,0,1,8,268
065682905,242,8,1,2,0,0,3,256
065682906,260,2,0,2,1,0,12,277
065682907,265,10,1,3,0,0,0,279
065682908,225,7,3,2,0,1,6,244
065682909,309,5,0,1,1,0,3,319
065682910,271,7,0,1,0,0,0,279
065682911,410,12,1,2,0,0,2,427
065682912,286,6,1,1,1,1,8,304
065682913,257,2,1,2,1,0,3,266
065682914,242,7,3,3,1,0,7,263
065683001,351,8,0,1,0,1,5,366
065683002,422,20,2,3,0,0,7,454
065683003,416,14,6,1,0,0,5,442
065683004,425,19,0,4,0,0,8,456
065683005,255,11,1,1,3,0,5,276
065683006,278,12,5,3,1,0,4,303
065683007,379,15,9,0,0,0,12,415
065683008,319,12,2,4,0,0,11,348
065683009,267,14,9,1,1,0,8,300
065683010,393,16,0,3,2,1,5,420
065683011,359,20,1,3,0,2,3,388
065683101,386,19,3,1,0,0,21,430
065683102,392,19,0,4,0,0,12,427
065683103,273,8,2,2,3,1,4,293
065683104,448,12,3,2,0,0,8,473
065683105,327,14,2,0,0,0,4,347
065683106,280,15,1,6,0,0,8,310
065683107,379,7,2,1,0,1,11,401
065683108,218,7,4,2,2,0,6,239
065683109,291,20,3,1,0,0,8,323
065683110,232,21,0,3,2,0,4,262
065683111,202,10,0,1,1,0,5,219
065683112,298,18,4,2,1,0,3,326
066580101,2,0,0,0,0,0,0,2
066580102,365,14,5,2,0,8,11,405
066580103,340,30,4,1,6,0,7,388
066580104,249,9,3,2,1,0,14,278
066580105,305,11,5,2,1,0,6,330
066580106,307,15,5,3,0,0,14,344
066580107,238,25,3,2,4,2,14,288
066580108,249,12,11,4,1,0,7,284
066580109,299,23,5,3,0,1,3,334
066580110,436,14,1,10,1,0,12,474
066580111,3,0,0,0,0,0,0,3
066580112,39,2,2,0,0,2,0,45
066580113,28,1,0,4,0,1,1,35
066580201,101,5,0,1,0,0,2,109
066580202,227,1,0,1,0,4,4,237
066580203,230,12,0,5,0,3,9,259
066580204,264,12,0,0,0,1,8,285
066580205,205,4,0,2,0,0,5,216
066580206,409,21,0,2,0,0,6,438
066580207,228,7,0,2,0,0,6,243
066580208,279,7,1,3,0,0,7,297
066580209,252,4,0,1,0,0,12,269
066580210,262,21,2,0,1,0,5,291
066580211,344,11,1,2,0,1,17,376
066580212,274,9,3,1,0,0,10,297
066580301,288,10,1,12,0,1,15,327
066580302,295,16,0,7,0,2,14,334
066580303,338,15,3,12,0,0,2,370
066580304,295,25,2,0,1,0,9,332
066580305,326,17,3,3,0,0,12,361
066580306,237,11,6,3,0,1,8,266
066580307,335,18,3,0,2,0,8,366
066580308,447,23,8,4,1,1,14,498
066580309,434,13,6,9,0,0,20,482
066580310,309,1,7,6,6,1,23,353
066580311,252,16,3,1,3,2,7,284
066580401,177,11,11,0,1,2,19,221
066580402,314,18,2,12,0,1,11,358
066580403,310,7,0,2,0,0,5,324
066580404,259,6,2,0,1,0,5,273
066580405,272,17,0,25,0,0,7,321
066580406,259,13,2,2,0,0,1,277
066580407,273,9,1,5,0,1,7,296
066580408,384,18,7,7,2,1,11,430
066580409,315,21,6,0,4,0,3,349
066580410,300,24,2,3,8,0,9,346
066580411,305,20,6,5,0,1,7,344
066580412,396,10,3,2,0,2,7,420
066580413,231,7,1,3,0,0,6,248
066580414,198,12,1,0,0,0,234,445
066580415,272,12,2,3,0,0,4,293
066580501,217,3,1,2,2,1,17,243
066580502,164,10,1,2,0,0,4,181
066580503,272,9,3,0,0,0,6,290
066580504,190,1,6,0,0,0,4,201
066580505,226,11,1,1,0,0,7,246
066580506,254,14,0,3,0,0,10,281
066580507,368,9,10,8,2,1,21,419
066580508,294,9,4,1,0,1,5,314
066580509,359,8,8,4,7,2,4,392
066580510,171,6,3,1,0,1,2,184
066580511,332,29,1,3,0,0,9,374
066580512,243,23,4,4,2,2,2,280
066580513,247,4,3,6,0,1,14,275
066580514,273,17,4,7,1,2,7,311
066580601,234,28,27,4,17,0,4,314
066580602,269,30,15,3,12,0,18,347
066580603,281,20,6,8,14,0,41,370
066580604,280,13,23,4,16,0,17,353
066580605,304,17,18,0,4,1,16,360
066580606,193,6,0,2,2,1,7,211
066580607,260,20,4,2,3,0,0,289
066580608,170,15,1,2,0,1,15,204
066580609,371,29,4,3,5,1,12,425
066580610,348,13,11,5,2,0,6,385
066580611,323,20,0,5,1,0,16,365
066580612,277,10,9,1,2,0,5,304
066580701,250,22,5,5,11,2,17,312
066580702,255,12,8,6,10,0,23,314
066580703,273,7,7,7,5,3,10,312
066580704,300,2,8,6,12,2,43,373
066580705,267,5,7,1,3,23,9,315
066580706,254,0,5,5,2,1,10,277
066580707,248,0,10,2,0,7,2,269
066580708,345,9,7,3,1,0,4,369
066580709,270,11,0,2,0,0,4,287
066580710,416,7,3,1,1,0,3,431
066580711,250,4,11,12,4,2,12,295
066580801,161,4,16,3,5,1,14,204
066580802,203,10,24,0,6,4,15,262
066580803,167,29,10,1,9,2,13,231
066580804,324,82,15,3,7,1,17,449
066580805,318,48,7,4,30,2,55,464
066580806,204,40,10,3,20,1,17,295
066580807,193,58,5,3,7,0,10,276
066580808,215,4,70,22,49,0,12,372
066580809,289,44,49,1,30,0,1,414
066580810,197,57,16,2,28,1,12,313
066580811,292,12,39,0,7,2,40,392
066580812,217,39,44,1,58,4,15,378
066580813,138,20,18,0,46,0,13,235
066580814,178,9,18,0,22,0,41,268
066580815,148,30,5,0,57,0,7,247
066580901,313,25,6,5,2,2,10,363
066580902,315,3,17,9,23,2,46,415
066580903,276,50,14,0,34,0,48,422
066580904,53,0,0,0,11,3,18,85
066580905,208,31,23,1,34,8,5,310
066580906,259,29,22,0,65,1,20,396
066580907,192,31,20,5,40,0,9,297
066580908,163,45,25,0,13,0,3,249
066580909,181,21,8,0,2,0,27,239
066580910,298,43,46,4,21,4,23,439
066580911,179,0,34,0,13,1,12,239
066580912,219,37,12,3,15,0,7,293
066580913,230,36,4,6,33,1,22,332
066581001,275,23,2,5,0,0,15,320
066581002,333,5,0,0,0,0,1,339
066581003,236,14,3,3,0,0,6,262
066581004,255,27,6,4,1,1,24,318
066581005,412,18,12,8,1,0,19,470
066581006,228,17,8,1,11,0,27,292
066581007,372,7,15,2,3,1,20,420
066581008,302,26,14,8,9,0,37,396
066581009,258,23,10,4,4,0,3,302
066581010,275,31,11,6,1,2,6,332
066581011,335,19,10,1,1,0,12,378
066581012,401,9,1,2,0,0,15,428
066581013,228,0,0,0,0,0,0,228
066581101,288,15,4,1,0,0,13,321
066581102,251,9,3,4,1,0,33,301
066581103,230,2,4,2,6,0,16,260
066581104,194,15,6,2,3,2,3,225
066581105,152,10,3,4,0,0,9,178
066581106,265,8,3,1,0,1,10,288
066581107,278,32,5,6,3,0,12,336
066581108,271,17,5,6,1,0,12,312
066581109,283,30,5,3,4,1,13,339
066581110,294,23,10,2,2,2,12,345
066581111,226,1,12,4,0,7,12,262
066581112,276,30,9,7,3,1,10,336
066581113,211,17,4,4,0,2,5,243
066581201,425,21,15,1,3,0,15,480
066581202,342,19,9,4,4,2,22,402
066581203,356,23,8,3,1,0,10,401
066581204,369,25,10,3,5,1,21,434
066581205,313,15,14,2,8,2,19,373
066581206,295,32,8,10,9,0,27,381
066581207,283,37,9,2,2,1,27,361
066581208,307,11,15,3,19,0,21,376
066581209,286,4,14,13,7,0,26,350
066581210,281,33,9,2,12,0,34,371
066581211,341,24,17,7,8,1,18,416
066581212,320,16,5,2,1,2,10,356
066581213,247,32,12,4,4,4,17,320
066581301,157,4,0,1,0,0,2,164
066581302,123,5,0,0,0,0,2,130
066581303,93,3,0,1,1,0,1,99
066581304,219,10,0,0,0,0,2,231
066581305,124,5,0,0,0,0,1,130
066581306,200,6,0,0,0,0,0,206
066581307,238,5,3,0,0,0,9,255
066581308,225,6,0,1,0,0,1,233
066581309,236,4,1,1,0,0,7,249
066581310,187,2,0,0,0,0,2,191
066581401,148,4,1,2,0,0,0,155
066581402,61,4,0,0,0,0,2,67
066581403,77,4,0,2,0,0,2,85
066581404,172,6,0,0,0,0,10,188
066581405,122,2,0,0,1,0,3,128
066581406,123,3,0,0,0,0,2,128
066581407,261,5,0,0,2,0,18,286
066581408,206,8,0,1,0,0,6,221
066581409,407,8,0,0,0,0,12,427
066581410,197,10,1,1,1,0,4,214
066581501,248,29,4,3,0,0,16,300
066581502,290,30,4,0,1,0,9,334
066581503,304,9,0,0,0,0,4,317
066581504,151,7,0,1,0,0,2,161
066581505,338,17,4,1,1,0,5,366
066581506,183,4,7,3,3,1,8,209
066581507,260,7,4,3,1,0,12,287
066581508,275,10,3,2,1,0,18,309
066581509,337,20,12,4,2,0,12,387
066581510,227,18,2,0,4,0,10,261
066581511,206,11,8,3,1,0,17,246
066581512,231,28,3,4,1,0,5,272
066581513,210,15,0,4,6,1,18,254
066581601,257,25,3,1,2,0,3,291
066581602,256,32,20,4,3,2,11,328
066581603,232,11,3,5,1,0,8,260
066581604,177,18,5,2,2,0,8,212
066581605,206,26,3,6,3,0,8,252
066581606,265,26,11,2,1,0,16,321
066581607,225,13,6,4,3,0,15,266
066581608,234,22,3,1,4,0,3,267
066581609,291,15,6,4,2,0,7,325
066581610,216,36,7,3,6,1,14,283
066581611,217,23,2,8,1,0,10,261
066581612,223,8,6,1,0,0,16,254
066581701,284,12,2,2,2,0,5,307
066581702,264,11,7,16,14,0,10,322
066581703,245,2,8,14,10,1,8,288
066581704,282,19,14,0,6,0,15,336
066581705,316,28,10,0,4,0,16,374
066581706,345,4,2,3,4,2,30,390
066581707,292,28,8,2,1,0,5,336
066581708,378,35,2,5,0,2,7,429
066581709,346,24,6,6,5,2,21,410
066581710,264,18,7,4,5,1,4,303
066581711,314,15,3,6,2,1,10,351
066581712,311,32,4,2,1,0,8,358
066581801,130,10,3,6,6,0,13,168
066581802,146,8,1,3,1,0,8,167
066581803,187,21,1,2,1,0,7,219
066581804,256,11,12,3,3,0,5,290
066581805,264,16,6,8,10,0,15,319
066581806,284,24,8,4,10,1,20,351
066581807,218,33,3,3,1,0,7,265
066581808,263,9,4,6,6,2,13,303
066581809,288,32,6,6,11,1,27,371
066581810,209,18,7,4,5,0,20,263
066581811,241,18,4,0,9,0,8,280
066581812,138,9,13,1,11,0,3,175
066581901,221,22,19,3,6,0,17,288
066581902,245,17,5,5,5,0,25,302
066581903,195,21,5,5,1,0,9,236
066581904,192,4,8,3,2,0,11,220
066581905,205,4,4,1,0,4,35,253
066581906,179,3,11,12,4,1,3,213
066581907,179,4,4,1,2,2,8,200
066581908,269,5,18,5,10,1,11,319
066581909,233,11,3,6,1,0,11,265
066581910,272,18,14,3,2,6,25,340
066581911,278,9,0,2,0,2,4,295
066582001,297,11,2,9,1,1,6,327
066582002,317,49,15,0,0,0,6,387
066582003,396,15,3,0,1,2,5,422
066582004,322,10,1,1,0,1,5,340
066582005,326,9,3,0,0,0,3,341
066582006,188,8,1,3,0,0,1,201
066582007,231,6,3,2,4,1,13,260
066582008,336,5,2,3,1,2,13,362
066582009,497,23,15,16,0,0,3,554
066582010,458,14,2,3,2,1,12,492
066582011,405,11,5,2,2,0,11,436
066582101,448,22,8,12,3,1,8,502
066582102,384,10,2,2,0,1,2,401
066582103,468,27,3,3,1,2,8,512
066582104,324,6,1,4,0,0,5,340
066582105,363,10,2,0,0,0,6,381
066582106,427,13,6,1,0,0,6,453
066582107,547,12,2,3,0,0,6,570
066582108,544,6,0,5,0,0,8,563
066582109,350,5,0,0,0,0,4,359
066582110,297,5,1,2,1,3,4,313
066582111,444,26,3,0,0,1,1,475
066582112,458,6,4,11,2,1,14,496
066582113,417,32,1,4,2,0,20,476
066582114,346,0,7,5,0,1,15,374
066582115,271,8,1,5,0,0,6,291
066582116,267,3,0,0,0,0,4,274
066582201,325,16,8,5,4,0,13,371
066582202,313,18,10,10,2,0,11,364
066582203,307,20,9,6,2,2,18,364
066582204,261,14,4,1,4,0,8,292
066582205,222,20,3,3,1,0,5,254
066582206,229,20,7,3,6,0,17,282
066582207,289,23,3,6,1,0,9,331
066582208,211,6,1,2,0,0,7,227
066582209,446,25,4,1,0,0,4,480
066582210,364,11,6,5,0,0,6,392
066582211,346,14,6,5,0,0,12,383
066582301,247,8,1,2,1,0,2,261
066582302,322,6,8,1,2,0,5,344
066582303,424,57,10,11,4,0,10,516
066582304,290,10,4,1,0,0,19,324
066582305,324,11,11,6,2,0,21,375
066582306,198,14,8,6,3,0,3,232
066582307,180,15,1,0,0,0,5,201
066582308,197,7,2,1,1,1,3,212
066582309,339,8,2,0,0,0,2,351
066582310,349,14,2,4,1,0,3,373
066582311,293,16,4,1,0,0,3,317
066582312,253,20,14,0,1,0,7,295
066582401,309,16,7,3,1,0,8,344
066582402,331,12,15,1,0,1,6,366
066582403,422,19,8,2,1,0,16,468
066582404,271,20,16,2,1,0,10,320
066582405,303,18,2,3,2,0,5,333
066582406,347,17,8,7,4,0,5,388
066582407,312,12,3,6,0,1,14,348
066582408,265,17,7,4,2,0,7,302
066582409,261,18,9,5,3,0,9,305
066582410,229,11,2,1,5,0,9,257
066582411,243,28,3,1,5,0,14,294
066582412,234,12,2,2,5,3,7,265
066582501,220,8,6,4,3,0,24,265
066582502,228,26,9,4,2,0,3,272
066582503,280,31,13,3,1,0,16,344
066582504,206,21,2,2,2,2,6,241
066582505,246,11,9,1,4,2,4,277
066582506,291,11,16,3,1,0,8,330
066582507,258,15,3,9,1,0,8,294
066582508,291,12,6,3,1,1,14,328
066582509,217,15,2,1,2,0,10,247
066582510,324,25,3,1,2,0,9,364
066582511,373,28,7,29,0,0,33,470
066582512,311,20,3,0,2,0,29,365
066582513,366,1,6,2,0,0,21,396
066582514,129,9,3,1,1,0,7,150
066582601,500,7,9,9,2,1,21,549
066582602,425,7,9,6,5,0,9,461
066582603,327,2,4,2,4,1,18,358
066582604,295,9,13,0,3,1,19,340
066582605,272,6,9,2,0,0,3,292
066582606,338,5,14,1,1,0,28,387
066582607,271,6,4,1,4,1,14,301
066582608,241,2,7,3,4,0,24,281
066582609,222,24,4,1,5,0,6,262
066582610,359,18,16,2,5,0,12,412
066582701,306,10,2,0,0,0,6,324
066582702,307,4,0,0,0,0,9,320
066582703,165,4,0,0,0,0,7,176
066582704,115,0,0,0,0,0,6,121
066582705,112,2,0,0,0,0,3,117
066582706,384,11,0,1,0,0,7,403
066582707,213,5,0,3,0,0,1,222
066582708,165,0,0,0,0,0,5,170
066582709,419,10,2,2,4,0,13,450
066582710,218,13,0,0,0,0,1,232
066582711,345,4,0,1,0,0,2,352
066582712,272,7,0,1,1,0,3,284
066582713,275,8,1,1,0,0,5,290
066582714,206,4,1,4,0,0,2,217
066582715,218,13,0,0,0,0,7,238
066582716,178,13,1,2,0,0,3,197
066582801,218,18,2,3,11,3,5,260
066582802,341,15,2,5,2,1,12,378
066582803,277,13,1,1,3,0,12,307
066582804,363,15,7,1,5,3,11,405
066582805,259,18,4,5,1,3,8,298
066582806,340,6,4,2,1,1,6,360
066582807,294,2,1,1,0,0,6,304
066582808,338,23,6,3,0,0,2,372
066582809,339,15,3,1,0,0,14,372
066582810,370,12,4,3,2,0,15,406
066582901,381,21,12,1,2,1,12,430
066582902,214,24,4,2,2,2,2,250
066582903,218,19,4,2,2,1,7,253
066582904,238,18,3,2,2,0,7,270
066582905,339,17,0,3,1,0,8,368
066582906,335,18,1,1,2,0,6,363
066582907,368,6,5,3,1,0,3,386
066582908,367,5,1,0,0,0,5,378
066582909,264,5,3,0,0,1,4,277
066582910,328,7,1,1,0,0,6,343
066582911,344,3,6,5,9,0,5,372
066582912,429,15,6,0,1,3,5,459
066583001,381,4,11,6,7,0,9,418
066583002,340,13,1,2,1,0,13,370
066583003,300,13,2,0,0,0,3,318
066583004,260,21,3,1,1,0,6,292
066583005,338,15,2,7,0,0,13,375
066583006,329,20,2,4,2,1,10,368
066583007,375,16,3,3,3,0,1,401
066583008,367,11,2,6,0,2,7,395
066583009,397,7,3,2,0,0,8,417
066583010,283,12,0,2,0,0,5,302
066583011,362,11,4,0,0,0,2,379
066583012,245,5,2,0,0,1,6,259
066583101,295,1,4,4,1,1,24,330
066583102,379,0,9,5,2,1,19,415
066583103,633,2,2,3,1,0,9,650
066583104,408,6,2,5,3,0,12,436
066583105,310,1,13,3,0,0,3,330
066583106,1002,2,14,12,7,1,26,1064
066583107,306,2,2,1,1,2,3,317
066583108,220,6,1,2,2,0,7,238
066583109,264,1,10,0,1,1,10,287
066583110,392,0,2,3,1,0,4,402
066583111,311,2,4,5,0,3,3,328
066583112,233,0,0,2,1,0,9,245
066583113,183,0,5,1,8,2,5,204
066583201,237,0,3,1,0,0,1,242
066583202,381,0,0,8,1,1,10,401
066583203,360,0,6,7,7,1,15,396
066583204,190,2,3,2,0,1,1,199
066583205,246,1,4,3,0,1,4,259
066583206,94,0,0,1,0,0,2,97
066583207,506,8,2,5,0,1,4,526
066583208,537,1,7,2,1,2,7,557
066583209,139,0,1,2,3,0,3,148
066583210,413,0,4,2,0,0,6,425
066583211,178,0,0,1,0,0,3,182
066583212,502,6,3,8,2,1,13,535
066583213,309,0,0,1,1,0,4,315
066583301,509,0,2,4,0,1,12,528
066583302,288,0,0,0,0,0,5,293
066583303,276,1,1,0,0,0,3,281
066583304,340,0,0,1,0,0,3,344
066583305,572,1,0,0,0,0,9,582
066583306,439,0,3,17,0,0,11,470
066583307,381,2,0,2,0,0,9,394
066583308,196,0,1,1,0,0,0,198
066583309,372,2,2,3,0,0,7,386
066583310,266,2,0,2,0,0,7,277
066583311,371,0,11,5,1,3,13,404
066583312,311,0,1,3,1,2,6,324
066583313,265,2,3,27,1,3,14,315
066583401,385,1,8,4,0,0,19,417
066583402,274,1,0,3,3,0,1,282
066583403,297,0,1,1,1,1,1,302
066583404,276,0,2,1,1,0,1,281
066583405,295,2,4,1,0,2,1,305
066583406,381,2,9,12,0,2,10,416
066583407,304,1,11,2,1,0,3,322
066583408,334,2,1,6,1,0,4,348
066583409,263,2,8,9,2,2,10,296
066583410,236,0,3,6,2,0,10,257
066583411,362,0,4,6,2,4,10,388
066583412,355,0,7,12,1,6,9,390
066583413,382,0,4,9,4,0,10,409
066583501,262,0,3,2,1,0,9,277
066583502,383,6,2,0,3,0,10,404
066583503,263,10,7,0,1,0,7,288
066583504,349,16,3,10,1,1,7,387
066583505,226,10,11,5,0,0,7,259
066583506,390,18,5,1,0,0,4,418
066583507,286,9,8,5,0,0,6,314
066583508,397,6,3,3,1,0,3,413
066583509,320,7,4,0,0,0,7,338
066583510,393,5,3,3,0,0,9,413
066583601,443,13,1,1,0,2,12,472
066583602,476,10,4,2,3,0,7,502
066583603,321,10,22,3,2,0,18,376
066583604,238,5,0,1,0,0,16,260
066583605,290,0,7,1,0,0,13,311
066583606,181,12,4,1,3,2,8,211
066583607,504,21,7,5,0,0,13,550
066583608,290,7,0,0,0,1,2,300
066583609,247,7,4,4,8,1,6,277
066583610,267,18,1,3,0,0,14,303
066583611,445,8,2,1,0,0,3,459
066583612,342,1,0,1,0,0,10,354
066583613,267,5,1,3,0,0,0,276
066583614,248,8,0,2,1,0,5,264
066583701,456,21,1,2,1,0,5,486
066583702,590,16,0,5,1,0,10,622
066583703,264,1,0,0,0,0,0,265
066583704,221,11,1,1,0,0,7,241
066583705,186,43,10,18,2,0,42,301
066583706,238,1,1,0,0,0,0,240
066583707,335,3,1,0,0,0,2,341
066583708,393,1,0,0,0,0,4,398
066583709,286,11,1,0,0,0,1,299
066583710,247,17,0,0,0,1,3,268
066583711,400,2,1,0,0,0,9,412
066583712,508,17,2,1,1,0,14,543
066583713,455,16,1,1,1,0,1,475
066583801,354,10,2,0,0,0,4,370
066583802,357,3,2,0,0,0,6,368
066583803,228,1,0,0,0,0,2,231
066583804,296,14,1,1,0,0,7,319
066583805,343,9,0,1,0,0,7,360
066583806,433,4,1,0,0,0,5,443
066583807,94,1,2,1,0,0,3,101
066583808,247,3,0,0,0,0,4,254
066583809,196,5,0,2,0,0,3,206
066583810,211,0,0,1,0,0,1,213
066583811,470,12,1,2,0,1,19,505
066583812,285,4,2,1,1,0,4,297
066583813,325,6,2,1,1,1,4,340
066583814,352,14,1,4,0,0,11,382
066583815,368,10,3,2,1,2,18,404
066583816,480,17,4,2,0,3,7,513
066583901,385,7,2,0,0,0,6,400
066583902,366,5,0,0,0,0,2,373
066583903,337,2,0,0,1,0,6,346
066583904,237,0,0,1,0,1,4,243
066583905,349,7,0,1,0,0,4,361
066583906,293,3,0,2,0,0,7,305
066583907,339,4,2,2,1,0,3,351
066583908,287,4,1,1,0,0,4,297
066583909,237,3,3,0,0,0,5,248
066583910,467,6,1,3,5,0,3,485
066584001,395,5,2,3,0,0,10,415
066584002,311,6,1,14,0,0,12,344
066584003,291,13,2,24,0,0,9,339
066584004,427,9,2,11,1,0,5,455
066584005,333,7,0,1,0,0,4,345
066584006,131,3,0,0,0,0,0,134
066584007,402,0,1,3,0,0,7,413
066584008,215,0,1,2,0,0,2,220
066584009,180,1,0,0,0,0,0,181
066584010,139,0,1,1,0,0,0,141
066584011,184,2,0,0,0,0,1,187
066584012,335,3,1,2,0,0,8,349
066584013,331,3,0,1,0,0,3,338
066584014,257,4,0,1,0,0,2,264
066584015,485,2,1,2,1,0,7,498
066584016,337,6,1,1,0,0,5,350
066584017,451,4,2,2,1,0,6,466
066584101,262,2,2,1,1,0,11,279
066584102,548,10,2,2,0,1,7,570
066584103,411,8,0,2,0,0,10,431
066584104,401,4,2,3,0,0,10,420
066584105,408,20,5,0,1,0,7,441
066584106,423,8,6,5,1,1,11,455
066584107,491,2,1,13,6,0,19,532
066584108,383,4,3,1,0,0,4,395
066584109,427,6,2,1,0,0,24,460
066584110,409,17,3,3,0,0,4,436
066584111,233,9,1,1,0,0,0,244
066584112,303,8,0,1,0,0,9,321
066584113,414,2,6,5,1,0,5,433
066584114,270,8,1,1,1,0,5,286
066584115,269,12,0,2,0,0,11,294
066584201,236,5,1,3,0,0,1,246
066584202,261,11,2,1,4,0,9,288
066584203,327,11,2,4,2,0,11,357
066584204,213,5,1,0,0,4,5,228
066584205,279,2,0,0,0,1,6,288
066584206,257,6,1,0,0,0,4,268
066584207,200,7,3,27,0,0,6,243
066584208,320,21,7,1,3,0,5,357
066584209,433,15,7,8,2,0,8,473
066584210,371,13,6,3,0,2,12,407
066584211,231,20,7,0,0,0,2,260
066584212,375,23,15,6,50,1,11,481
066584213,405,8,0,0,0,1,5,419
066584301,285,14,1,1,0,0,0,301
066584302,393,16,0,2,0,1,6,418
066584303,439,12,0,1,2,0,14,468
066584304,449,8,0,0,0,1,2,460
066584305,268,1,0,0,0,0,4,273
066584306,315,3,0,0,0,0,5,323
066584307,187,5,0,4,3,0,1,200
066584308,444,2,2,1,0,0,16,465
066584309,185,5,2,3,0,0,4,199
066584310,229,4,2,1,0,1,2,239
066584311,343,9,1,2,0,2,6,363
066584312,368,13,6,7,1,0,7,402
066584401,319,14,1,4,0,1,6,345
066584402,310,5,1,0,4,0,7,327
066584403,384,13,4,0,0,0,3,404
066584404,497,12,1,1,1,0,4,516
066584405,317,7,5,2,0,1,4,336
066584406,310,11,3,4,0,0,5,333
066584407,220,1,4,0,0,0,15,240
066584408,397,22,0,0,2,0,6,427
066584409,470,7,0,3,3,0,3,486
066584410,360,5,0,3,0,0,6,374
066584411,459,6,2,1,0,0,9,477
066584412,378,4,1,1,0,0,5,389
066584413,132,4,1,3,0,0,0,140
066584414,185,1,0,1,0,0,3,190
067490101,25,1,0,0,3,0,1,30
067490102,310,2,0,0,0,0,5,317
067490103,316,5,3,6,0,0,10,340
067490104,78,0,0,0,0,0,2,80
067490105,129,0,0,0,1,0,4,134
067490201,196,3,6,1,1,6,5,218
067490202,343,2,11,4,2,1,6,369
067490203,339,0,9,4,2,0,10,364
067490204,346,3,9,2,4,0,15,379
067490205,324,1,12,4,3,2,6,352
067490206,118,16,3,5,1,11,23,177
067490207,243,1,3,5,2,0,21,275
067490208,294,49,6,1,0,2,22,374
067490209,336,25,7,1,11,0,15,395
067490210,339,20,1,6,3,1,14,384
067490211,260,19,4,1,4,0,11,299
067490212,233,21,5,0,0,0,2,261
067490213,261,33,13,0,2,0,4,313
067490301,310,51,11,2,9,1,7,391
067490302,141,22,18,2,6,1,5,195
067490303,228,41,6,2,5,1,7,290
067490304,322,34,13,1,3,0,13,386
067490305,281,17,8,7,7,2,12,334
067490306,163,19,3,1,2,2,4,194
067490307,211,13,5,6,1,0,12,248
067490308,238,20,27,0,10,6,4,305
067490309,232,36,4,4,10,0,5,291
067490310,248,47,30,3,3,0,19,350
067490311,311,52,60,2,18,3,16,462
067490312,360,61,6,8,3,0,7,445
067490401,19,14,0,0,0,0,3,36
067490402,38,11,0,1,0,0,0,50
067490403,222,29,11,0,5,0,2,269
067490404,314,85,14,2,6,2,3,426
067490405,43,9,0,0,0,0,2,54
067490406,239,22,4,4,6,0,8,283
067490501,143,15,8,0,5,0,14,185
067490502,244,23,23,2,8,3,17,320
067490503,287,51,16,2,21,3,15,395
067490504,293,46,30,3,6,0,13,391
067490505,245,15,18,2,1,0,13,294
067490506,281,54,20,1,4,1,15,376
067490507,194,48,19,0,18,0,21,300
067490508,169,12,35,0,11,5,18,250
067490509,233,28,17,5,1,1,10,295
067490510,234,30,15,1,1,0,8,289
067490511,136,15,40,0,5,0,9,205
067490512,198,34,5,6,13,0,9,265
067490513,111,50,3,1,11,0,12,188
067490601,188,26,51,1,5,0,14,285
067490602,328,36,9,0,0,2,17,392
067490603,340,38,29,3,18,2,25,455
067490604,177,26,14,2,2,0,16,237
067490605,278,30,8,3,4,1,21,345
067490701,360,26,2,0,1,1,5,395
067490702,279,21,7,7,3,0,9,326
067490703,274,21,4,5,0,1,14,319
067490704,353,21,3,1,2,0,5,385
067490705,430,23,1,0,1,1,7,463
067490706,286,26,2,2,2,0,22,340
067490707,367,27,13,3,1,1,13,425
067490708,426,40,0,4,0,1,18,489
067490709,91,0,0,0,0,0,5,96
067490801,254,14,6,1,0,0,24,299
067490802,171,12,7,0,2,0,4,196
067490803,209,8,1,0,0,0,15,233
067490804,303,19,3,1,0,0,4,330
067490805,355,9,4,3,0,0,3,374
067490806,237,14,1,0,1,0,10,263
067490807,364,19,5,2,2,0,7,399
067490808,278,10,6,0,3,0,6,303
067490809,245,15,1,2,1,0,6,270
067490901,283,22,10,2,4,0,10,331
067490902,369,15,2,4,2,0,8,400
067490903,429,13,4,2,0,0,10,458
067490904,385,24,4,2,1,0,9,425
067490905,392,23,6,0,0,0,8,429
067490906,282,4,0,1,1,0,3,291
067490907,233,15,3,4,1,0,13,269
067490908,296,18,4,1,3,0,16,338
067490909,318,10,1,1,1,1,9,341
067490910,255,15,2,1,2,0,4,279
067490911,378,23,11,6,5,1,11,435
067490912,382,23,2,1,0,0,11,419
067490913,124,1,0,0,0,0,2,127
067491001,448,19,5,0,1,0,11,484
067491002,307,16,2,0,0,1,25,351
067491003,365,13,4,7,1,0,11,401
067491004,315,9,1,2,0,0,7,334
067491005,378,18,5,2,1,0,8,412
067491006,373,30,5,2,0,0,2,412
067491007,289,13,6,0,0,0,10,318
067491008,163,14,0,0,0,0,13,190
067491009,254,4,5,1,0,3,10,277
067491010,211,20,3,2,0,0,5,241
067491011,329,15,3,1,1,0,8,357
067491012,278,29,6,64,0,2,6,385
067491013,182,8,4,0,0,0,5,199
067491101,223,7,2,0,0,0,6,238
067491102,328,3,2,1,0,0,6,340
067491103,242,3,2,0,0,0,6,253
067491104,109,6,2,1,0,0,1,119
067491105,240,9,7,2,0,1,5,264
067491106,176,9,0,0,0,0,1,186
067491107,270,14,7,1,1,0,6,299
067491108,159,2,0,0,0,0,0,161
067491109,141,13,2,2,5,0,4,167
067491110,264,18,2,2,0,2,9,297
067491111,239,10,4,0,3,0,9,265
067491112,183,10,8,0,0,0,4,205
067491113,381,20,11,3,1,2,24,442
067491114,361,21,4,4,3,0,14,407
067491201,276,2,6,0,0,0,4,288
067491202,321,8,6,3,6,0,6,350
067491203,406,5,4,1,0,0,10,426
067491204,381,16,2,0,1,1,7,408
067491205,409,8,17,1,0,2,13,450
067491206,245,10,0,2,0,0,5,262
067491207,268,3,6,2,2,0,4,285
067491208,332,22,12,0,0,0,11,377
067491209,229,1,0,0,0,0,6,236
067491210,362,17,4,5,2,0,6,396
067491211,380,9,0,1,2,0,3,395
067491301,265,0,0,1,0,0,6,272
067491302,390,7,0,0,0,0,5,402
067491303,247,15,2,0,0,0,0,264
067491304,398,2,3,1,0,0,11,415
067491305,372,8,1,2,0,1,4,388
067491306,421,6,0,1,0,0,2,430
067491307,9,0,0,0,0,0,0,9
067491308,177,4,0,11,0,0,7,199
067491309,221,10,0,0,0,0,1,232
067491310,268,10,3,0,0,0,4,285
067491311,213,1,1,1,0,0,4,220
067491312,272,4,15,6,0,1,2,300
067491313,214,6,4,1,0,0,2,227
067491314,269,4,0,0,0,0,7,280
067491315,229,10,6,2,0,0,2,249
067491316,452,27,3,3,0,1,11,497
067491317,220,6,1,2,0,0,1,230
067491318,273,7,0,2,1,0,1,284
067491319,280,8,0,0,0,1,5,294
067491320,157,0,0,0,0,0,0,157
067491321,195,7,1,0,0,0,0,203
067491401,172,4,3,0,4,0,11,194
067491402,284,4,0,1,0,0,1,290
067491403,155,8,4,0,0,0,3,170
067491404,266,11,1,2,0,2,4,286
067491405,299,10,1,2,0,0,13,325
067491406,301,8,0,1,0,0,9,319
067491407,356,3,2,1,0,1,3,366
067491408,320,7,2,1,0,0,2,332
067491409,257,4,0,2,0,0,6,269
067491410,265,5,1,3,0,1,3,278
067491411,95,0,0,0,0,0,1,96
067491412,363,11,2,2,0,0,5,383
067491413,378,24,3,3,2,0,10,420
067491414,361,19,2,3,0,1,5,391
067491415,309,9,0,0,0,0,2,320
067491416,291,7,2,1,0,0,0,301
067491417,454,5,0,1,0,1,0,461
067491418,153,51,3,2,0,0,6,215
067491419,343,2,1,0,0,0,2,348
067491420,147,3,0,0,0,0,2,152
067491501,25,4,1,2,0,15,46,93
067491502,75,46,0,0,0,15,1,137
067491503,34,0,2,0,0,46,22,104
067491504,86,120,1,0,0,18,28,253
067491505,76,2,3,0,0,100,49,230
067491506,23,0,0,1,0,1,21,46
067491507,26,0,0,1,0,6,31,64
067491508,57,0,0,1,0,32,44,134
067491509,100,14,2,2,0,88,50,256
067491510,120,30,6,2,1,131,31,321
067491511,130,1,0,1,0,193,30,355
067491512,98,19,0,5,0,12,53,187
067491513,70,11,0,0,1,22,12,116
067560101,245,1,10,9,0,9,12,286
067560102,159,13,3,5,1,2,6,189
067560103,197,2,4,6,4,2,3,218
067560104,298,1,8,1,1,0,7,316
067560105,271,1,5,3,1,1,5,287
067560106,249,3,7,5,4,0,12,280
067560107,437,0,9,3,2,0,21,472
067560108,194,0,10,3,8,0,7,222
067560109,200,1,3,0,4,0,3,211
067560110,387,11,4,4,0,2,16,424
067560111,194,16,10,2,0,0,16,238
067560112,329,11,32,1,9,0,3,385
067560113,302,28,5,4,3,1,20,363
067560114,375,23,9,4,2,1,14,428
067560115,185,9,11,1,1,1,8,216
067560116,351,25,3,1,5,0,14,399
067560117,289,15,1,0,2,0,19,326
067560201,256,19,3,1,6,1,2,288
067560202,224,20,1,4,7,0,5,261
067560203,379,26,1,3,5,0,6,420
067560204,255,19,1,7,0,0,5,287
067560205,248,20,5,18,0,5,1,297
067560206,268,39,14,4,52,0,11,388
067560207,328,37,8,2,15,0,11,401
067560208,212,21,9,3,10,1,0,256
067560209,301,48,16,0,16,2,20,403
067560301,185,34,15,2,58,1,18,313
067560302,133,29,16,0,77,1,58,314
067560303,197,36,30,3,22,1,18,307
067560304,249,43,8,1,17,3,18,339
067560305,137,40,13,0,41,0,6,237
067560306,148,25,6,0,9,0,55,243
067560307,400,101,9,0,1,0,21,532
067560308,266,40,19,2,87,4,22,440
067560309,238,41,11,1,121,1,16,429
067560310,328,73,16,2,23,1,24,467
067560401,254,34,8,9,3,3,8,319
067560402,276,43,7,8,6,2,12,354
067560403,321,54,20,3,3,0,24,425
067560404,284,53,13,2,9,3,17,381
067560405,305,34,20,7,8,0,11,385
067560406,223,26,7,4,3,0,7,270
067560407,296,35,8,2,4,1,13,359
067560408,190,25,5,2,5,5,15,247
067560501,260,40,10,6,1,3,12,332
067560502,280,31,19,10,5,1,25,371
067560503,239,39,17,3,2,1,5,306
067560504,297,35,17,11,15,1,31,407
067560505,231,43,5,7,2,0,10,298
067560506,237,42,16,6,8,0,26,335
067560507,246,48,4,2,2,1,19,322
067560508,267,48,11,3,14,0,22,365
067560509,242,55,6,2,13,5,16,339
067560510,257,21,13,4,0,0,13,308
067560601,371,38,5,1,8,1,28,452
067560602,253,65,13,1,2,1,8,343
067560603,188,30,5,1,18,0,12,254
067560604,132,35,7,0,45,0,1,220
067560605,238,46,4,0,11,0,19,318
067560606,246,50,12,0,45,1,19,373
067560607,337,62,27,0,14,0,17,457
067560608,218,21,6,5,5,1,11,267
067560609,267,41,15,1,26,4,17,371
067560610,341,54,21,0,12,2,11,441
067560611,189,26,3,6,6,1,8,239
067560612,215,23,9,5,9,1,7,269
067560701,269,28,16,0,13,1,11,338
067560702,222,56,8,2,5,1,3,297
067560703,148,18,4,0,16,0,9,195
067560704,312,34,15,3,11,0,15,390
067560705,287,39,13,0,7,1,14,361
067560706,291,38,38,0,61,1,24,453
067560707,300,39,8,1,39,0,26,413
067560708,250,35,5,0,1,0,0,291
067560709,279,22,6,3,14,1,16,341
067560710,319,20,8,1,7,3,10,368
067560801,314,25,5,3,5,1,15,368
067560802,279,17,4,4,0,0,12,316
067560803,314,35,7,3,3,0,8,370
067560804,359,35,0,2,2,0,8,406
067560805,360,25,12,1,8,0,14,420
067560806,407,34,5,5,3,0,10,464
067560807,301,18,5,6,3,0,8,341
067560808,355,23,4,3,1,0,11,397
067560809,309,35,10,3,1,2,15,375
067560901,197,24,13,6,9,0,6,255
067560902,180,14,72,2,3,0,7,278
067560903,329,18,4,2,5,1,11,370
067560904,357,23,8,1,5,0,10,404
067560905,374,34,2,3,1,1,14,429
067560906,398,34,14,5,7,0,8,466
067560907,410,28,9,5,3,1,5,461
067560908,378,35,2,1,2,0,10,428
067560909,332,22,2,1,1,1,10,369
067560910,330,28,10,6,3,0,6,383
067560911,266,24,1,3,2,0,17,313
067560912,311,15,3,4,2,0,14,349
067560913,249,21,3,4,0,0,12,289
067560914,345,16,5,1,3,1,15,386
067560915,332,32,6,4,1,0,8,383
067560916,265,19,2,5,0,1,16,308
067561001,220,20,11,0,14,0,12,277
067561002,192,42,17,1,10,0,8,270
067561003,315,29,14,1,17,0,26,402
067561004,329,55,19,0,17,4,24,448
067561005,195,19,7,1,0,1,19,242
067561006,370,53,8,0,1,2,21,455
067561007,245,43,3,1,11,0,10,313
067561008,243,50,6,0,36,2,13,350
067561009,139,24,21,1,3,1,19,208
067561010,317,50,14,2,3,6,6,398
067561011,306,34,5,5,4,0,12,366
067561012,322,22,8,1,9,2,14,378
067561101,203,30,12,3,3,0,10,261
067561102,207,31,12,2,8,0,15,275
067561103,292,20,25,1,10,1,14,363
067561104,273,30,18,1,12,0,19,353
067561105,353,45,22,1,8,2,35,466
067561106,337,56,14,1,5,0,6,419
067561107,368,74,28,2,1,1,7,481
067561108,229,41,8,0,1,0,6,285
067561109,167,25,21,0,3,0,6,222
067561110,239,29,14,0,14,0,8,304
067561111,308,34,21,0,72,1,13,449
067561112,309,39,17,4,48,18,27,462
067561113,250,21,5,2,4,1,2,285
067561201,345,14,3,1,8,0,28,399
067561202,215,31,17,1,8,0,17,289
067561203,248,18,8,1,0,1,4,280
067561204,471,15,3,3,4,0,4,500
067561205,274,19,2,5,11,2,19,332
067561206,186,61,3,0,1,0,4,255
067561207,167,45,11,1,8,0,11,243
067561208,344,56,6,1,1,0,17,425
067561209,315,17,2,3,7,0,4,348
067561210,254,25,5,2,3,0,5,294
067561211,328,33,4,2,5,1,24,397
067561301,271,29,12,1,0,2,3,318
067561302,191,19,2,4,0,1,4,221
067561303,388,17,3,4,3,0,4,419
067561304,306,13,6,3,2,2,5,337
067561305,341,23,5,3,4,1,8,385
067561306,259,22,1,2,0,2,11,297
067561307,287,21,10,4,1,0,13,336
067561308,346,30,1,6,6,0,37,426
067561309,350,0,0,0,0,0,6,356
067561310,272,0,0,0,0,0,12,284
067561311,367,21,3,1,4,0,14,410
067561312,335,31,9,3,3,0,8,389
067561313,379,23,6,0,1,1,22,432
067561314,492,10,0,0,0,0,6,508
067561401,523,11,0,0,1,0,5,540
067561402,644,24,0,1,0,0,14,683
067561403,215,8,1,0,0,0,12,236
067561404,221,5,3,0,2,0,3,234
067561405,200,14,4,2,0,0,9,229
067561406,247,11,3,0,2,1,10,274
067561407,386,28,5,0,0,0,10,429
067561408,316,65,1,0,2,0,1,385
067561409,346,6,0,9,1,0,8,370
067561410,487,4,0,1,0,0,3,495
067561411,262,1,1,0,0,0,2,266
067561412,241,6,0,0,0,0,5,252
067561413,195,5,0,0,0,0,3,203
067561414,265,1,0,0,0,0,4,270
067561415,261,13,6,0,0,2,3,285
067561501,391,33,7,7,5,1,15,459
067561502,335,7,2,4,0,0,7,355
067561503,312,6,3,0,0,0,18,339
067561504,440,26,5,3,0,0,15,489
067561505,381,19,6,3,7,0,10,426
067561506,288,18,2,0,0,0,2,310
067561507,216,23,2,2,3,0,2,248
067561508,201,18,5,1,1,0,8,234
067561509,212,11,3,1,1,1,17,246
067561510,294,33,3,6,6,0,12,354
067561511,323,36,8,5,0,2,13,387
067561512,206,29,7,3,0,3,4,252
067561601,306,27,5,4,7,1,7,357
067561602,255,18,0,2,5,0,4,284
067561603,273,8,3,1,3,2,12,302
067561604,284,31,2,0,0,0,13,330
067561605,205,21,9,5,2,1,20,263
067561606,188,7,2,1,0,1,8,207
067561607,276,62,3,0,0,1,34,376
067561608,273,34,17,2,1,0,5,332
067561609,278,10,3,1,3,0,6,301
067561610,193,14,20,2,5,1,5,240
067561611,330,18,6,1,2,2,27,386
067561612,259,30,7,3,1,1,3,304
067561613,270,26,7,5,3,2,8,321
067561701,304,30,10,1,16,2,10,373
067561702,394,32,6,6,3,1,7,449
067561703,300,28,5,1,0,0,6,340
067561704,299,21,4,3,8,0,10,345
067561705,194,24,4,2,5,0,9,238
067561706,270,19,3,1,2,0,20,315
067561707,332,16,7,5,3,0,14,377
067561708,378,22,6,1,4,1,26,438
067561709,371,31,2,2,21,0,27,454
067561710,324,75,5,1,0,1,7,413
067561801,257,22,1,0,5,3,2,290
067561802,389,42,7,3,1,0,3,445
067561803,292,23,8,1,2,0,2,328
067561804,340,14,9,7,2,0,10,382
067561805,199,5,3,1,2,0,9,219
067561806,229,23,4,3,4,1,3,267
067561807,203,17,4,3,1,1,4,233
067561808,60,1,0,0,8,0,5,74
067561809,227,36,5,0,0,1,10,279
067561810,296,24,5,1,1,0,23,350
067561811,419,30,18,1,4,0,15,487
067561901,370,16,7,6,4,0,12,415
067561902,399,15,8,5,1,2,6,436
067561903,258,11,4,0,0,0,6,279
067561904,221,10,1,7,1,0,4,244
067561905,412,19,4,5,2,0,7,449
067561906,412,32,4,0,2,0,13,463
067561907,359,27,0,0,2,0,8,396
067561908,409,26,2,0,1,0,10,448
067561909,362,21,9,4,2,0,14,412
067561910,278,2,5,1,7,1,7,301
067562001,260,2,13,1,7,0,15,298
067562002,296,29,3,2,12,0,10,352
067562003,362,1,5,1,2,0,7,378
067562004,182,0,1,0,0,0,5,188
067562005,209,2,4,0,1,0,2,218
067562006,176,15,2,1,0,0,5,199
067562007,442,15,7,2,2,0,8,476
067562008,350,17,9,4,2,0,11,393
067562009,278,19,0,4,1,1,5,308
067562101,372,28,9,6,4,5,22,446
067562102,249,11,1,1,0,0,4,266
067562103,213,12,0,1,0,0,6,232
067562104,432,43,8,2,2,0,15,502
067562105,236,11,0,2,0,3,20,272
067562106,307,43,2,6,0,0,15,373
067562107,165,17,5,1,0,2,3,193
067562108,329,37,4,8,0,12,6,396
067562109,295,33,10,5,4,0,14,361
067562110,74,3,6,0,7,0,9,99
067562111,283,21,6,1,6,0,18,335
067562201,530,26,4,0,1,0,17,578
067562202,333,7,0,3,1,1,9,354
067562203,453,20,2,0,0,0,11,486
067562204,320,6,0,1,0,0,6,333
067562205,260,25,3,1,2,0,6,297
067562206,309,9,0,7,0,0,2,327
067562207,232,4,0,3,0,0,4,243
067562208,206,7,0,1,0,0,13,227
067562209,259,17,5,3,5,2,11,302
067562210,262,14,7,1,0,2,9,295
067562211,333,39,7,3,0,1,5,388
067562212,200,12,4,2,1,2,1,222
067562213,184,16,2,1,1,0,3,207
067562301,565,21,0,0,0,0,4,590
067562302,266,7,0,0,0,0,5,278
067562303,234,15,1,2,0,0,5,257
067562304,354,15,3,0,2,0,11,385
067562305,315,14,1,1,2,0,20,353
067562306,276,11,4,0,0,0,32,323
067562307,378,14,8,4,1,2,23,430
067562308,322,33,4,12,1,0,16,388
067562309,325,17,3,1,4,1,11,362
067562310,272,8,2,0,2,0,5,289
067562401,293,7,6,2,0,0,9,317
067562402,158,8,11,1,0,0,4,182
067562403,186,6,1,1,0,1,2,197
067562404,225,0,1,2,3,0,6,237
067562405,235,0,4,1,2,0,6,248
067562406,303,2,7,5,3,0,5,325
067562407,191,1,1,2,0,0,10,205
067562408,202,1,3,1,1,0,12,220
067562409,227,1,3,1,5,3,5,245
067562410,249,0,1,2,0,0,3,255
067562411,386,3,8,2,4,0,10,413
067562412,398,1,4,1,4,0,20,428
067562413,342,0,12,1,6,0,16,377
067562501,270,2,0,1,0,0,3,276
067562502,305,19,12,0,4,1,14,355
067562503,201,11,6,2,0,0,6,226
067562504,169,6,1,0,0,0,10,186
067562505,230,24,4,4,1,1,5,269
067562506,208,14,0,3,1,1,2,229
067562507,194,8,2,6,0,0,8,218
067562508,183,16,2,1,1,0,0,203
067562509,334,25,3,3,0,1,8,374
067562510,298,12,3,0,4,0,13,330
067562511,210,1,0,1,0,0,3,215
067562512,349,16,4,1,3,1,12,386
067562513,288,21,5,4,6,0,6,330
067562514,273,19,4,2,5,0,24,327
067562515,329,11,7,3,1,1,9,361
067562516,349,25,3,10,2,0,6,395
067562517,258,21,6,1,1,0,9,296
067562518,381,30,4,4,0,0,9,428
067562519,349,17,15,5,1,0,25,412
067562601,363,6,0,0,11,0,27,407
067562602,234,0,0,0,7,0,7,248
067562603,175,5,0,0,6,0,15,201
067562604,230,5,0,0,9,0,23,267
067562605,215,3,0,0,8,0,14,240
067562606,339,8,0,0,12,0,34,393
067562607,362,4,0,0,11,0,17,394
067562608,359,6,0,0,10,0,25,400
067562609,212,2,0,0,7,0,13,234
067562610,186,2,0,0,3,0,6,197
067562611,374,3,0,0,10,0,18,405
067562701,361,0,0,0,0,0,6,367
067562702,424,7,2,1,1,1,6,442
067562703,280,2,0,5,0,0,6,293
067562704,298,1,0,1,0,0,2,302
067562705,381,0,0,1,0,0,3,385
067562706,463,0,0,2,0,1,10,476
067562707,195,0,0,1,0,0,1,197
067562708,218,0,4,1,0,0,4,227
067562709,214,0,4,1,1,0,6,226
067562710,235,1,1,2,0,0,5,244
067562711,426,0,4,0,1,0,3,434
067562712,359,0,2,2,0,0,6,369
067600101,290,2,0,0,0,0,6,298
067600102,259,0,10,2,0,0,16,287
067600103,293,8,11,1,0,1,12,326
067600104,267,3,1,2,2,0,5,280
067600105,446,4,11,4,5,1,21,492
067600106,243,1,11,4,1,1,19,280
067600107,429,6,4,4,2,0,4,449
067600108,354,2,4,7,0,0,10,377
067600109,395,2,1,7,0,0,16,421
067600110,312,0,0,0,0,0,5,317
067600111,209,5,2,3,0,1,11,231
067600112,222,6,7,0,15,0,8,258
067600113,300,22,10,33,1,1,9,376
067600114,405,15,5,1,1,0,15,442
067600115,263,22,5,1,1,0,5,297
067600116,197,20,14,0,1,1,10,243
067600117,213,29,16,0,0,0,4,262
067600201,416,5,18,3,3,0,9,454
067600202,394,3,13,1,6,1,21,439
067600203,218,35,22,4,8,0,13,300
067600204,274,41,11,2,4,1,12,345
067600205,272,5,61,3,19,5,11,376
067600206,264,25,21,4,87,2,20,423
067600207,311,75,49,1,81,0,16,533
067600208,134,3,10,3,12,3,7,172
067600209,165,17,6,1,45,0,13,247
067600210,389,22,21,1,3,0,17,453
067600211,251,2,15,3,1,0,5,277
067600212,280,4,20,2,1,0,22,329
067600213,366,19,53,5,3,0,12,458
067600214,226,24,44,0,10,0,14,318
067600215,202,38,34,5,21,0,7,307
067600216,178,50,32,0,30,0,18,308
067600217,194,26,11,1,14,4,25,275
067600301,198,0,7,0,0,0,4,209
067600302,462,6,10,4,2,1,17,502
067600303,280,4,1,2,1,1,14,303
067600304,283,10,2,1,0,0,11,307
067600305,332,0,1,1,1,0,69,404
067600306,215,0,6,2,4,2,46,275
067600307,84,0,7,0,0,0,31,122
067600308,261,2,13,3,2,0,49,330
067600309,184,0,14,3,2,4,43,250
067600310,71,0,0,1,0,0,16,88
067600311,349,43,14,0,1,0,6,413
067600312,73,3,19,1,0,1,9,106
067600313,412,113,65,0,1,0,7,598
067600314,316,86,71,2,1,8,14,498
067600315,261,36,13,2,9,1,38,360
067600316,131,37,8,2,2,2,21,203
067600317,300,44,17,7,17,0,9,394
067600401,202,28,0,0,1,0,2,233
067600501,522,17,9,6,1,4,10,569
067600502,311,22,11,4,9,8,10,375
067600503,436,17,23,14,5,2,29,526
067600504,228,27,2,0,0,0,4,261
067600505,370,39,8,5,1,0,6,429
067600506,295,22,11,1,0,2,20,351
067600507,354,33,10,4,2,2,29,434
067600508,480,47,8,3,6,0,11,555
067600509,404,26,6,5,3,1,16,461
067600510,535,20,5,6,0,3,44,613
067600511,728,29,14,11,4,1,40,827
067600512,353,28,13,2,5,2,23,426
067600601,338,24,13,1,4,0,9,389
067600602,359,25,3,1,2,1,16,407
067600603,277,21,2,1,1,1,11,314
067600604,272,31,4,3,1,0,6,317
067600605,285,32,3,4,1,3,6,334
067600606,261,20,4,2,0,0,10,297
067600607,324,11,6,1,0,1,9,352
067600608,273,22,5,1,0,2,4,307
067600609,354,19,2,4,3,0,5,387
067600610,387,6,2,1,0,0,3,399
067600701,504,24,17,12,5,4,15,581
067600702,497,18,10,10,4,4,10,553
067600703,423,43,30,1,5,2,20,524
067600704,378,18,6,7,10,2,15,436
067600705,429,29,1,6,1,5,9,480
067600706,239,13,6,5,2,0,15,280
067600707,236,20,2,4,3,0,14,279
067600708,302,26,5,0,1,1,15,350
067600709,352,20,4,7,1,2,5,391
067600710,463,29,4,10,0,5,11,522
067600801,320,52,15,6,5,3,18,419
067600802,419,33,12,8,4,1,10,487
067600803,369,29,13,2,0,2,19,434
067600804,350,19,12,1,0,0,7,389
067600805,216,21,3,2,0,0,16,258
067600806,346,10,8,5,5,3,6,383
067600807,480,29,11,9,0,6,19,554
067600808,206,19,0,5,0,3,5,238
067600809,337,29,12,7,2,5,1,393
067600810,306,14,6,13,1,0,13,353
067600811,218,21,8,1,2,1,3,254
067600812,354,26,18,5,5,4,13,425
067600901,233,8,6,1,0,0,9,257
067600902,193,9,1,5,0,2,4,214
067600903,305,13,2,1,3,1,8,333
067600904,253,18,4,4,2,3,8,292
067600905,259,46,15,3,4,0,13,340
067600906,213,27,7,23,12,0,5,287
067600907,386,38,17,23,9,0,16,489
067600908,210,32,10,4,4,1,3,264
067600909,225,25,13,3,19,0,5,290
067600910,410,39,11,6,1,1,15,483
067600911,432,33,10,13,1,13,11,513
067600912,423,27,8,12,0,5,10,485
067600913,381,28,2,0,1,2,17,431
067600914,323,15,0,2,0,0,7,347
067600915,172,11,6,7,0,1,7,204
067600916,238,12,0,3,1,0,5,259
067601001,167,2,3,0,0,0,3,175
067601002,254,4,1,4,0,0,4,267
067601003,173,0,0,4,0,0,0,177
067601004,230,8,0,0,0,0,0,238
067601005,192,9,2,2,1,0,5,211
067601006,54,2,0,0,0,0,2,58
067601007,92,2,0,0,0,1,3,98
067601008,97,1,0,0,0,0,1,99
067601009,219,7,0,1,0,0,5,232
067601010,68,3,0,0,0,0,0,71
067601011,117,7,0,0,1,1,2,128
067601012,390,9,4,5,1,1,2,412
067601013,353,9,1,6,0,1,6,376
067601014,288,6,0,2,0,0,6,302
067601015,367,6,7,3,0,1,5,389
067601101,222,20,7,3,0,1,3,256
067601102,252,11,1,3,0,0,5,272
067601103,550,14,5,1,1,1,15,587
067601104,391,14,2,2,2,1,9,421
067601105,184,18,1,1,0,0,3,207
067601106,623,26,11,4,3,1,21,689
067601107,363,12,7,4,0,0,11,397
067601108,521,29,1,2,0,0,8,561
067601109,226,6,3,2,1,1,5,244
067601110,391,7,3,5,0,1,7,414
067601111,491,8,2,5,0,3,17,526
067601112,178,10,2,2,0,0,4,196
067601113,221,12,1,1,0,1,4,240
067601114,157,9,1,0,8,0,12,187
067601115,161,7,3,1,0,10,3,185
067601116,138,21,3,3,0,1,8,174
067601117,214,20,3,5,0,1,12,255
067601201,212,19,4,8,2,3,6,254
067601202,227,2,0,3,2,6,9,249
067601203,99,9,0,1,0,0,6,115
067601204,166,19,11,8,0,12,13,229
067601205,253,18,1,4,0,10,7,293
067601206,171,39,37,13,0,2,31,293
067601207,107,4,0,0,0,2,14,127
067601208,228,15,0,5,0,10,4,262
067601209,206,27,0,5,0,6,5,249
067601210,208,10,4,2,0,1,7,232
067601211,293,19,1,5,0,6,11,335
067601212,291,21,1,10,0,4,3,330
067601213,4,0,0,0,3,244,0,251
067601214,303,9,0,2,0,0,2,316
067601215,285,9,0,3,0,0,7,304
067601216,315,0,0,3,0,0,16,334
067601217,343,3,1,1,0,0,4,352
067601218,190,21,1,1,0,0,11,224
067601219,252,3,0,0,0,0,1,256
067601301,195,8,1,6,1,1,18,230
067601302,317,14,2,4,1,1,13,352
067601303,157,5,0,3,4,0,10,179
067601304,200,4,0,1,0,0,6,211
067601305,266,12,0,2,2,0,3,285
067601306,334,10,1,2,1,1,13,362
067601307,222,3,0,1,6,0,9,241
067601308,238,3,1,1,5,0,9,257
067601309,341,28,1,3,0,0,6,379
067601310,395,11,2,3,0,0,1,412
067601311,322,15,0,0,0,0,10,347
067601312,307,20,1,3,1,3,9,344
067601313,252,18,7,4,0,5,31,317
067601314,394,19,2,1,0,0,4,420
067601315,377,26,0,5,0,12,2,422
067601316,181,8,0,6,1,0,3,199
067601401,217,5,2,3,0,0,11,238
067601402,213,3,0,1,0,0,5,222
067601403,287,11,0,2,0,0,9,309
067601404,397,12,3,10,0,0,4,426
067601405,290,5,0,2,0,2,4,303
067601406,499,31,0,4,0,0,9,543
067601407,311,8,0,5,0,0,8,332
067601408,257,19,2,6,0,0,20,304
067601409,360,4,1,3,0,1,9,378
067601410,299,7,0,4,0,1,3,314
067601411,239,1,0,0,0,0,3,243
067601412,379,6,0,0,0,0,9,394
067601413,339,4,3,2,0,0,5,353
067601414,222,5,1,0,0,1,7,236
067601415,113,13,0,0,0,0,1,127
067601501,281,10,2,5,1,2,9,310
067601502,229,22,3,1,1,0,8,264
067601503,154,9,0,0,0,0,17,180
067601504,208,8,1,0,0,1,1,219
067601505,417,12,1,1,0,0,11,442
067601506,191,4,2,0,0,0,1,198
067601507,301,4,0,2,0,1,2,310
067601508,311,6,1,0,0,2,3,323
067601509,376,6,0,0,0,0,5,387
067601510,178,1,0,0,0,0,0,179
067601511,202,3,1,0,1,0,0,207
067601512,335,10,18,4,0,2,8,377
067601513,265,9,2,0,0,0,3,279
067601514,220,11,1,3,0,4,3,242
067601515,193,16,6,1,0,0,4,220
067601516,200,12,0,0,0,1,3,216
067601601,246,11,3,2,0,1,2,265
067601602,235,8,3,0,1,1,6,254
067601603,330,21,1,4,0,1,3,360
067601604,296,16,1,6,0,0,4,323
067601605,347,4,2,1,1,0,9,364
067601606,380,13,2,2,0,2,4,403
067601607,286,8,3,1,1,0,7,306
067601608,321,6,1,5,0,0,5,338
067601609,204,3,0,3,0,0,7,217
067601610,250,6,4,2,0,0,5,267
067601611,212,12,3,4,0,1,6,238
067601612,178,6,1,2,3,1,7,198
067601613,321,13,1,1,0,0,10,346
067601614,301,5,1,0,1,0,4,312
067601701,332,9,0,1,0,1,6,349
067601702,289,24,2,1,0,0,1,317
067601703,263,17,3,4,0,0,4,291
067601704,291,6,2,5,1,2,3,310
067601705,323,3,0,3,0,1,3,333
067601706,332,2,1,1,0,1,2,339
067601707,263,4,1,0,0,0,12,280
067601708,356,14,2,1,0,0,23,396
067601709,287,10,5,2,1,0,2,307
067601710,291,4,3,0,1,12,6,317
067601711,229,7,0,2,12,0,1,251
067601712,263,7,0,3,0,0,1,274
067601713,247,2,3,7,0,3,6,268
067601714,265,15,5,3,1,1,8,298
067601715,331,10,0,0,0,0,2,343
067601716,221,5,0,2,0,1,6,235
067601801,274,3,0,2,0,1,5,285
067601802,296,8,1,3,0,0,5,313
067601803,327,7,0,0,0,0,2,336
067601804,314,12,0,2,0,0,1,329
067601805,215,3,3,0,0,1,1,223
067601806,250,5,1,1,0,2,7,266
067601807,260,6,2,1,0,0,2,271
067601808,346,7,1,2,0,0,8,364
067601809,259,9,0,3,0,0,5,276
067601810,276,6,0,1,0,1,8,292
067601811,275,3,1,1,0,0,4,284
067601812,337,5,0,4,0,1,12,359
067601813,248,11,0,0,0,0,1,260
067601814,274,7,0,0,0,1,6,288
067601815,242,5,0,2,0,0,3,252
067601816,237,9,0,1,0,0,8,255
068050101,192,9,1,9,0,56,8,275
068050102,191,20,3,1,0,24,6,245
068050103,148,7,4,3,0,14,6,182
068050104,301,22,7,8,0,55,18,411
068050105,110,16,0,50,0,7,1,184
068050106,153,30,1,46,0,8,4,242
068050107,247,28,1,45,0,7,5,333
068050108,162,18,7,26,0,3,2,218
068050201,107,6,0,0,1,24,1,139
068050202,204,16,7,58,0,5,5,295
068050203,354,12,2,5,0,4,6,383
068050204,376,19,3,9,0,5,12,424
068050205,424,16,4,15,1,3,4,467
068050301,87,16,8,11,61,38,130,351
068050302,132,17,0,4,0,5,8,166
068050303,287,5,2,7,3,10,9,323
068050304,513,53,10,19,1,120,13,729
068050305,421,41,140,15,15,15,29,676
068050306,388,189,28,14,1,66,149,835
068050307,407,48,6,67,0,3,8,539
068050308,218,14,1,12,0,2,7,254
068050309,151,23,6,35,0,3,26,244
068050310,134,1,0,16,0,10,12,173
068050311,378,44,4,10,0,4,14,454
068050401,217,36,1,7,1,37,13,312
068050402,230,3,5,1,0,0,3,242
068050403,507,6,2,5,0,0,5,525
068050404,431,3,2,1,0,1,4,442
068050405,436,1,0,2,0,1,5,445
068050406,310,0,1,2,0,0,1,314
068050407,621,16,1,5,1,0,3,647
068050408,276,1,1,2,0,0,5,285
068050409,382,1,0,3,1,0,21,408
068050410,449,0,1,0,1,0,3,454
068050411,426,24,2,45,5,31,47,580
068050412,687,9,5,12,0,16,6,735
068050501,341,2,6,3,1,0,23,376
068050502,336,0,12,6,2,4,16,376
068050503,395,8,15,6,1,0,21,446
068050504,250,1,25,1,1,2,10,290
068050505,265,2,4,2,0,1,2,276
068050506,277,1,4,1,0,0,6,289
068050507,497,7,19,7,0,2,9,541
068050508,371,5,9,3,1,0,6,395
068050509,254,7,1,1,6,1,10,280
068050510,261,1,2,5,1,2,6,278
068050511,447,2,3,8,2,0,3,465
068050512,439,1,0,2,0,0,12,454
068050513,368,3,0,6,0,0,4,381
068050601,665,0,0,0,0,0,8,673
068050602,184,18,12,3,2,3,26,248
068050603,349,31,3,0,0,0,14,397
068050604,368,35,12,1,1,2,15,434
068050605,201,62,10,0,0,0,95,368
068050606,213,52,2,1,0,1,7,276
068050607,117,29,12,0,2,2,6,168
068050608,328,90,23,0,20,12,8,481
068050609,378,57,53,3,11,1,9,512
068050610,342,85,5,1,8,0,82,523
068050611,296,23,11,6,2,1,10,349
068050612,345,50,29,1,7,1,32,465
068050701,155,19,4,3,3,2,143,329
068050702,251,16,1,0,1,0,5,274
068050703,340,20,2,1,0,2,8,373
068050704,242,21,0,10,1,1,109,384
068050705,262,5,1,3,1,1,97,370
068050706,140,18,5,2,1,0,390,556
068050707,124,17,1,3,0,1,191,337
068050708,26,17,3,2,0,0,324,372
068050709,77,8,4,1,0,0,129,219
068050710,28,11,1,1,0,0,286,327
068050711,34,13,5,0,6,0,278,336
068050801,134,30,13,8,12,25,296,518
068050802,85,27,4,2,12,166,127,423
068050803,182,35,32,2,0,2,185,438
068050804,234,112,7,0,0,35,66,454
068050805,171,27,6,4,0,2,113,323
068050806,263,30,1,1,1,27,10,333
068050807,356,16,4,1,2,1,8,388
068050808,287,35,17,0,1,1,12,353
068050809,404,9,3,1,1,1,7,426
068050810,188,10,2,0,2,0,4,206
068050811,387,7,1,2,1,0,16,414
068050812,232,6,0,1,0,0,14,253
068050813,500,3,0,1,2,0,6,512
068050814,392,7,9,2,4,0,2,416
068050901,1,0,0,0,0,0,13,14
068050902,287,6,2,0,0,2,2,299
068050903,298,15,1,0,0,0,7,321
068050904,597,16,0,3,3,2,14,635
068050905,596,60,18,40,0,23,38,775
068050906,559,48,4,21,0,23,41,696
068051001,484,20,6,3,4,0,12,529
068051002,292,8,3,0,0,0,5,308
068051003,298,5,6,0,0,0,3,312
068051004,475,22,1,4,0,0,3,505
068051005,251,11,2,2,0,0,9,275
068051006,382,19,3,4,0,0,4,412
068051007,369,10,0,1,0,0,1,381
068051008,498,5,0,1,1,0,1,506
068051009,451,22,0,6,0,0,4,483
068051010,294,4,0,0,0,0,2,300
068051011,276,7,0,1,0,0,5,289
068051012,287,25,1,10,0,0,5,328
068051013,225,14,2,4,0,0,6,251
068051101,331,2,0,0,1,1,4,339
068051102,237,4,1,2,0,1,3,248
068051103,485,23,6,16,1,3,11,545
068051104,465,21,21,7,0,1,4,519
068051105,403,20,1,4,0,2,6,436
068051106,337,5,0,0,0,0,2,344
068051107,380,3,1,1,0,0,5,390
068051108,424,18,2,2,0,0,9,455
068051109,345,11,0,0,0,0,6,362
068051110,452,8,0,1,1,0,5,467
068051201,245,6,16,10,1,1,4,283
068051202,315,23,5,3,0,1,9,356
068051203,335,34,16,1,3,2,6,397
068051204,266,13,8,5,1,1,2,296
068051205,277,25,3,2,4,1,7,319
068051206,232,14,5,0,0,0,7,258
068051207,260,7,0,5,3,2,6,283
068051208,249,11,3,2,2,2,7,276
068051209,208,7,2,0,6,0,9,232
068051210,568,31,12,8,6,7,15,647
068051211,334,22,3,2,3,1,10,375
068051212,416,26,7,3,23,1,16,492
068051213,279,21,1,2,0,2,6,311
068051214,272,18,4,7,0,5,8,314
068051301,388,22,0,52,0,6,7,475
068051302,394,29,5,30,0,9,5,472
068051303,441,14,2,15,0,6,3,481
068051304,383,22,2,2,1,6,10,426
068051305,336,26,5,0,3,1,14,385
068051306,245,12,0,2,0,0,5,264
068051307,291,19,9,3,0,0,0,322
068051308,568,16,1,2,0,1,7,595
068051309,248,0,1,1,0,1,4,255
068051310,188,10,1,1,0,0,1,201
068051311,389,10,3,3,3,0,3,411
068051312,380,23,6,0,0,0,13,422
068051313,341,14,5,3,0,4,14,381
068051314,312,14,2,9,1,3,3,344
068051315,269,10,7,0,0,0,4,290
068051316,367,33,7,1,0,0,9,417
068051317,245,16,7,0,0,0,9,277
068051318,476,13,2,3,0,0,8,502
068051401,397,5,2,2,0,0,1,407
068051402,225,4,3,1,0,0,3,236
068051403,347,12,0,1,0,0,2,362
068051404,319,10,6,2,0,2,4,343
068051405,425,12,4,6,1,0,7,455
068051406,297,5,4,5,2,1,3,317
068051407,298,16,3,1,0,1,2,321
068051408,280,2,0,2,0,0,6,290
068051409,324,10,5,1,0,0,5,345
068051410,286,8,4,4,0,1,6,309
068051411,327,8,0,3,0,0,6,344
068051412,287,4,1,0,0,1,3,296
068051413,340,8,1,0,0,0,7,356
068051414,361,2,0,2,0,0,2,367
068051415,343,6,4,2,0,0,6,361
068051416,481,11,4,1,0,0,16,513
068051501,256,12,4,4,3,1,10,290
068051502,277,18,2,4,0,0,10,311
068051503,373,17,15,5,1,0,15,426
068051504,324,9,2,3,0,5,7,350
068051505,313,11,5,10,0,1,7,347
068051506,432,22,3,7,1,8,8,481
068051507,368,15,11,5,1,8,7,415
068051508,405,40,7,1,0,0,2,455
068051509,404,11,2,5,1,2,6,431
068051510,342,13,1,7,0,0,5,368
068051511,288,8,3,0,0,2,5,306
068051512,225,14,3,3,2,3,1,251
068051513,352,17,5,9,2,4,6,395
068051601,337,12,3,0,0,0,4,356
068051602,513,19,3,0,0,1,4,540
068051603,301,11,3,1,0,0,3,319
068051604,411,9,1,1,0,2,4,428
068051605,272,15,3,6,1,1,3,301
068051606,313,8,0,0,0,1,5,327
068051607,346,11,0,1,5,0,4,367
068051608,271,18,0,1,1,1,7,299
068051609,294,23,3,3,0,0,2,325
068051610,329,15,0,2,5,0,2,353
068051611,349,24,2,0,0,4,5,384
068051701,345,6,1,2,0,0,6,360
068051702,342,23,3,3,3,0,4,378
068051703,230,12,9,5,5,0,5,266
068051704,250,17,3,2,6,1,6,285
068051705,390,16,0,2,4,0,40,452
068051706,415,25,0,4,1,0,4,449
068051707,435,27,7,3,2,0,5,479
068051708,428,15,4,2,3,0,8,460
068051709,380,29,3,5,0,2,6,425
068051710,299,18,0,7,0,0,3,327
068051711,355,15,1,0,1,0,4,376
068051801,180,10,0,0,0,0,5,195
068051802,227,11,8,1,0,0,3,250
068051803,403,30,9,5,0,2,19,468
068051804,380,19,5,3,0,4,19,430
068051805,330,38,4,2,2,9,19,404
068051806,254,16,2,0,1,1,5,279
068051807,263,15,0,5,0,0,1,284
068051808,403,20,4,1,0,0,7,435
068051809,359,21,2,1,5,1,4,393
068051810,407,28,4,4,2,1,7,453
068051811,408,45,19,6,9,0,10,497
068051812,213,8,1,4,0,0,4,230
068051901,194,7,1,2,0,0,4,208
068051902,265,14,1,7,0,2,2,291
068051903,293,23,6,4,7,6,11,350
068051904,216,16,5,4,2,3,5,251
068051905,276,5,1,5,0,2,5,294
068051906,426,20,0,2,0,1,5,454
068051907,236,16,1,4,3,2,13,275
068051908,217,20,1,2,1,2,4,247
068051909,287,17,1,2,0,1,1,309
068051910,211,11,5,2,1,0,3,233
068051911,459,25,15,9,9,1,9,527
068051912,394,39,2,5,2,2,3,447
068051913,82,7,0,2,0,7,1,99
068051914,279,22,1,1,0,11,7,321
068052001,168,9,0,0,0,0,1,178
068052002,230,7,0,1,1,0,20,259
068052003,209,8,3,0,2,0,4,226
068052004,518,14,3,8,1,0,13,557
068052005,403,21,2,1,1,0,8,436
068052006,289,10,2,0,0,1,1,303
068052007,496,12,0,33,0,0,5,546
068052008,228,18,0,0,0,0,1,247
068052009,329,8,3,4,0,0,5,349
068052010,292,6,5,4,0,0,3,310
068052011,346,4,2,4,0,2,4,362
068052012,269,15,1,0,0,1,5,291
068052013,251,9,3,1,0,0,6,270
068052014,297,32,3,4,0,4,2,342
068052101,287,2,2,1,0,1,7,300
068052102,257,2,0,0,0,0,2,261
068052103,495,12,3,2,0,0,3,515
068052104,526,19,3,4,1,1,4,558
068052105,338,11,2,4,2,0,3,360
068052106,274,12,3,1,0,0,7,297
068052107,205,1,0,4,0,0,4,214
068052108,305,0,2,1,0,0,7,315
068052109,284,7,3,2,0,0,3,299
068052110,309,5,1,0,3,0,3,321
068052111,366,8,1,1,0,0,3,379
068052112,341,6,0,0,0,1,0,348
068052113,301,11,1,1,0,2,3,319
068052114,268,8,1,4,0,1,11,293
068052201,403,7,1,3,1,0,2,417
068052202,473,8,1,5,1,0,10,498
068052203,461,7,4,3,0,1,2,478
068052204,458,7,2,5,0,0,1,473
068052205,520,19,3,1,0,2,10,555
068052206,355,22,6,1,0,2,15,401
068052207,322,10,3,3,1,1,9,349
068052208,318,22,3,3,0,10,7,363
068052209,409,47,8,13,6,29,12,524
068052210,267,25,1,6,2,10,3,314
068052301,312,12,0,3,0,0,5,332
068052302,373,17,1,2,0,3,8,404
068052303,465,19,15,7,0,5,10,521
068052304,407,5,3,7,2,2,9,435
068052305,312,6,9,6,2,1,12,348
068052306,322,25,5,3,0,8,10,373
068052307,373,4,3,2,1,0,9,392
068052308,226,2,1,6,0,4,2,241
068052309,203,3,0,1,0,0,4,211
068052310,320,4,2,2,0,8,3,339
068052311,186,18,2,3,0,2,6,217
068052312,1049,49,3,4,1,0,22,1128
068052313,345,36,1,79,0,7,11,479
068052314,441,9,0,3,1,0,2,456
068052315,334,1,0,1,0,1,3,340
068052401,404,19,5,6,4,24,11,473
068052402,414,27,7,1,0,1,2,452
068052403,313,31,6,5,0,19,10,384
068052404,361,29,9,3,4,5,4,415
068052405,392,15,11,4,0,8,1,431
068052406,206,16,0,5,1,1,3,232
068052407,183,14,5,11,0,6,7,226
068052408,340,16,5,9,0,3,12,385
068052409,374,6,5,5,1,2,6,399
068052410,355,8,2,5,0,3,2,375
068052501,269,34,4,12,0,34,14,367
068052502,281,8,0,20,0,2,14,325
068052503,154,17,4,5,1,15,2,198
068052504,134,20,2,2,0,9,13,180
068052505,399,11,1,4,0,0,17,432
068052506,386,10,4,2,0,0,5,407
068052507,584,20,3,5,0,6,8,626
068052508,203,79,5,1,1,49,54,392
068052509,248,15,5,3,0,3,12,286
068052510,257,12,5,2,1,2,4,283
068052511,330,21,4,5,0,2,10,372
068052512,423,10,1,5,0,2,13,454
068052601,47,1,5,1,2,152,27,235
068052602,73,109,7,1,0,83,52,325
068052603,150,46,9,5,0,167,46,423
068052604,68,73,12,1,1,146,40,341
068052605,51,65,8,1,1,144,8,278
068052606,44,0,9,1,0,79,28,161
068052607,27,1,2,2,0,77,22,131
068052608,78,17,1,5,5,152,37,295
068052609,293,141,14,18,0,185,56,707
068052610,213,42,1,2,6,198,59,521
068052611,112,11,5,4,0,198,61,391
068052612,80,3,4,3,2,218,17,327
068052613,83,1,3,7,0,238,41,373
068052614,36,8,0,0,0,117,7,168
068052615,115,47,5,1,0,86,58,312
068052616,56,24,8,3,0,106,39,236
068052617,18,19,1,2,0,10,6,56
068052618,74,19,4,5,0,69,59,230
068052619,115,50,4,0,0,46,35,250
068052620,171,50,3,19,0,203,31,477
068052621,70,4,6,7,0,130,8,225
068400101,117,5,0,0,0,0,1,123
068400102,332,11,0,2,0,0,2,347
068400103,476,7,1,2,0,1,9,496
068400104,231,5,1,2,2,0,18,259
068400105,490,11,1,4,1,0,3,510
068400106,349,14,2,0,1,0,1,367
068400107,252,12,0,3,1,1,9,278
068400108,166,2,0,0,0,0,0,168
068400109,274,11,2,0,1,0,6,294
068400110,410,7,3,0,0,0,3,423
068400111,293,12,4,0,0,0,6,315
068400112,286,14,2,2,3,0,12,319
068400113,567,20,3,6,0,0,9,605
068400201,329,5,3,2,0,0,5,344
068400202,347,17,7,3,1,3,9,387
068400203,292,20,6,3,0,0,12,333
068400204,259,14,2,0,3,0,20,298
068400205,292,7,1,0,1,1,18,320
068400206,324,11,0,1,3,0,35,374
068400207,211,10,0,3,2,1,11,238
068400208,228,29,6,1,2,1,12,279
068400209,317,7,10,2,5,0,22,363
068400210,271,19,1,0,4,0,11,306
068400211,283,8,10,2,1,1,5,310
068400212,366,14,2,1,0,0,15,398
068400301,348,19,10,2,4,0,8,391
068400302,396,26,5,3,2,0,5,437
068400303,301,7,2,1,0,0,10,321
068400304,379,16,2,0,3,0,8,408
068400305,377,15,3,0,0,0,2,397
068400306,304,9,3,3,11,1,4,335
068400307,361,11,0,1,1,0,9,383
068400308,430,17,3,0,2,1,10,463
068400309,288,8,4,2,0,0,4,306
068400310,257,8,1,0,1,0,2,269
068400311,460,23,5,4,0,0,6,498
068400312,412,6,4,3,1,0,7,433
068400401,469,10,8,2,0,0,6,495
068400402,371,4,1,3,0,0,4,383
068400403,240,7,0,0,0,0,3,250
068400404,231,8,8,3,1,0,5,256
068400405,240,19,3,2,1,0,13,278
068400406,234,4,3,0,2,1,9,253
068400407,312,15,2,0,2,0,15,346
068400408,149,9,1,1,0,0,3,163
068400409,281,7,4,0,1,0,4,297
068400410,414,10,7,2,6,0,4,443
068400411,298,7,1,2,0,0,5,313
068400412,168,10,0,1,0,0,8,187
068400413,353,12,2,1,3,0,7,378
068400414,341,33,2,12,3,0,8,399
068400415,345,25,0,4,1,0,5,380
068400416,372,24,1,10,0,5,9,421
068400417,396,11,1,2,2,0,4,416
068400501,257,7,6,1,1,0,5,277
068400502,271,10,0,1,4,0,10,296
068400503,314,19,3,0,3,0,1,340
068400504,283,13,3,0,1,0,5,305
068400505,227,18,9,0,4,0,7,265
068400506,191,12,5,6,1,0,8,223
068400507,254,25,7,4,4,0,103,397
068400508,412,45,6,0,1,0,18,482
068400509,225,12,1,2,4,0,10,254
068400510,287,10,15,10,11,4,10,347
068400511,455,33,27,6,1,3,13,538
068400512,393,18,0,1,3,0,5,420
068400601,314,15,2,2,3,2,14,352
068400602,192,10,2,0,0,0,3,207
068400603,214,1,1,1,0,0,4,221
068400604,276,6,2,0,0,0,4,288
068400605,350,15,5,4,1,1,5,381
068400606,392,11,12,5,0,0,10,430
068400607,287,24,11,1,3,1,8,335
068400608,210,8,7,2,1,0,4,232
068400609,172,10,4,4,2,3,6,201
068400610,235,10,7,2,0,2,7,263
068400611,204,11,2,0,5,0,13,235
068400612,194,9,3,2,0,1,7,216
068400613,270,8,0,2,1,0,3,284
068400614,342,15,3,6,1,0,9,376
068400615,296,14,6,5,6,0,6,333
068400616,296,12,19,6,2,0,24,359
068400701,393,18,9,1,2,0,6,429
068400702,389,26,12,4,3,1,12,447
068400703,284,23,7,3,5,0,10,332
068400704,304,25,5,12,0,0,17,363
068400705,244,12,2,1,1,1,16,277
068400706,284,23,7,3,2,0,6,325
068400707,306,18,7,5,2,0,10,348
068400708,337,19,4,6,1,0,17,384
068400709,348,28,12,4,2,2,10,406
068400710,379,45,16,8,20,1,9,478
068400711,331,30,10,4,5,0,15,395
068400801,289,17,8,5,5,1,12,337
068400802,166,8,9,3,1,0,8,195
068400803,166,7,2,2,0,0,14,191
068400804,286,14,6,2,7,0,11,326
068400805,320,20,8,3,3,0,17,371
068400806,210,22,10,2,0,0,2,246
068400807,253,6,12,2,0,0,11,284
068400808,217,16,0,2,1,0,5,241
068400809,346,32,20,3,0,0,11,412
068400810,238,16,6,1,1,0,3,265
068400811,296,37,16,9,6,1,5,370
068400812,351,23,20,9,1,0,6,410
068400901,295,21,3,7,0,0,4,330
068400902,215,28,4,1,0,0,1,249
068400903,324,26,6,3,0,0,10,369
068400904,209,21,2,1,1,1,3,238
068400905,208,0,2,0,1,2,13,226
068400906,305,1,2,4,2,0,4,318
068400907,281,1,6,3,0,0,7,298
068400908,231,9,2,2,0,1,15,260
068400909,236,6,2,3,2,0,5,254
068400910,287,0,5,2,0,0,13,307
068401001,404,11,5,8,1,5,20,454
068401002,438,3,15,3,2,0,9,470
068401003,238,40,9,5,3,1,3,299
068401004,315,0,13,2,3,0,20,353
068401005,205,2,3,0,1,0,9,220
068401006,321,3,8,0,4,1,18,355
068401007,300,8,15,3,4,0,6,336
068401008,256,26,10,0,1,0,24,317
068401009,186,39,3,2,11,1,12,254
068401010,249,2,22,1,21,0,27,322
068401011,253,36,12,5,11,0,14,331
068401012,164,2,7,1,4,0,10,188
068401013,229,6,10,2,8,0,5,260
068401101,282,2,4,11,1,2,13,315
068401102,225,0,10,2,3,1,8,249
068401103,165,8,5,0,0,1,10,189
068401104,96,2,0,1,0,0,0,99
068401105,249,1,7,2,1,0,16,276
068401106,374,4,8,7,2,0,23,418
068401107,277,1,11,9,4,1,12,315
068401108,401,13,6,9,0,1,13,443
068401109,296,4,7,3,0,0,8,318
068401110,341,11,14,4,3,0,14,387
068401111,328,5,7,2,3,1,16,362
068401112,320,4,3,3,3,1,13,347
068401201,346,16,6,6,3,0,21,398
068401202,369,0,5,5,4,1,22,406
068401203,351,5,5,1,5,0,19,386
068401204,178,2,3,1,3,0,8,195
068401205,306,1,2,2,5,2,9,327
068401206,4,0,0,0,0,0,0,4
068401207,186,2,4,0,0,1,20,213
068401208,228,10,19,2,3,0,3,265
068401209,265,3,12,5,1,1,6,293
068401210,312,2,3,2,4,0,15,338
068401211,349,18,11,1,5,0,9,393
068401301,307,11,6,3,3,0,16,346
068401302,200,4,2,0,0,1,9,216
068401303,392,20,8,0,3,0,8,431
068401304,337,21,3,5,2,1,15,384
068401305,270,17,5,5,4,0,12,313
068401306,226,17,5,5,8,1,7,269
068401307,194,30,15,2,1,0,5,247
068401308,214,4,6,5,5,1,8,243
068401309,334,47,3,1,9,0,15,409
068401310,403,17,7,5,7,0,18,457
068401311,234,21,9,4,4,0,9,281
068401312,351,61,11,1,8,1,10,443
068401313,205,58,19,1,10,2,15,310
068401314,178,25,27,5,23,1,5,264
068401401,319,28,10,2,8,0,22,389
068401402,163,16,7,1,1,0,7,195
068401403,240,15,9,2,0,1,4,271
068401404,368,28,9,7,2,1,16,431
068401405,205,21,5,2,2,3,27,265
068401406,256,19,5,4,7,0,12,303
068401407,277,17,14,3,5,0,10,326
068401408,155,9,1,0,1,0,8,174
068401409,283,33,12,2,2,1,8,341
068401410,298,27,7,2,1,0,10,345
068401501,209,32,16,7,2,1,110,377
068401502,389,32,31,5,4,0,13,474
068401503,258,29,17,2,1,0,11,318
068401504,224,15,7,1,1,1,12,261
068401505,375,58,28,2,6,0,13,482
068401506,365,36,21,2,4,0,19,447
068401507,180,18,6,1,9,1,13,228
068401508,249,35,11,5,3,0,9,312
068401509,325,28,19,2,5,0,25,404
068401510,368,49,48,3,4,0,31,503
068401511,181,25,22,4,2,0,4,238
068401512,221,16,0,3,0,0,16,256
068401513,314,23,20,8,5,0,23,393
068401514,320,30,7,3,5,0,22,387
068401601,250,17,13,1,4,0,7,292
068401602,268,12,15,0,7,0,12,314
068401603,291,38,18,3,0,0,6,356
068401604,304,27,5,1,3,0,11,351
068401605,309,55,23,4,6,0,14,411
068401606,311,31,36,6,2,0,19,405
068401607,213,14,3,2,3,0,10,245
068401608,334,34,26,1,3,1,23,422
068401609,307,35,19,6,4,0,16,387
068401610,189,10,1,0,1,2,25,228
068401611,169,14,18,1,10,0,12,224
068401612,197,33,12,3,10,0,12,267
068401613,320,46,9,7,3,0,8,393
068401614,157,19,8,1,6,1,8,200
068401701,269,16,6,4,5,0,23,323
068401702,434,29,3,0,0,0,19,485
068401703,324,26,4,4,7,1,36,402
068401704,243,18,8,1,1,1,65,337
068401705,289,14,9,3,0,0,10,325
068401706,395,32,36,4,2,3,20,492
068401707,237,18,4,1,0,0,7,267
068401708,278,34,3,0,4,0,8,327
068401709,200,15,9,1,3,0,2,230
068401710,236,16,9,10,0,0,8,279
068401711,177,7,11,6,2,2,7,212
068401712,200,22,5,0,2,0,12,241
068401713,209,21,4,0,7,0,7,248
068401801,113,0,0,0,0,0,1,114
068401802,264,29,28,12,7,0,9,349
068401803,162,23,12,1,7,0,23,228
068401804,217,21,7,1,12,0,15,273
068401805,165,15,8,4,23,1,22,238
068401806,363,52,48,6,27,1,35,532
068401807,385,34,29,3,7,1,15,474
068401808,355,9,16,5,9,1,20,415
068401809,339,20,3,2,2,0,16,382
068401810,333,21,6,3,0,1,10,374
068401811,225,17,7,0,5,0,6,260
068401812,209,14,4,1,6,1,11,246
068401813,336,23,8,1,5,0,19,392
068401814,267,23,8,0,1,0,11,310
068401901,198,39,10,2,4,0,10,263
068401902,224,44,30,3,8,0,11,320
068401903,335,39,25,3,2,3,15,422
068401904,433,40,18,3,28,3,24,549
068401905,317,15,11,2,10,1,8,364
068401906,330,19,12,10,1,0,19,391
068401907,252,15,1,2,5,0,17,292
068401908,269,15,6,2,5,0,10,307
068401909,235,15,5,1,1,0,6,263
068401910,210,11,12,3,1,0,23,260
068401911,268,24,4,1,1,0,17,315
068401912,246,13,5,1,1,2,11,279
068402001,288,20,8,3,5,1,13,338
068402002,263,19,7,6,1,0,7,303
068402003,354,11,15,1,2,0,12,395
068402004,351,27,9,3,1,0,4,395
068402005,323,6,6,2,5,0,17,359
068402006,318,19,7,3,6,0,14,367
068402007,270,12,10,2,3,1,23,321
068402008,191,5,5,2,1,0,14,218
068402009,274,11,2,3,1,0,7,298
068402010,231,8,11,2,0,1,9,262
068402011,331,21,1,5,10,1,15,384
068402101,216,26,7,1,5,0,15,270
068402102,217,25,3,1,1,0,5,252
068402103,157,12,8,6,1,0,4,188
068402104,200,10,9,0,0,0,11,230
068402105,157,11,5,2,0,0,4,179
068402106,366,22,4,0,1,0,7,400
068402107,376,16,5,5,2,0,22,426
068402108,262,9,3,1,0,0,3,278
068402109,317,6,0,0,0,0,4,327
068402110,333,10,2,2,0,0,10,357
068402201,364,24,11,1,2,0,7,409
068402202,292,18,7,5,0,3,12,337
068402203,322,9,5,0,2,0,5,343
068402204,293,23,2,4,2,0,6,330
068402205,265,8,3,1,1,0,7,285
068402206,316,23,7,1,0,0,8,355
068402207,362,8,12,3,2,0,20,407
068402208,346,13,0,4,0,0,6,369
068402301,240,13,6,0,2,0,10,271
068402302,267,11,5,1,3,1,12,300
068402303,172,7,0,2,0,0,9,190
068402304,219,10,2,1,0,0,8,240
068402305,364,14,4,2,2,0,16,402
068402306,188,3,4,1,1,1,8,206
068402307,186,7,1,1,0,0,11,206
068402308,392,18,1,0,0,0,6,417
068402309,228,29,6,4,6,0,8,281
068402310,264,8,3,0,6,0,16,297
068402401,326,13,4,1,1,1,6,352
068402402,284,22,4,1,4,1,10,326
068402403,184,8,0,1,3,0,6,202
068402404,224,14,1,2,2,0,2,245
068402405,200,5,1,0,0,0,2,208
068402406,165,4,2,0,2,0,6,179
068402407,277,15,1,0,0,0,9,302
068402408,230,7,0,1,0,0,27,265
068402409,212,9,3,0,4,0,6,234
068402410,188,23,6,1,0,1,14,233
068402501,122,0,0,5,0,0,1,128
068402502,50,2,0,3,0,0,4,59
068402503,147,0,0,6,0,0,6,159
068402504,218,1,4,0,0,0,9,232
068402505,133,0,0,7,0,1,3,144
068402506,263,4,1,3,0,0,6,277
068402507,90,28,0,0,0,0,4,122
068402508,162,29,0,0,0,0,14,205
068402509,141,25,0,0,0,0,8,174
068402510,217,4,0,0,2,0,4,227
068402511,184,6,0,2,0,0,3,195
068402601,354,0,0,0,0,0,5,359
068402602,951,22,1,1,0,0,20,995
068402603,354,12,5,0,0,0,8,379
068402604,160,13,0,0,0,1,3,177
068402605,301,8,1,0,0,0,13,323
068402606,904,27,1,0,0,0,15,947
068402607,173,1,0,34,5,1,0,214
068402608,5,0,0,21,0,0,0,26
068402701,238,19,8,0,8,0,6,279
068402702,349,19,11,3,1,1,15,399
068402703,279,4,2,1,0,0,3,289
068402704,301,31,9,2,1,2,8,354
068402705,103,0,21,0,0,0,17,141
068402706,104,7,1,3,0,0,12,127
068402707,215,20,5,1,1,1,15,258
068402708,265,20,7,4,2,0,16,314
068402709,265,26,12,2,0,0,6,311
068402710,299,26,5,0,0,0,14,344
068402711,199,10,1,3,1,1,6,221
068402712,300,25,8,1,4,0,17,355
068402713,258,33,16,1,3,0,11,322
068402801,265,10,0,0,0,0,19,294
068402802,243,25,2,2,11,0,9,292
068402803,193,7,3,1,0,0,4,208
068402804,226,8,1,0,0,0,1,236
068402805,333,11,1,1,0,0,12,358
068402806,260,8,3,0,1,1,14,287
068402807,378,24,3,2,9,1,7,424
068402808,225,10,9,1,1,1,11,258
068402809,260,11,2,0,4,0,12,289
068402810,221,13,3,1,7,0,1,246
068402811,278,5,0,0,0,0,3,286
068402901,312,23,7,2,2,1,5,352
068402902,256,14,3,0,0,0,4,277
068402903,426,16,10,1,4,2,17,476
068402904,217,4,8,2,7,0,25,263
068402905,349,14,13,8,4,0,9,397
068402906,263,10,14,1,5,9,21,323
068402907,305,15,2,2,5,0,22,351
068402908,273,29,8,2,3,0,4,319
068402909,330,30,8,2,5,0,13,388
068402910,363,22,5,0,1,0,10,401
068402911,171,12,3,0,3,1,2,192
068403001,185,15,3,3,8,0,25,239
068403002,133,13,3,0,9,0,4,162
068403003,261,20,4,8,4,0,22,319
068403004,272,20,4,1,4,0,11,312
068403005,156,14,12,6,8,1,6,203
068403006,215,23,4,2,1,0,8,253
068403007,227,28,3,1,2,1,12,274
068403008,321,31,11,1,9,3,9,385
068403009,225,14,8,25,3,2,17,294
068403010,212,38,18,1,6,4,15,294
068403011,289,33,8,7,7,0,15,359
068403012,178,21,6,1,7,0,18,231
068403013,213,27,42,6,7,0,1,296
068403101,110,1,0,0,0,0,1,112
068403102,269,20,9,7,4,3,13,325
068403103,360,46,19,2,15,1,12,455
068403104,193,26,3,3,3,0,16,244
068403105,283,26,21,3,6,2,7,348
068403106,323,29,12,4,10,0,22,400
068403107,302,28,10,4,5,1,15,365
068403108,327,27,7,5,2,0,16,384
068403109,354,34,12,1,4,2,28,435
068403110,234,37,7,0,4,0,12,294
068403201,143,12,4,2,3,1,11,176
068403202,290,29,19,2,5,1,11,357
068403203,241,25,5,3,7,5,7,293
068403204,307,7,5,1,0,0,48,368
068403205,248,21,4,1,18,0,18,310
068403206,206,28,6,2,1,1,26,270
068403207,299,14,9,2,1,0,31,356
068403208,280,22,14,2,11,0,15,344
068403209,299,12,9,1,0,1,23,345
068610101,236,35,9,1,4,1,11,297
068610102,166,21,6,3,2,1,5,204
068610103,247,45,13,0,9,0,6,320
068610104,304,55,9,4,9,0,13,394
068610105,311,36,6,3,9,0,14,379
068610106,216,18,20,2,6,3,9,274
068610107,250,52,12,2,4,0,9,329
068610108,254,27,10,4,3,1,3,302
068610109,241,31,5,2,3,2,11,295
068610110,231,39,29,3,21,2,17,342
068610111,192,17,9,1,10,0,10,239
068610201,256,30,4,2,5,0,9,306
068610202,209,47,25,5,3,1,11,301
068610203,143,45,7,3,0,1,4,203
068610204,318,44,8,5,1,0,12,388
068610205,222,34,10,2,4,0,14,286
068610206,172,48,7,0,2,0,17,246
068610207,193,39,5,2,1,1,7,248
068610208,137,59,11,1,15,0,6,229
068610209,266,13,1,4,1,2,4,291
068610210,299,28,4,8,12,1,16,368
068610211,244,32,3,2,5,3,8,297
068610212,227,36,10,1,18,0,16,308
068610301,326,0,6,3,15,7,10,367
068610302,233,2,1,1,5,0,7,249
068610303,321,5,3,0,12,1,11,353
068610304,362,11,9,0,1,0,13,396
068610305,261,15,6,3,12,4,9,310
068610306,249,1,19,0,19,0,5,293
068610307,247,0,14,1,21,0,5,288
068610308,273,3,17,1,8,1,9,312
068610309,169,15,6,0,30,0,16,236
068610310,231,39,5,0,20,0,48,343
068610311,320,55,3,2,11,1,14,406
068610401,285,89,31,2,1,3,23,434
068610402,191,34,103,1,6,18,30,383
068610403,275,44,12,0,0,0,25,356
068610404,165,47,9,12,5,1,10,249
068610405,267,49,13,32,1,1,32,395
068610406,279,40,15,3,0,1,20,358
068610407,298,58,7,1,0,1,26,391
068610408,185,51,20,2,2,0,20,280
068610409,206,30,12,2,2,4,9,265
068610410,254,21,5,1,3,0,11,295
068610411,196,28,18,7,7,2,7,265
068610501,247,47,11,6,8,1,16,336
068610502,220,55,17,5,9,4,12,322
068610503,224,29,16,3,2,1,11,286
068610504,264,40,2,8,5,1,9,329
068610505,225,25,2,5,2,2,44,305
068610506,0,0,0,0,0,0,1,1
068610507,235,51,20,0,3,1,8,318
068610508,334,29,3,4,0,4,14,388
068610509,322,41,8,1,7,1,28,408
068610601,103,37,16,55,2,0,6,219
068610602,213,57,24,2,6,1,15,318
068610603,243,40,1,4,6,0,9,303
068610604,273,58,19,2,3,2,11,368
068610605,133,21,16,1,0,0,0,171
068610606,254,44,13,3,6,2,11,333
068610607,273,49,8,0,2,1,3,336
068610608,164,61,12,1,4,1,7,250
068610609,268,51,22,2,10,0,39,392
068610610,390,44,4,0,2,0,24,464
068610611,150,25,2,1,0,1,13,192
068610701,258,10,2,2,6,0,9,287
068610702,249,30,9,0,35,5,6,334
068610703,268,58,9,2,38,0,21,396
068610704,245,7,4,6,4,0,3,269
068610705,308,15,19,4,11,0,15,372
068610706,177,27,0,1,6,0,4,215
068610707,274,42,1,4,16,3,21,361
068610708,285,34,12,1,10,1,5,348
068610709,266,19,20,1,7,3,13,329
068610801,339,68,9,4,15,1,29,465
068610802,298,29,2,4,13,0,13,359
068610803,199,13,3,0,2,0,9,226
068610804,272,7,7,5,2,0,4,297
068610805,183,16,2,0,46,1,22,270
068610806,233,9,11,0,3,0,23,279
068610807,200,23,8,0,0,0,11,242
068610808,255,13,16,3,12,1,35,335
068610809,162,7,13,1,7,0,8,198
068610810,256,17,7,3,2,3,8,296
068610811,225,19,13,1,6,6,74,344
068610901,341,41,9,4,10,2,12,419
068610902,226,41,14,2,7,3,19,312
068610903,219,13,2,1,8,1,5,249
068610904,215,5,4,1,7,0,10,242
068610905,386,30,14,3,4,1,22,460
068610906,323,28,9,3,3,0,7,373
068610907,292,14,10,3,4,0,29,352
068610908,273,33,13,1,23,0,20,363
068610909,125,21,10,0,28,1,13,198
068610910,273,29,14,2,1,0,9,328
068610911,375,17,9,8,6,0,40,455
068610912,293,18,5,0,1,0,8,325
068611001,330,39,2,1,6,0,11,389
068611002,395,43,27,6,8,2,15,496
068611003,346,46,9,4,5,1,14,425
068611004,334,34,12,4,7,1,13,405
068611005,316,21,2,2,0,0,6,347
068611006,313,28,1,1,3,0,19,365
068611007,325,22,12,6,5,0,9,379
068611008,329,35,4,5,6,3,9,391
068611009,278,18,2,2,3,0,12,315
068611010,297,18,2,5,0,0,12,334
068611101,329,18,5,3,6,0,11,372
068611102,224,23,3,0,1,1,4,256
068611103,289,17,2,2,0,1,32,343
068611104,228,21,3,3,5,0,18,278
068611105,196,17,5,1,2,0,7,228
068611106,297,24,15,3,7,0,9,355
068611107,360,28,8,2,11,0,18,427
068611108,231,23,3,3,6,1,8,275
068611109,294,20,5,1,3,0,23,346
068611110,248,26,28,0,2,0,4,308
068611201,261,42,16,1,8,2,17,347
068611202,257,26,8,1,1,1,14,308
068611203,185,29,6,0,4,0,2,226
068611204,164,23,2,2,9,0,12,212
068611205,335,27,9,9,10,1,19,410
068611206,231,17,11,4,12,0,9,284
068611207,289,32,23,4,8,0,11,367
068611208,310,15,6,15,4,3,12,365
068611209,272,24,5,4,2,3,5,315
068611301,167,32,6,0,4,0,12,221
068611302,232,37,7,1,3,0,22,302
068611303,224,34,18,2,10,1,12,301
068611304,281,21,10,2,1,0,19,334
068611305,295,49,3,6,5,1,31,390
068611306,314,35,3,1,3,1,16,373
068611307,247,24,14,8,0,1,4,298
068611308,220,17,8,2,1,1,9,258
068611309,304,21,3,6,0,0,5,339
068611401,258,44,4,0,32,1,16,355
068611402,232,28,16,1,22,1,17,317
068611403,242,24,15,0,7,2,8,298
068611404,280,21,0,3,9,1,14,328
068611405,201,18,4,1,1,0,6,231
068611406,185,34,7,1,2,0,5,234
068611407,318,32,4,8,2,0,30,394
068611408,256,47,5,1,8,0,9,326
068611409,349,32,10,1,7,1,25,425
068611410,241,21,11,0,10,0,5,288
068611411,144,10,0,1,9,3,11,178
068611412,228,48,15,0,35,2,8,336
068611501,273,48,33,0,9,1,7,371
068611502,308,39,29,1,19,0,17,413
068611503,390,29,14,2,3,1,33,472
068611504,96,5,0,0,1,0,4,106
068611505,184,29,10,1,28,2,3,257
068611506,272,35,1,0,4,4,17,333
068611507,277,24,4,1,19,1,27,353
068611508,399,64,14,3,8,1,24,513
068611509,254,23,6,3,4,0,24,314
068611510,314,32,17,4,0,1,23,391
068611601,207,22,5,0,1,0,8,243
068611602,196,22,6,0,2,0,5,231
068611603,265,19,7,3,3,0,11,308
068611604,321,28,5,2,9,1,14,380
068611605,282,14,11,1,1,0,8,317
068611606,287,40,2,6,1,0,15,351
068611607,313,23,5,5,1,0,12,359
068611608,255,32,3,2,2,0,14,308
068611609,363,29,8,2,1,0,10,413
068611610,308,24,20,7,5,3,15,382
068611611,274,16,8,5,2,0,9,314
068611701,321,22,2,2,1,1,7,356
068611702,308,18,2,4,0,0,6,338
068611703,252,23,7,0,5,0,8,295
068611704,227,11,5,10,3,2,7,265
068611705,250,16,5,3,2,1,7,284
068611706,253,17,1,4,1,0,3,279
068611707,329,23,1,1,1,0,10,365
068611708,315,35,8,0,1,1,17,377
068611709,318,27,1,8,7,0,16,377
068611801,368,32,5,6,3,0,7,421
068611802,350,24,2,5,10,0,5,396
068611803,271,24,10,3,1,0,17,326
068611804,256,17,4,4,2,2,12,297
068611805,195,14,18,3,2,1,7,240
068611806,333,18,15,5,3,0,18,392
068611807,304,36,2,1,3,2,5,353
068611808,299,12,5,4,11,3,15,349
068611809,306,12,9,1,16,1,26,371
068611810,362,18,21,3,6,2,7,419
068611901,289,32,2,1,4,1,8,337
068611902,119,17,3,1,0,0,9,149
068611903,301,30,19,21,4,1,16,392
068611904,266,18,6,4,7,2,19,322
068611905,335,32,4,3,3,1,6,384
068611906,284,20,5,1,0,0,6,316
068611907,317,27,4,1,3,0,15,367
068611908,253,22,1,6,2,0,7,291
068611909,267,13,6,3,1,1,8,299
068611910,267,21,4,6,3,0,10,311
068611911,332,23,16,2,1,0,17,391
068611912,356,33,9,7,1,0,6,412
068611913,257,16,7,1,0,0,10,291
068611914,230,11,3,2,3,0,6,255
068611915,197,25,9,0,9,0,16,256
068612001,353,47,27,0,2,1,2,432
068612002,264,46,29,0,2,1,1,343
068612003,350,46,22,0,4,2,6,430
068612004,325,41,20,0,2,1,11,400
068612005,351,43,27,0,12,0,10,443
068612006,366,32,13,0,2,1,7,421
068612007,296,32,15,0,0,0,9,352
068612008,241,44,43,0,40,2,2,372
068612101,324,30,2,2,3,3,7,371
068612102,266,20,2,3,6,1,10,308
068612103,313,33,8,4,5,2,14,379
068612104,311,19,5,2,3,0,18,358
068612105,288,19,6,3,3,1,16,336
068612106,350,18,15,2,1,1,13,400
068612107,329,17,6,8,0,2,7,369
068612108,397,25,8,1,7,0,19,457
068612109,278,34,10,2,5,1,9,339
068612201,316,27,2,8,4,3,26,386
068612202,305,32,4,0,5,1,13,360
068612203,301,16,8,1,1,0,7,334
068612204,306,22,12,3,2,0,11,356
068612205,334,28,7,2,2,1,17,391
068612206,307,28,4,1,3,0,15,358
068612207,308,34,8,1,3,1,11,366
068612208,368,29,11,2,2,1,6,419
068612209,190,19,3,0,1,0,6,219
068612210,208,12,3,1,1,0,13,238
068612211,202,19,0,3,1,0,11,236
068612212,183,18,3,2,3,1,9,219
068612301,384,26,4,1,0,0,9,424
068612302,350,36,4,4,1,0,6,401
068612303,372,17,7,4,4,0,6,410
068612304,218,9,1,2,0,0,5,235
068612305,311,10,2,0,0,0,8,331
068612306,154,9,4,1,1,0,3,172
068612307,363,20,11,1,4,2,17,418
068612308,218,15,15,0,4,1,18,271
068612309,217,11,5,2,8,1,5,249
068612401,395,40,11,5,12,0,10,473
068612402,382,4,3,1,2,0,8,400
068612403,248,18,8,0,0,0,4,278
068612404,234,16,2,2,0,0,4,258
068612405,324,21,8,0,2,1,13,369
068612406,277,16,4,2,0,0,4,303
068612407,404,22,5,4,0,1,9,445
068612408,357,17,3,1,3,0,7,388
068612409,327,11,6,10,3,0,16,373
068612410,326,15,3,7,3,0,11,365
068612411,420,36,16,3,3,1,12,491
068612501,226,11,2,0,1,0,11,251
068612502,422,15,10,1,0,0,11,459
068612503,365,18,7,1,2,0,16,409
068612504,175,13,0,0,0,0,4,192
068612505,279,1,5,0,2,0,26,313
068612506,269,14,5,0,29,0,16,333
068612507,279,17,8,2,6,1,18,331
068612508,362,15,18,1,4,0,24,424
068612509,346,23,4,5,1,0,8,387
068612601,391,32,4,2,9,1,17,456
068612602,279,29,6,1,5,0,14,334
068612603,261,17,13,4,4,1,16,316
068612604,310,25,8,0,1,0,10,354
068612605,300,17,4,3,1,0,9,334
068612606,327,29,28,0,19,0,10,413
068612607,342,30,7,6,3,1,13,402
068612608,405,27,4,2,2,0,8,448
068612609,322,16,8,3,1,0,11,361
068612610,292,20,7,3,0,1,14,337
068612701,356,34,22,2,2,1,7,424
068612702,304,24,8,4,1,1,9,351
068612703,268,30,1,1,0,0,23,323
068612704,233,23,5,2,1,1,13,278
068612705,234,23,5,2,0,0,2,266
068612706,287,14,5,1,5,2,10,324
068612707,332,32,11,3,7,0,23,408
068612708,295,17,3,3,16,0,16,350
068612709,241,16,4,0,1,0,13,275
068612710,243,23,1,2,0,0,9,278
068612801,189,25,5,3,7,0,7,236
068612802,348,23,8,1,1,1,23,405
068612803,212,32,0,0,4,1,24,273
068612804,302,17,2,3,10,0,15,349
068612805,236,2,0,2,3,1,32,276
068612806,280,19,10,1,25,0,15,350
068612807,264,30,2,4,14,0,11,325
068612808,185,8,3,1,5,0,13,215
068612809,242,22,9,1,4,0,10,288
068612810,292,11,1,2,3,0,10,319
068612901,493,40,13,3,10,0,19,578
068612902,281,10,4,2,2,0,7,306
068612903,328,10,3,1,6,5,14,367
068612904,242,10,1,0,9,0,1,263
068612905,267,20,3,2,6,1,8,307
068612906,165,24,0,0,1,0,11,201
068612907,169,1,8,0,3,0,12,193
068612908,460,13,3,1,0,0,5,482
068612909,182,47,0,24,0,0,80,333
068612910,320,19,4,1,0,0,20,364
068612911,238,21,3,3,4,1,14,284
068612912,192,12,2,0,0,0,7,213
068613001,269,2,7,1,5,0,8,292
068613002,259,1,0,0,0,0,3,263
068613003,311,4,0,0,0,0,14,329
068613004,401,2,0,0,0,0,4,407
068613005,216,0,0,0,0,0,5,221
068613006,245,0,0,0,0,0,9,254
068613007,246,0,0,0,0,0,0,246
068613008,66,3,1,0,0,0,2,72
068613009,366,21,2,0,6,1,7,403
068613010,194,8,2,2,19,0,11,236
068613011,260,11,4,1,3,0,7,286
068613012,340,21,6,0,0,1,16,384
068613101,413,67,21,1,3,0,7,512
068613102,513,63,37,0,20,0,20,653
068613103,346,28,2,2,0,0,8,386
068613104,638,67,29,3,14,0,23,774
068613105,219,15,4,0,8,1,16,263
068613106,322,21,9,1,1,1,12,367
068613107,405,29,12,3,0,0,9,458
068613108,379,18,7,0,1,0,11,416
068613109,300,20,4,3,0,0,4,331
068613110,380,21,5,5,2,0,10,423
068613201,207,22,17,0,10,0,1,257
068613202,398,51,27,0,0,0,9,485
068613203,73,13,10,0,1,0,0,97
068613204,107,15,12,0,2,0,1,137
068613205,161,30,10,0,0,0,2,203
068613206,224,45,8,0,0,0,3,280
068613207,369,52,19,0,0,0,5,445
068613208,233,62,28,0,12,0,4,339
068613209,167,59,15,0,12,0,6,259
068613210,351,46,30,0,24,0,3,454
068613301,337,52,35,0,0,0,0,424
068613302,315,83,34,0,0,0,0,432
068613303,359,64,43,0,12,0,3,481
068613304,226,56,16,0,0,0,6,304
068613305,342,52,23,0,0,0,3,420
068613306,256,59,28,0,0,0,6,349
068613307,318,40,26,0,0,0,0,384
068613308,313,58,34,0,12,0,3,420
068613309,356,41,27,0,12,0,0,436
068613310,385,36,15,0,0,0,3,439
060070101,177,9,2,2,1,5,17,213
060070102,251,3,8,1,0,0,12,275
060070103,13,10,0,0,0,0,0,23
060070104,1,1,0,0,0,0,0,2
060070105,12,17,0,0,0,0,0,29
060070106,5,3,0,0,0,1,6,15
060070107,63,21,0,0,1,2,10,97
060070108,11,7,0,0,0,0,5,23
060070109,8,0,0,0,0,2,5,15
060070110,11,2,0,0,0,0,0,13
060070111,8,1,0,0,0,1,5,15
060070112,6,3,0,0,0,1,0,10
060070113,15,3,0,0,0,3,6,27
060070114,21,8,0,0,0,0,5,34
060070115,140,11,1,1,0,2,12,167
060070201,8,0,0,0,0,0,0,8
060070202,7,1,0,0,0,0,0,8
060070203,12,1,0,0,0,1,0,14
060070204,4,2,0,0,0,0,11,17
060070205,7,2,0,0,0,0,5,14
060070206,15,0,0,0,0,0,0,15
060070207,3,2,0,0,0,3,0,8
060070208,4,0,0,0,0,0,6,10
060070209,2,1,0,0,0,0,1,4
060070301,5,0,0,0,0,0,12,17
060070302,7,1,0,0,0,0,8,16
060070303,15,6,0,0,0,0,3,24
060070304,11,0,0,0,0,1,11,23
060070305,4,5,0,0,0,2,0,11
060070306,19,0,0,0,0,2,2,23
060070307,5,5,0,0,1,1,13,25
060070308,10,0,0,0,0,0,6,16
060070401,13,7,0,1,0,1,9,31
060070402,56,5,0,8,1,1,3,74
060070403,234,25,2,1,0,2,15,279
060070404,249,23,0,17,0,2,5,296
060070405,329,30,5,2,0,1,25,392
060070406,161,22,3,0,0,2,6,194
060070407,193,17,0,0,1,0,11,222
060070408,6,8,0,0,0,0,0,14
060070409,4,1,0,0,0,0,9,14
060070410,2,0,0,0,0,1,5,8
060070411,3,0,2,0,0,2,1,8
060070412,2,0,0,0,0,1,4,7
060070413,6,0,0,0,0,0,8,14
060070501,43,8,0,1,0,1,8,61
060070502,0,2,0,0,0,0,0,2
060070503,4,0,2,0,0,3,1,10
060070504,10,1,0,0,0,0,1,12
060070505,3,2,0,0,0,0,0,5
060070506,4,3,0,0,0,0,3,10
060070507,4,0,0,0,0,0,3,7
060070508,2,0,0,0,0,0,7,9
060070509,6,0,0,0,0,0,7,13
060070510,3,1,0,0,0,3,3,10
060070511,4,0,0,0,0,0,3,7
060070512,5,0,0,0,0,0,12,17
060070513,2,12,0,0,0,0,1,15
060070514,8,8,0,0,0,3,18,37
060070515,11,1,0,0,0,0,3,15
060070516,3,2,0,0,0,3,5,13
060070601,164,28,0,0,1,1,12,206
060070602,7,2,0,0,0,1,7,17
060070603,10,6,0,0,0,0,6,22
060070604,1,2,0,0,0,0,5,8
060070605,9,4,0,0,1,1,0,15
060070606,14,0,0,0,0,2,5,21
060070607,1,1,0,0,0,0,4,6
060070608,6,2,0,0,0,0,1,9
060070609,8,0,0,0,0,1,4,13
060070610,9,1,0,0,0,0,0,10
060070611,7,3,0,0,0,0,0,10
060070612,49,7,0,1,0,0,14,71
060070613,8,0,0,0,0,1,4,13
060070614,4,0,0,0,0,0,6,10
060070615,8,2,0,0,0,0,0,10
060070701,9,1,0,0,0,0,1,11
060070702,207,23,0,2,1,2,18,253
060070703,6,2,1,0,0,4,3,16
060070704,5,7,0,0,0,0,1,13
060070801,24,6,0,2,0,0,0,32
060070802,105,16,1,1,1,0,9,133
060070803,251,16,3,3,2,0,9,284
060070804,219,31,4,2,0,3,6,265
060070805,176,18,9,6,1,4,4,218
060070806,286,26,16,4,2,2,21,357
060070807,295,26,23,3,2,1,26,376
060070808,247,34,21,4,4,3,10,323
060070809,345,19,8,7,4,3,14,400
060070810,303,29,13,7,8,0,23,383
060070811,198,19,4,1,3,0,12,237
060070812,183,17,0,2,0,0,12,214
060070813,201,18,1,5,2,1,14,242
060070814,308,18,1,2,0,0,4,333
060070901,5,0,0,0,0,0,8,13
060070902,9,2,0,0,0,0,0,11
060070903,7,0,0,0,0,0,13,20
060070904,6,4,0,0,0,0,0,10
060070905,3,8,0,0,0,0,0,11
060070906,5,1,0,0,0,0,0,6
060071001,11,1,0,0,0,0,5,17
060071002,3,9,0,0,0,0,0,12
060071003,4,0,0,0,0,0,9,13
060071004,4,10,1,0,0,0,0,15
060071005,13,12,1,0,0,0,0,26
060071006,13,8,0,0,0,0,6,27
060071007,6,4,0,0,0,0,0,10
060071008,2,6,0,2,0,1,3,14
060071009,4,5,0,0,0,0,19,28
060071010,10,0,0,0,0,1,2,13
060071011,9,0,0,0,0,0,4,13
060071012,5,2,0,0,0,4,9,20
060071101,11,4,0,0,0,0,4,19
060071102,0,0,0,0,0,0,7,7
060071103,6,0,1,0,0,1,3,11
060071104,9,0,0,0,0,7,0,16
060071105,4,0,0,0,0,0,3,7
060071106,3,0,0,0,0,0,7,10
060071107,5,0,0,0,0,1,4,10
060071108,6,6,0,0,0,0,0,12
060071109,0,5,0,0,0,0,0,5
060071110,5,3,0,0,0,0,3,11
060071111,6,1,0,0,0,0,0,7
060140101,24,0,0,0,0,5,10,39
060140201,11,7,0,0,0,0,1,19
060140301,55,11,0,0,0,0,11,77
060140302,34,8,0,0,0,8,5,55
060140401,35,11,0,1,0,3,16,66
060140501,150,21,2,2,0,0,4,179
060140502,36,3,0,0,0,2,10,51
060140503,36,34,0,1,0,5,9,85
060140504,298,22,3,8,0,3,18,352
060140505,140,14,3,34,0,0,5,196
060140601,17,0,0,0,0,9,24,50
060140701,12,15,0,0,0,3,2,32
060140801,29,2,0,0,0,0,25,56
060140901,15,4,0,0,0,15,2,36
060141001,127,6,1,1,0,1,8,144
060141002,28,3,1,48,1,2,8,91
060141003,146,9,2,8,0,0,14,179
060141004,181,13,3,4,0,1,6,208
060141005,209,18,2,0,0,0,8,237
060141006,203,19,7,5,0,0,3,237
060141007,130,11,0,0,1,0,4,146
060141008,209,16,0,2,0,0,14,241
060141009,274,28,6,1,1,0,20,330
060141010,354,33,3,4,2,3,14,413
060141011,302,42,2,1,10,1,10,368
060141012,189,16,0,3,0,0,6,214
060141013,294,38,8,3,1,0,8,352
060141014,207,20,6,4,0,1,2,240
060141015,263,16,1,0,0,0,6,286
060141101,18,6,0,0,0,1,7,32
060141201,17,0,0,0,0,0,15,32
060141202,18,12,0,0,0,2,11,43
060141301,21,27,0,0,0,6,32,86
060141401,5,10,0,0,0,0,8,23
060141501,3,13,0,0,0,0,0,16
060210101,9,0,0,0,0,1,7,17
060210102,6,0,0,0,0,0,16,22
060210201,153,1,0,1,0,1,19,175
060210202,147,30,0,11,0,4,14,206
060210203,14,0,0,0,0,5,12,31
060210204,6,0,0,0,0,4,24,34
060210205,3,0,0,0,0,0,21,24
060210206,58,3,0,1,0,4,10,76
060210207,11,0,0,0,0,4,5,20
060210301,7,1,0,0,0,5,6,19
060210302,7,1,0,0,0,6,5,19
060210401,12,0,0,0,0,0,23,35
060210402,6,0,0,0,0,0,13,19
060210501,138,17,4,10,3,8,15,195
060210502,11,2,0,0,0,0,6,19
060210503,5,0,0,0,0,2,8,15
060210601,121,4,0,6,3,7,14,155
060210602,406,34,9,9,0,2,21,481
060210603,294,23,4,6,2,4,19,352
060210604,332,27,7,11,1,8,14,400
060210605,260,15,2,3,8,5,9,302
060210606,291,33,6,5,2,0,8,345
060210607,392,31,5,5,2,6,25,466
060210608,143,5,2,4,1,6,10,171
060210609,26,1,0,2,0,4,16,49
060210610,89,13,3,3,2,24,1,135
060210611,323,21,3,22,0,7,22,398
060210612,218,8,2,4,0,12,20,264
060210701,6,0,0,0,0,13,8,27
060210702,5,19,0,0,0,9,0,33
060210801,70,15,0,16,1,6,13,121
060210802,6,0,0,0,0,4,5,15
060210803,16,0,0,0,0,0,14,30
060210804,16,7,0,0,0,2,0,25
060210901,12,3,0,0,0,0,16,31
060210902,10,2,0,1,0,9,2,24
060210903,13,3,0,0,0,0,7,23
060210904,17,9,0,0,0,0,0,26
060211001,11,2,0,0,0,3,0,16
060211002,47,8,1,10,0,35,6,107
060211003,8,2,0,0,0,7,0,17
060420101,370,29,2,25,0,2,5,433
060420102,271,32,6,2,1,1,5,318
060420103,289,25,10,5,0,3,25,357
060420104,244,31,1,1,5,2,9,293
060420105,233,17,1,0,4,1,3,259
060420106,246,21,0,6,1,4,8,286
060420107,227,23,4,3,3,3,10,273
060420108,390,48,4,7,6,4,16,475
060420109,418,33,5,15,1,2,17,491
060420201,47,11,0,0,0,1,29,88
060420301,68,7,0,0,0,2,9,86
060420401,41,9,0,0,0,1,17,68
060420501,99,48,1,0,0,4,11,163
060420601,55,7,0,0,0,7,4,73
060420701,64,36,0,0,0,2,7,109
060420801,42,26,0,0,0,3,1,72
060420901,93,10,0,0,0,13,35,151
060421001,52,16,0,0,0,2,5,75
060421101,23,14,0,0,0,7,7,51
060421102,148,27,2,4,4,20,27,232
060421103,293,30,4,8,1,10,32,378
060421201,51,15,0,0,0,1,3,70
060421301,40,8,0,0,0,0,1,49
060421401,66,39,0,0,0,3,1,109
060421501,35,26,0,0,0,0,13,74
060421601,34,30,0,0,0,0,13,77
060421701,36,1,0,0,0,0,2,39
060421801,15,3,0,0,0,0,0,18
060421901,319,45,1,10,1,2,9,387
060421902,288,27,4,3,0,2,6,330
060421903,350,29,3,4,0,1,6,393
060421904,303,31,5,7,7,0,15,368
060421905,297,37,3,4,3,1,9,354
060421906,301,46,4,2,6,0,13,372
060421907,222,16,0,8,0,2,6,254
060421908,221,13,3,7,0,4,4,252
060421909,477,23,2,16,0,0,13,531
060490101,210,29,1,0,5,1,13,259
060490102,161,20,5,8,11,0,49,254
060490103,255,44,10,6,17,4,19,355
060490104,290,62,7,1,18,0,38,416
060490105,261,54,15,4,37,5,30,406
060490106,243,28,18,6,23,4,24,346
060490107,257,35,8,5,12,4,17,338
060490108,292,31,10,9,28,5,23,398
060490109,272,43,7,0,0,2,6,330
060490110,267,9,6,5,1,0,10,298
060490111,233,22,1,2,0,3,10,271
060490112,153,18,1,3,0,0,0,175
060490113,215,21,7,2,14,1,25,285
060490114,248,17,0,9,1,1,1,277
060490115,174,18,1,2,0,0,8,203
060490116,172,13,0,1,0,0,1,187
060490201,241,25,15,1,20,1,26,329
060490202,270,13,14,2,11,1,24,335
060490203,273,9,12,7,1,0,22,324
060490204,350,23,1,3,0,0,12,389
060490205,344,15,3,1,0,0,7,370
060490206,293,21,13,3,1,1,11,343
060490207,245,34,8,4,2,1,13,307
060490208,297,24,2,4,2,1,24,354
060490209,300,17,5,5,0,0,7,334
060490210,209,7,0,1,0,0,5,222
060490211,276,13,1,4,2,1,7,304
060490212,287,10,3,12,1,0,7,320
060490213,225,20,0,10,2,0,2,259
060490301,42,19,0,0,0,0,12,73
060490302,28,3,0,1,0,6,4,42
060490401,123,37,6,4,0,32,30,232
060490402,84,6,1,3,1,48,1,144
060490403,91,8,1,4,0,21,5,130
060490404,101,15,1,10,0,14,4,145
060490405,133,4,3,12,1,3,5,161
060490406,154,7,1,3,1,2,3,171
060490407,172,24,3,3,5,15,13,235
060490501,252,32,5,2,1,1,23,316
060490502,236,23,7,4,14,0,27,311
060490503,226,20,5,10,9,1,18,289
060490504,404,19,2,6,8,0,22,461
060490505,315,20,9,3,3,1,21,372
060490506,274,31,10,7,4,1,10,337
060490507,291,18,2,6,2,0,11,330
060490508,371,36,7,3,4,2,17,440
060490601,306,0,1,3,0,2,3,315
060490602,134,2,0,5,2,0,5,148
060490603,373,2,6,6,0,1,10,398
060490604,279,0,10,10,1,0,11,311
060490605,264,2,4,1,8,0,21,300
060490606,346,18,5,4,3,1,29,406
060490607,331,21,7,4,1,0,16,380
060490608,400,32,5,10,0,0,8,455
060490609,299,16,0,1,0,1,9,326
060490610,155,7,4,23,0,0,10,199
060490611,326,12,2,16,0,0,4,360
060490612,296,12,0,7,2,1,5,323
060490613,418,30,8,9,3,1,11,480
060490614,281,13,2,9,2,0,13,320
060490615,133,6,0,9,0,1,14,163
060490701,3,11,0,0,0,0,0,14
060490702,32,3,0,0,0,0,3,38
060490801,19,4,0,0,0,1,7,31
060490901,29,9,1,0,0,4,18,61
060491001,112,11,5,4,0,7,19,158
060491002,122,15,8,1,0,3,10,159
060491003,187,16,4,1,0,9,9,226
060491004,110,13,8,3,1,3,9,147
060491005,84,8,3,3,1,5,10,114
060491006,101,11,2,1,11,1,15,142
060491007,115,13,1,4,1,3,6,143
060491008,177,17,2,8,0,2,12,218
060491009,57,8,0,0,0,1,1,67
060491101,31,14,1,2,0,3,10,61
060491102,42,21,0,1,0,2,9,75
060491201,42,0,0,0,0,2,13,57
060491301,38,8,0,0,0,9,27,82
060491401,18,22,0,0,0,0,1,41
060491402,21,4,0,0,0,10,1,36
060491501,35,3,0,0,0,8,11,57
060491601,30,17,0,0,0,7,7,61
060491701,40,8,0,1,0,6,1,56
060491801,90,26,0,0,0,8,6,130
060491901,54,26,0,0,0,6,17,103
060492001,378,28,3,0,0,0,10,419
060492002,346,20,1,6,0,0,8,381
060492003,31,22,1,1,0,0,9,64
060492004,33,31,0,0,0,17,0,81
060492005,16,4,0,0,0,0,16,36
060492006,185,24,2,2,1,8,25,247
060492007,200,35,1,4,1,0,5,246
060492101,43,5,0,0,0,5,1,54
060492102,44,18,4,0,0,5,8,79
060492201,79,1,0,2,0,17,30,129
060492301,62,14,0,0,0,4,8,88
060492401,19,15,0,0,0,0,1,35
060492501,248,28,0,1,0,2,23,302
060492502,421,9,4,0,0,1,1,436
060492503,217,18,3,33,5,0,5,281
060492504,258,15,6,4,1,0,30,314
060492505,210,10,0,1,0,3,1,225
060492506,244,36,1,17,0,4,4,306
060492507,425,29,4,12,1,3,16,490
060492508,377,21,3,11,0,0,8,420
060492509,392,5,1,6,1,0,15,420
060492510,282,6,2,13,0,2,7,312
060560101,323,66,28,3,8,0,5,433
060560102,352,64,39,1,2,0,38,496
060560103,385,121,12,8,4,3,23,556
060560104,164,59,6,0,2,0,7,238
060560105,191,62,12,1,3,0,10,279
060560106,169,42,12,0,7,0,7,237
060560107,212,78,11,1,1,4,17,324
060560108,461,59,11,3,0,3,14,551
060560109,183,35,1,0,4,0,1,224
060560110,238,40,5,1,6,1,21,312
060560111,290,59,34,3,3,2,13,404
060560112,268,45,16,4,12,2,10,357
060560113,233,32,5,7,10,0,19,306
060560114,219,41,8,2,3,0,20,293
060560115,226,43,1,4,4,0,15,293
060560116,205,51,14,2,9,0,11,292
060560117,215,33,8,5,9,2,26,298
060560118,172,51,22,2,19,11,7,284
060560119,288,39,22,1,27,2,32,411
060560201,292,3,0,6,0,0,6,307
060560202,360,10,3,5,0,1,5,384
060560203,178,20,1,6,0,0,2,207
060560204,190,18,6,3,0,2,13,232
060560205,187,19,3,3,2,0,1,215
060560206,184,24,24,5,8,2,6,253
060560207,294,42,4,1,0,3,6,350
060560208,349,40,19,6,9,0,18,441
060560209,251,19,1,1,1,0,4,277
060560210,286,17,5,6,1,1,13,329
060560211,314,28,1,7,0,2,3,355
060560212,317,32,7,7,0,1,19,383
060560213,175,20,3,5,4,0,5,212
060560214,241,15,7,1,4,1,19,288
060560301,178,23,8,1,5,1,12,228
060560302,236,30,12,4,7,6,32,327
060560303,276,41,58,5,7,1,4,392
060560304,266,13,11,2,3,0,13,308
060560305,121,7,4,2,10,1,8,153
060560306,324,55,25,4,24,4,13,449
060560307,217,24,9,3,4,0,11,268
060560308,175,13,2,0,2,0,4,196
060560309,208,18,2,1,2,0,17,248
060560310,277,42,15,3,1,0,8,346
060560311,352,19,10,2,2,1,12,398
060560312,221,9,3,1,3,0,12,249
060560401,380,20,7,1,1,2,10,421
060560402,231,9,2,2,2,0,7,253
060560403,305,17,2,2,1,0,4,331
060560404,449,28,7,4,7,1,17,513
060560405,435,29,14,3,4,3,16,504
060560406,427,45,11,2,11,1,23,520
060560407,308,33,12,2,14,0,18,387
060560408,252,26,2,2,4,2,18,306
060560409,209,20,7,4,12,2,19,273
060560410,142,7,3,2,0,0,18,172
060560501,206,7,5,3,0,0,4,225
060560502,294,11,8,4,0,0,4,321
060560503,389,10,4,6,1,0,5,415
060560504,389,26,10,7,4,0,3,439
060560505,166,20,2,6,0,1,12,207
060560506,321,12,9,5,2,0,20,369
060560507,312,22,4,2,1,0,16,357
060560508,202,10,3,0,3,0,8,226
060560509,369,28,5,1,0,3,5,411
060560601,266,12,3,5,0,0,5,291
060560602,310,18,4,1,0,0,6,339
060560603,274,9,1,1,2,0,11,298
060560604,212,32,3,3,0,0,4,254
060560605,395,15,2,9,0,0,12,433
060560606,199,28,19,2,0,0,6,254
060560607,385,11,8,2,0,0,16,422
060560608,319,13,6,185,0,0,6,529
060560609,353,23,2,6,0,2,7,393
060560701,387,25,4,5,1,0,13,435
060560702,308,32,5,1,5,1,17,369
060560703,341,12,7,1,1,1,18,381
060560704,373,29,5,4,2,0,5,418
060560705,197,19,7,9,1,0,1,234
060560706,236,12,7,8,0,1,7,271
060560707,337,25,6,2,2,0,6,378
060560708,274,13,9,2,3,1,3,305
060560709,348,20,4,4,0,1,12,389
060560710,319,20,2,7,1,0,28,377
060560711,370,18,7,4,2,1,12,414
060560801,459,21,1,5,0,0,1,487
060560802,457,26,6,10,0,1,8,508
060560803,343,12,0,5,0,0,2,362
060560804,406,15,0,35,0,0,5,461
060560805,434,28,5,2,0,1,16,486
060560806,243,10,6,2,1,0,7,269
060560807,237,8,2,2,0,0,9,258
060560808,69,0,0,3,0,0,1,73
060560809,475,23,1,12,0,0,15,526
060560810,210,34,0,4,1,0,4,253
060560811,23,1,0,0,0,0,5,29
060560812,241,11,1,0,0,0,2,255
060560813,319,15,0,5,0,0,0,339
060560814,392,13,1,4,0,0,5,415
060560815,190,16,2,5,1,0,16,230
060560901,308,74,23,2,11,1,7,426
060560902,264,28,21,2,36,1,29,381
060560903,262,52,12,1,23,4,17,371
060560904,248,56,8,1,12,2,21,348
060560905,223,44,13,2,8,2,16,308
060560906,319,18,11,1,13,1,18,381
060560907,224,23,4,6,1,0,11,269
060560908,226,29,9,2,1,1,9,277
060560909,141,7,0,1,0,0,3,152
060560910,177,16,1,0,4,1,20,219
060560911,203,9,6,3,0,0,6,227
060561001,128,32,1,17,9,1,21,209
060561002,182,41,3,1,1,5,21,254
060561003,282,95,25,0,15,2,9,428
060561004,303,65,7,4,35,2,10,426
060561005,175,38,24,0,7,4,51,299
060561006,170,41,28,2,6,1,22,270
060561007,240,39,22,0,5,1,30,337
060561008,323,46,27,0,12,1,20,429
060561009,228,16,19,0,12,2,21,298
060561010,228,42,10,3,8,1,12,304
060561011,193,15,12,1,9,0,16,246
060561101,207,48,22,2,4,0,10,293
060561102,142,32,5,1,25,2,16,223
060561103,147,50,6,1,5,4,15,228
060561104,241,109,49,2,6,0,4,411
060561105,212,60,19,1,9,1,3,305
060561106,211,56,24,0,0,0,8,299
060561107,254,50,13,5,13,5,26,366
060561108,230,33,39,0,9,4,13,328
060561109,187,35,11,1,6,12,18,270
060561110,268,55,12,0,2,2,14,353
060561111,235,66,23,2,8,8,11,353
060561112,271,55,7,6,9,2,24,374
060561113,247,37,3,1,9,4,13,314
060561114,195,24,12,0,0,1,8,240
060561201,306,4,5,3,13,1,21,353
060561202,293,11,35,1,2,0,0,342
060561203,190,35,5,0,12,1,2,245
060561204,271,47,19,0,15,1,14,367
060561205,279,84,13,6,8,0,10,400
060561206,245,77,22,0,4,0,20,368
060561207,196,52,10,0,4,6,10,278
060561208,232,42,2,0,4,0,13,293
060561209,241,47,16,0,5,0,39,348
060561210,142,25,8,1,2,5,16,199
060561211,167,45,7,1,0,0,15,235
060561301,470,82,32,0,10,0,17,611
060561302,307,61,39,22,7,2,40,478
060561303,301,64,14,6,3,1,3,392
060561304,156,31,42,2,7,1,1,240
060561305,177,25,7,0,3,0,17,229
060561306,258,61,15,1,2,0,7,344
060561307,315,75,6,1,2,0,6,405
060561308,306,64,8,0,3,1,11,393
060561309,169,56,6,2,2,0,9,244
060561310,240,35,2,1,2,0,19,299
060561401,203,28,7,6,2,1,9,256
060561402,218,21,3,3,2,0,7,254
060561403,261,38,15,2,0,4,16,336
060561404,223,23,14,2,1,1,8,272
060561405,215,27,4,0,1,1,3,251
060561406,405,46,22,16,11,3,22,525
060561407,237,31,6,0,1,1,19,295
060561408,301,72,11,1,5,2,7,399
060561409,169,25,11,1,1,1,14,222
060561410,295,63,8,2,5,0,16,389
060561411,203,31,19,2,9,0,3,267
060561412,175,29,4,0,4,0,22,234
060561413,276,50,61,2,5,0,19,413
060561414,326,71,24,4,27,3,29,484
060561415,172,49,32,2,5,2,29,291
060561416,324,73,26,1,7,1,16,448
060561417,267,55,8,0,5,1,15,351
060561418,204,47,12,3,21,4,41,332
060561419,251,44,12,0,1,2,46,356
060561420,111,31,6,0,0,3,16,167
060561421,188,41,10,0,30,10,11,290
060561501,298,24,4,10,1,2,9,348
060561502,376,26,6,15,0,0,3,426
060561503,332,16,7,8,2,0,9,374
060561504,242,9,7,3,0,0,13,274
060561505,264,14,7,5,1,0,7,298
060561506,312,25,4,13,0,2,10,366
060561507,295,7,6,3,2,1,3,317
060561508,364,13,2,1,0,0,8,388
060561509,171,6,2,6,0,0,1,186
060561510,210,5,5,4,4,0,9,237
060561511,230,2,6,0,1,0,6,245
060561512,389,17,1,2,0,0,9,418
060561513,227,8,5,2,3,0,3,248
060561514,332,9,5,8,1,0,14,369
060561515,420,26,21,5,1,3,11,487
060561516,172,13,0,6,0,0,2,193
060561517,168,3,1,3,0,0,4,179
060561601,212,8,3,1,4,1,9,238
060561602,201,14,23,8,5,0,5,256
060561603,236,15,3,4,0,2,8,268
060561604,182,19,15,7,1,1,9,234
060561605,302,27,7,4,5,0,14,359
060561606,171,18,5,0,2,1,4,201
060561607,182,15,9,1,1,0,6,214
060561608,305,35,12,5,10,2,14,383
060561609,312,38,9,1,5,3,14,382
060561610,266,18,8,2,11,6,39,350
060561611,330,50,9,2,26,3,27,447
060561612,242,37,17,17,35,3,18,369
060561613,332,63,18,3,16,2,20,454
060561614,243,47,26,0,32,3,0,351
060561701,340,34,6,2,1,1,4,388
060561702,318,34,12,4,1,0,11,380
060561703,336,26,11,4,6,1,14,398
060561704,211,15,10,5,9,2,7,259
060561705,180,17,20,1,6,0,13,237
060561706,301,43,5,1,6,2,19,377
060561707,317,26,15,2,25,2,24,411
060561708,252,43,17,1,10,2,5,330
060561709,248,34,33,5,13,1,12,346
060561710,253,24,17,3,9,5,13,324
060561801,377,18,10,4,1,4,13,427
060561802,359,24,5,4,0,0,11,403
060561803,216,11,3,2,1,0,9,242
060561804,228,16,1,6,1,0,6,258
060561805,300,14,4,7,0,0,7,332
060561806,289,19,5,5,6,0,12,336
060561807,338,26,4,4,4,1,16,393
060561808,320,29,7,2,5,1,11,375
060561809,294,27,8,1,6,0,27,363
060561810,244,24,9,3,6,0,19,305
060561901,337,16,13,5,3,0,17,391
060561902,326,19,6,1,1,1,11,365
060561903,432,17,6,3,3,0,16,477
060561904,322,7,4,1,0,0,17,351
060561905,361,21,1,2,0,0,4,389
060561906,443,33,15,2,2,2,7,504
060561907,380,16,4,5,2,0,3,410
060561908,226,17,1,2,0,0,3,249
060561909,236,14,0,3,1,0,7,261
060561910,457,11,3,0,1,2,6,480
060561911,337,12,3,5,1,1,17,376
060561912,370,25,3,2,1,0,14,415
060561913,387,18,5,6,0,0,13,429
060561914,219,8,2,1,1,0,4,235
060562001,397,20,7,0,3,4,13,444
060562002,386,21,23,0,7,0,25,462
060562003,309,44,10,1,12,1,13,390
060562004,319,30,11,0,12,2,18,392
060562005,353,46,9,2,9,0,14,433
060562006,251,38,32,0,19,3,30,373
060562007,239,30,7,0,8,2,13,299
060562008,183,12,4,3,6,0,11,219
060562009,190,17,3,3,1,0,13,227
060562010,199,14,6,2,3,0,3,227
060562101,315,19,8,4,1,2,24,373
060562102,279,15,2,0,2,0,11,309
060562103,199,16,4,5,4,0,6,234
060562104,221,12,6,1,3,1,4,248
060562105,347,18,13,5,6,1,7,397
060562106,158,13,8,0,2,0,2,183
060562107,250,19,2,15,2,0,10,298
060562108,210,41,6,31,0,0,0,288
060562109,264,27,7,0,0,0,10,308
060562110,239,14,3,2,0,0,4,262
060562111,330,30,1,7,0,2,13,383
060562201,331,23,3,5,3,2,26,393
060562202,336,28,3,4,1,2,12,386
060562203,357,15,5,2,5,3,24,411
060562204,378,9,10,4,2,0,12,415
060562205,232,2,2,4,0,1,3,244
060562206,322,7,0,0,1,0,1,331
060562207,207,0,3,0,2,1,6,219
060562208,364,6,5,8,10,0,17,410
060562209,194,2,3,2,3,0,15,219
060562210,279,22,5,0,1,0,11,318
060562211,263,23,7,0,0,4,13,310
060562212,100,1,0,181,0,0,31,313
060562213,292,0,1,17,0,0,5,315
060562214,295,3,0,43,0,0,10,351
060562215,294,2,1,5,0,0,7,309
060562216,333,3,10,1,3,0,6,356
060562217,320,13,8,6,2,0,11,360
060562301,190,8,0,3,8,0,14,223
060562302,264,10,4,7,2,0,7,294
060562303,314,13,0,8,1,0,8,344
060562304,465,26,1,6,2,2,12,514
060562305,256,7,5,0,1,0,3,272
060562306,306,7,1,0,0,0,6,320
060562307,270,5,5,0,0,0,2,282
060562308,282,7,5,2,1,0,11,308
060562309,357,20,2,7,3,1,17,407
060562310,271,15,1,4,6,1,21,319
060562311,159,4,8,3,9,0,14,197
060562312,197,15,1,6,3,2,12,236
060562313,236,23,6,3,6,0,15,289
060562314,294,15,3,0,1,0,11,324
060562315,253,7,2,1,5,0,13,281
060562316,278,11,0,5,0,0,11,305
060562401,387,7,8,40,1,1,11,455
060562402,454,12,0,20,1,0,4,491
060562403,298,27,1,81,1,1,6,415
060562404,358,13,6,17,0,1,13,408
060562405,316,22,0,0,0,0,0,338
060562406,424,15,7,4,1,1,4,456
060562407,381,12,3,16,1,0,42,455
060562408,713,26,2,58,3,0,28,830
060562409,352,12,4,6,1,0,7,382
060562410,254,11,1,0,0,0,4,270
060562411,190,4,3,0,0,0,6,203
060562412,394,18,3,2,2,0,7,426
060562413,393,13,2,3,3,4,1,419
060562414,226,9,2,3,0,0,5,245
060562415,233,6,5,1,1,0,8,254
060562416,324,18,2,3,1,0,4,352
060562417,166,4,0,0,0,0,8,178
060562501,374,63,7,43,5,18,11,521
060562502,469,11,12,16,0,0,29,537
060562503,274,14,7,39,2,78,11,425
060562504,399,20,6,26,0,3,5,459
060562505,347,5,1,4,0,0,10,367
060562506,418,32,4,10,2,0,4,470
060562507,390,16,1,15,2,4,11,439
060562508,385,31,14,12,1,1,8,452
060562509,351,20,11,24,0,2,7,415
060562510,322,27,4,3,0,0,10,366
060562511,337,33,10,5,2,0,8,395
060562512,336,17,13,23,2,7,18,416
060562513,278,25,3,0,2,0,8,316
060562514,307,52,21,4,6,0,24,414
060562515,253,24,7,2,1,0,10,297
060562516,321,51,23,7,2,1,4,409
060562601,277,11,1,22,1,16,23,351
060562602,285,30,6,37,1,27,15,401
060562603,300,28,1,40,7,1,17,394
060562604,126,8,1,34,0,1,10,180
060562605,291,26,1,12,0,3,6,339
060562606,175,11,1,18,2,1,7,215
060562607,314,23,5,4,0,50,6,402
060562608,305,31,2,7,0,17,12,374
060562609,187,9,1,2,1,13,25,238
060562610,553,40,10,44,0,18,24,689
060562611,423,19,3,59,0,11,12,527
060562612,165,10,2,16,0,9,19,221
060562613,424,33,7,41,0,4,22,531
060562614,372,22,4,36,1,21,5,461
060562615,252,35,0,7,0,2,14,310
060562616,244,4,1,1,1,0,2,253
060562617,461,13,3,130,1,0,7,615
060562618,197,7,0,2,0,0,1,207
060562619,170,5,1,1,0,0,4,181
060562701,46,8,1,2,0,12,5,74
060562702,242,39,1,4,2,1,64,353
060562703,298,17,2,5,1,0,3,326
060562704,284,24,3,93,1,24,16,445
060562705,123,5,5,210,0,0,3,346
060562706,96,1,0,96,0,0,2,195
060562707,321,22,0,8,2,7,25,385
060562708,149,16,0,2,1,6,5,179
060562801,22,4,0,0,0,16,17,59
060562901,17,5,1,0,0,6,7,36
060563001,43,7,0,0,0,5,18,73
060563002,139,6,0,6,1,4,17,173
060563003,203,24,4,3,2,1,2,239
060563004,204,13,2,2,4,1,10,236
060563005,105,10,1,0,0,0,6,122
060563006,72,0,2,3,0,2,7,86
060563007,27,7,0,1,0,0,20,55
060563101,59,34,3,0,0,12,37,145
060563201,23,7,1,1,0,11,22,65
060563202,222,62,6,77,0,35,8,410
060563203,327,15,2,22,2,46,11,425
060563204,91,22,1,0,0,0,8,122
060563205,330,22,3,9,0,1,6,371
060563206,332,6,0,17,0,0,10,365
060563207,168,15,3,9,3,14,12,224
060563208,239,9,1,9,0,2,5,265
060563209,360,16,5,9,3,5,14,412
060563210,306,15,5,2,2,0,9,339
060563211,311,13,4,3,2,2,14,349
060563212,5,0,0,0,0,0,0,5
060630101,267,0,2,3,1,0,6,279
060630102,314,6,9,2,0,1,7,339
060630103,309,31,3,2,0,0,5,350
060630104,246,34,2,4,0,2,5,293
060630105,397,18,1,0,0,1,9,426
060630106,269,22,7,6,0,0,14,318
060630107,295,33,3,6,11,8,13,369
060630108,366,25,5,7,6,1,12,422
060630109,369,32,3,1,1,1,10,417
060630110,232,17,10,7,0,0,2,268
060630111,269,13,8,6,2,4,20,322
060630112,215,28,3,6,5,0,17,274
060630113,246,27,8,2,15,4,10,312
060630114,257,26,17,3,7,0,13,323
060630115,338,25,0,6,2,1,14,386
060630116,231,15,1,3,0,0,1,251
060630117,228,13,3,5,1,0,7,257
060630201,430,53,4,13,0,0,9,509
060630202,281,30,17,3,18,2,26,377
060630203,292,49,7,3,8,0,6,365
060630204,304,33,7,8,1,0,12,365
060630205,349,43,4,5,2,0,13,416
060630206,153,9,1,2,0,0,6,171
060630207,320,18,2,17,0,0,14,371
060630208,302,24,12,8,2,0,8,356
060630301,11,7,0,0,0,0,0,18
060630302,157,24,0,5,0,1,28,215
060630303,42,4,0,0,1,6,18,71
060630304,17,11,0,0,0,0,7,35
060630305,26,7,0,0,0,6,2,41
060630306,21,7,0,0,0,1,5,34
060630401,6,0,0,0,0,0,9,15
060630402,28,0,0,0,0,1,5,34
060630403,23,13,0,1,0,11,13,61
060630404,40,9,0,2,0,2,24,77
060630405,11,4,0,0,0,0,6,21
060630406,29,1,0,0,0,5,7,42
060630501,8,0,0,0,0,0,2,10
060630502,16,0,0,0,0,0,5,21
060630601,41,14,0,0,0,4,32,91
060630602,22,1,0,1,0,1,14,39
060630603,25,4,0,0,0,2,15,46
060630604,24,2,0,0,0,4,21,51
060630605,30,1,0,0,0,0,25,56
060630606,18,11,0,0,0,10,18,57
060630607,18,12,0,0,0,0,0,30
060630701,411,34,2,1,0,0,11,459
060630702,187,13,1,6,0,0,4,211
060630703,306,15,0,7,0,0,4,332
060630704,211,23,4,11,0,0,3,252
060630705,171,8,0,13,0,0,2,194
060630706,357,33,1,10,0,21,27,449
060630707,233,34,3,17,2,24,17,330
060630708,397,41,1,22,0,12,7,480
060630709,259,23,1,39,0,1,9,332
060630801,6,2,0,0,0,1,1,10
060630802,60,3,2,2,0,10,8,85
060630803,8,3,0,0,0,2,6,19
060630804,27,12,0,1,1,8,10,59
060630805,53,18,0,1,0,4,30,106
060630806,65,9,0,2,0,2,7,85
060630901,81,8,0,2,0,2,15,108
060630902,17,9,0,0,0,0,0,26
060630903,17,4,0,0,0,4,16,41
060630904,7,11,0,0,0,1,5,24
060630905,9,9,0,0,0,6,5,29
060630906,100,6,0,0,0,2,16,124
060631001,20,3,0,1,0,3,1,28
060631002,121,10,1,4,3,4,6,149
060631003,42,19,2,1,4,13,23,104
060631004,21,10,0,0,0,8,14,53
060631101,22,15,0,0,0,0,0,37
060631102,46,47,0,1,0,5,11,110
060631103,44,20,0,0,0,6,9,79
060631104,45,10,0,0,0,3,9,67
060631105,40,20,1,0,0,0,4,65
060631106,42,14,0,1,0,31,4,92
060631107,18,2,3,2,0,21,8,54
060631201,15,1,0,0,0,0,0,16
060631202,16,7,0,0,0,0,14,37
060631203,8,9,0,1,0,0,1,19
060631301,275,61,12,6,19,0,15,388
060631302,331,36,8,3,5,0,16,399
060631303,423,29,8,13,1,0,15,489
060631304,321,13,4,6,0,1,12,357
060631305,324,32,7,4,9,3,16,395
060631306,279,29,14,4,6,2,6,340
060631307,354,26,3,8,0,3,14,408
060631308,341,28,4,9,1,0,19,402
060700101,161,9,1,3,4,4,20,202
060700102,164,26,7,2,1,0,8,208
060700103,228,23,6,2,7,2,17,285
060700104,139,21,3,3,2,1,6,175
060700105,209,17,3,1,7,4,3,244
060700106,281,17,6,4,2,1,14,325
060700107,285,29,12,2,7,0,16,351
060700108,258,25,6,3,2,2,7,303
060700109,296,41,6,3,4,1,14,365
060700110,281,29,8,5,1,1,16,341
060700111,148,21,1,3,1,0,6,180
060700112,121,4,10,0,2,0,24,161
060700113,156,15,5,1,0,2,11,190
060700201,452,51,4,7,1,1,13,529
060700202,294,15,4,3,2,2,7,327
060700203,183,11,2,0,3,0,8,207
060700204,342,28,16,11,3,4,6,410
060700205,338,31,3,3,0,0,7,382
060700206,371,39,1,7,0,0,17,435
060700207,182,14,5,4,1,0,6,212
060700208,245,16,0,5,1,0,15,282
060700209,289,22,1,8,1,6,10,337
060700210,442,32,1,10,0,0,9,494
060700211,240,34,1,11,0,13,4,303
060700212,351,18,4,14,0,3,11,401
060700213,282,26,4,7,0,1,11,331
060700214,334,23,0,5,0,0,13,375
060700215,281,20,3,14,1,1,11,331
060700216,192,10,0,2,2,2,7,215
060700217,132,13,0,3,0,0,1,149
060700218,143,11,3,12,1,40,11,221
060700301,52,6,1,1,1,23,8,92
060700302,76,2,2,1,1,58,5,145
060700303,70,0,2,4,0,26,1,103
060700304,77,0,1,0,1,21,14,114
060700305,433,27,2,10,0,1,11,484
060700306,432,16,2,4,0,0,16,470
060700401,378,10,5,6,2,12,23,436
060700402,19,18,0,0,0,4,2,43
060700403,18,10,0,0,0,1,13,42
060700404,111,16,0,2,1,15,17,162
060700501,39,9,0,2,0,21,14,85
060700502,22,2,0,0,2,23,8,57
060700601,16,8,0,0,0,7,5,36
060700602,42,14,1,0,0,4,4,65
060700701,14,4,0,0,0,8,1,27
060700702,19,2,0,1,0,5,3,30
060700801,135,20,5,3,1,6,15,185
060700802,8,2,0,0,0,4,2,16
060700803,9,4,0,0,0,0,0,13
060700804,13,10,0,0,0,2,7,32
060700805,13,0,0,0,0,8,7,28
060700806,4,0,0,0,0,4,3,11
060700901,7,0,0,0,0,0,6,13
060700902,5,10,0,0,0,0,0,15
060700903,13,1,0,0,0,5,11,30
060700904,5,3,0,0,0,0,6,14
060701001,56,24,2,0,1,5,1,89
060701002,19,4,0,0,0,7,1,31
060701003,19,9,0,0,0,5,0,33
060701004,9,1,0,0,0,0,6,16
060701101,3,3,0,0,0,0,3,9
060701102,5,1,0,0,0,0,5,11
060701201,21,0,0,0,0,15,4,40
060701202,19,2,0,0,0,30,2,53
060770101,313,17,4,5,2,1,7,349
060770102,260,13,0,3,0,0,2,278
060770103,224,26,2,3,6,4,12,277
060770104,250,12,8,3,8,3,23,307
060770105,292,19,4,13,1,3,8,340
060770106,390,15,6,4,0,3,17,435
060770107,101,3,1,4,0,9,19,137
060770108,207,11,7,2,1,0,19,247
060770109,287,29,5,4,7,2,22,356
060770201,22,12,0,0,0,0,1,35
060770202,17,4,0,0,0,3,13,37
060770301,13,0,0,0,0,0,2,15
060770302,8,1,0,0,0,1,8,18
060770401,250,24,2,7,2,24,6,315
060770402,167,29,7,4,5,14,12,238
060770403,15,2,0,0,0,0,4,21
060770404,11,0,0,0,0,7,8,26
060770405,17,0,0,0,0,4,2,23
060770501,366,20,5,11,4,3,13,422
060770502,206,11,2,9,0,4,3,235
060770503,300,14,0,7,0,9,11,341
060770504,168,11,3,3,0,4,6,195
060770505,237,0,0,6,0,5,21,269
060770506,30,2,0,0,0,1,0,33
060770507,11,0,0,0,0,0,10,21
060770508,22,3,0,0,0,3,1,29
060770509,442,10,2,2,2,22,7,487
060770510,573,39,0,1,0,1,3,617
060770511,307,17,3,8,0,6,11,352
060770512,185,6,3,3,0,0,9,206
060770513,196,22,4,2,0,3,0,227
060770514,96,3,0,1,0,0,1,101
060770601,21,1,0,0,0,0,3,25
060770602,28,2,0,1,0,6,13,50
060770603,18,4,0,1,0,1,7,31
060770701,14,0,0,0,0,0,7,21
060770801,14,0,0,0,0,1,17,32
060770901,12,11,0,0,0,0,8,31
060770902,8,2,0,0,0,0,0,10
060770903,13,2,0,0,0,3,0,18
060770904,24,2,0,0,0,1,6,33
060770905,11,1,0,1,0,3,2,18
060771001,4,8,0,0,0,0,3,15
060771002,10,2,0,0,0,1,1,14
060771003,8,0,0,0,0,3,0,11
060771101,5,0,0,0,0,3,2,10
060771102,7,0,0,0,0,1,0,8
060771103,11,0,1,0,1,4,6,23
060771201,20,0,0,0,0,0,0,20
060771202,12,2,0,0,0,0,2,16
060771302,17,4,0,0,0,0,0,21
060771303,11,3,0,0,0,1,1,16
060771401,319,8,6,2,1,1,3,340
060771402,367,19,4,9,4,3,16,422
060771403,310,19,19,7,3,2,13,373
060771404,354,15,11,8,4,1,16,409
060771405,243,38,5,3,26,3,21,339
060771406,332,32,15,5,18,10,18,430
060771407,281,30,0,4,12,2,19,348
060771408,417,10,4,0,2,0,3,436
060771409,338,12,0,6,0,0,5,361
060840101,19,1,0,0,0,0,3,23
060840102,16,16,0,0,0,0,6,38
060840103,32,8,0,0,0,3,8,51
060840201,18,5,0,0,0,0,13,36
060840202,13,6,1,0,0,3,6,29
060840301,56,11,1,0,0,2,20,90
060840302,17,5,1,0,0,0,12,35
060840303,12,5,0,1,0,1,9,28
060840304,17,14,0,0,0,0,4,35
060840305,13,2,0,0,0,0,4,19
060840401,4,4,0,1,0,9,7,25
060840402,27,11,0,0,0,0,10,48
060840403,16,5,0,0,0,3,10,34
060840501,32,7,0,0,0,3,4,46
060840502,17,0,0,0,0,0,14,31
060840602,5,0,0,0,0,1,3,9
060840603,6,0,0,0,0,0,5,11
060840604,10,0,0,0,0,1,11,22
060840605,9,0,0,0,0,1,9,19
060840701,66,10,0,1,0,15,15,107
060840702,188,19,1,1,0,1,3,213
060840703,205,15,1,9,3,5,10,248
060840704,314,23,4,5,1,0,25,372
060840705,168,12,0,2,1,0,8,191
060840706,281,16,4,3,0,0,16,320
060840707,266,42,5,2,6,1,13,335
060840708,287,53,6,0,7,2,21,376
060840709,244,31,5,5,18,4,31,338
060840710,271,32,6,3,1,9,10,332
060840711,336,37,3,9,2,0,14,401
060840801,43,15,0,1,1,0,4,64
060840802,12,3,0,0,0,1,6,22
060840803,29,19,0,0,0,0,9,57
060840804,6,16,0,0,0,0,2,24
060840901,178,24,11,6,0,0,13,232
060840902,234,22,5,4,6,3,11,285
060840903,125,12,1,2,0,0,3,143
060840904,137,26,1,2,1,1,8,176
060840905,203,13,2,1,1,1,10,231
060840906,221,38,1,4,6,0,4,274
060840907,30,5,1,0,0,2,9,47
060840908,6,2,0,0,0,0,3,11
060840909,13,0,0,0,0,0,2,15
060841001,12,12,0,0,0,0,0,24
060841002,7,11,0,0,0,0,0,18
060841003,10,13,0,0,0,0,0,23
060841101,8,33,0,0,0,0,0,41
060841102,33,18,0,0,0,0,20,71
060841201,75,17,0,0,0,3,39,134
060841202,139,22,3,4,0,0,3,171
060841203,203,21,0,3,0,0,3,230
060841204,329,25,8,0,3,1,9,375
060841205,226,14,4,3,1,0,2,250
060841206,399,35,2,7,1,1,14,459
060841207,199,23,5,2,3,1,13,246
060841208,332,27,12,6,1,1,11,390
060841209,196,25,3,1,0,3,2,230
060841210,268,36,2,12,2,0,12,332
060980101,273,2,7,5,2,0,26,315
060980102,285,2,14,9,0,0,14,324
060980103,300,3,1,3,2,0,3,312
060980104,288,6,6,10,0,0,33,343
060980105,257,0,6,1,1,0,22,287
060980106,292,6,8,7,3,0,13,329
060980107,227,2,13,1,19,3,21,286
060980108,241,11,4,2,8,0,14,280
060980109,232,28,7,9,3,0,6,285
060980110,301,10,5,6,1,1,14,338
060980111,363,12,6,8,2,0,13,404
060980112,250,27,5,6,2,0,12,302
060980201,275,24,2,4,1,1,13,320
060980202,332,16,3,11,3,0,10,375
060980203,263,16,2,5,2,0,11,299
060980204,391,8,0,2,0,0,15,416
060980205,298,15,1,0,1,1,12,328
060980206,289,29,8,8,0,1,14,349
060980207,365,13,9,14,2,0,21,424
060980208,348,21,4,13,0,0,11,397
060980209,215,16,1,3,1,0,3,239
060980210,300,8,3,2,0,0,6,319
060980211,216,22,0,5,1,0,13,257
060980212,433,11,2,9,2,1,8,466
060980213,209,13,1,3,1,0,13,240
060980214,218,1,3,2,0,0,6,230
060980215,229,14,0,5,0,1,5,254
060980301,131,14,1,1,0,0,4,151
060980302,86,10,0,0,0,0,2,98
060980303,337,11,5,5,1,1,15,375
060980304,281,20,0,2,2,0,6,311
060980305,242,7,1,1,3,1,12,267
060980306,340,10,3,3,3,0,10,369
060980307,251,4,8,1,0,0,20,284
060980308,414,15,3,4,1,1,9,447
060980309,418,8,1,0,0,0,10,437
060980310,413,19,0,1,0,0,2,435
060980311,228,12,0,0,1,6,4,251
060980312,165,4,0,1,0,0,3,173
060980313,133,8,2,0,1,0,1,145
060980401,54,9,0,1,0,3,7,74
060980402,139,12,0,2,0,0,18,171
060980403,172,29,1,15,1,26,30,274
060980404,100,2,1,5,0,10,13,131
060980405,6,0,0,0,0,5,2,13
060980406,168,28,0,2,1,42,12,253
060980407,74,6,2,14,0,75,29,200
060980408,44,1,4,8,0,91,2,150
060980501,279,12,1,5,0,1,8,306
060980502,336,9,4,4,2,2,4,361
060980503,291,6,3,3,0,1,15,319
060980504,270,16,7,2,0,0,9,304
060980505,316,15,1,5,0,0,11,348
060980506,256,12,1,1,0,1,7,278
060980507,222,15,2,3,0,0,6,248
060980508,233,2,3,4,0,2,11,255
060980509,271,16,1,10,3,2,7,310
060980510,299,14,2,2,0,2,19,338
060980601,258,20,7,2,3,1,16,307
060980602,378,26,6,4,5,1,9,429
060980603,452,15,4,22,2,1,15,511
060980604,207,8,0,1,0,0,4,220
060980605,371,18,3,5,0,2,12,411
060980606,288,18,5,1,0,2,11,325
060980607,288,21,6,9,4,0,10,338
060980608,328,19,4,5,0,0,14,370
060980609,395,26,3,6,1,0,10,441
060980610,221,6,0,0,1,0,4,232
060980611,297,6,2,8,4,0,13,330
060980612,185,4,0,10,0,3,5,207
060980613,234,4,0,0,0,0,5,243
060980614,255,5,1,0,0,0,20,281
060980615,231,10,2,10,2,0,6,261
060980616,302,12,2,18,0,1,5,340
060980617,221,11,0,3,0,0,8,243
060980701,220,17,7,6,0,0,12,262
060980702,570,19,2,5,1,1,26,624
060980703,163,9,3,1,3,0,4,183
060980704,287,22,3,2,0,0,16,330
060980705,293,25,3,8,0,1,24,354
060980706,332,24,7,11,2,2,15,393
060980707,13,0,0,0,0,22,1,36
060980801,323,12,2,4,1,0,6,348
060980802,250,16,2,15,0,0,4,287
060980803,221,9,3,6,0,0,12,251
060980804,267,16,3,2,0,0,5,293
060980805,160,46,6,5,2,2,8,229
060980806,238,19,17,6,1,0,19,300
060980807,183,29,14,1,2,0,37,266
060980808,234,21,7,1,0,0,8,271
060980809,233,28,7,10,1,0,5,284
060980810,400,18,3,3,1,0,13,438
060980811,226,27,8,1,2,1,3,268
060980812,208,8,10,23,0,0,5,254
060980813,206,11,1,4,0,0,13,235
060980814,255,14,0,3,0,1,11,284
060980815,300,14,6,8,6,0,3,337
060980816,274,16,8,4,3,2,14,321
060980817,352,13,0,5,0,0,6,376
061050101,384,30,8,9,2,1,9,443
061050102,322,31,5,17,0,5,14,394
061050103,283,24,9,5,2,3,7,333
061050104,376,40,12,2,19,6,30,485
061050105,237,42,7,8,11,6,16,327
061050106,250,32,11,6,7,0,16,322
061050107,287,36,9,7,1,0,7,347
061050108,330,36,5,8,1,4,17,401
061050109,248,25,5,3,3,2,24,310
061050201,344,59,6,5,0,2,13,429
061050202,335,36,6,6,1,0,9,393
061050203,313,50,7,1,10,1,4,386
061050204,160,15,2,4,5,0,10,196
061050205,297,25,5,1,16,4,23,371
061050206,271,27,4,9,1,0,17,329
061050207,300,57,13,8,7,3,30,418
061050208,150,34,8,21,4,1,8,226
061050209,203,21,6,2,1,1,19,253
061050210,283,22,5,5,4,1,18,338
061050211,341,25,10,8,4,1,17,406
061050301,101,8,0,0,0,2,46,157
061050401,45,19,0,0,0,2,34,100
061050402,22,4,0,0,0,4,21,51
061050403,79,8,2,1,1,3,32,126
061050501,40,2,0,0,0,23,21,86
061050601,64,51,1,0,0,2,3,121
061050602,36,1,0,0,0,28,13,78
061050701,44,10,0,0,0,3,17,74
061050801,135,9,3,1,0,4,6,158
061050802,163,15,0,10,0,5,9,202
061050803,270,15,4,17,0,1,3,310
061050804,4,2,0,0,0,0,1,7
061050805,68,8,0,4,0,50,5,135
061050806,31,17,0,2,0,0,8,58
061050807,38,2,0,0,0,5,23,68
061050808,55,27,0,0,0,18,5,105
061050809,35,11,0,0,0,1,29,76
061050901,42,6,0,0,0,0,58,106
061051001,54,23,0,2,1,4,39,123
061051002,52,47,0,1,1,3,22,126
061051101,59,29,0,0,1,4,27,120
061051102,160,15,5,3,0,4,31,218
061051103,151,19,1,6,0,3,8,188
061051104,175,30,1,1,0,3,15,225
061051105,318,40,4,6,1,1,26,396
061051106,95,26,3,1,0,0,11,136
061051107,107,26,2,1,0,0,2,138
061051201,38,57,0,0,0,1,5,101
061051301,175,27,3,0,0,5,16,226
061051302,126,8,3,0,3,1,7,148
061051303,232,33,6,4,0,2,12,289
061051304,77,20,0,2,0,6,30,135
061051401,416,30,18,11,0,8,14,497
061051402,249,16,2,8,0,1,14,290
061051403,180,13,3,5,1,1,15,218
061051404,189,16,2,14,2,11,9,243
061051405,221,23,4,11,0,11,2,272
061051406,268,23,4,4,0,22,10,331
061051407,273,4,0,5,1,1,6,290
061051408,78,9,0,1,0,16,15,119
061051409,30,0,0,0,1,5,5,41
061051410,312,28,2,13,0,1,10,366
061051411,162,10,2,6,7,3,7,197
061051412,194,18,1,4,0,0,4,221
061051413,331,22,1,2,1,0,5,362
061120101,222,21,1,4,0,1,16,265
061120102,357,21,8,9,4,2,16,417
061120103,397,43,6,6,8,0,6,466
061120104,172,26,6,1,17,0,11,233
061120105,225,50,0,1,4,0,2,282
061120106,278,13,12,1,9,1,19,333
061120107,265,31,2,1,1,1,21,322
061120108,259,16,5,5,9,3,22,319
061120109,390,15,3,7,1,0,6,422
061120110,477,20,4,9,4,2,11,527
061120111,326,27,6,2,5,0,13,379
061120112,425,31,3,12,2,1,13,487
061120113,241,23,2,3,0,3,6,278
061120201,311,12,0,8,0,0,7,338
061120202,299,26,0,3,1,3,7,339
061120203,381,17,7,17,4,1,9,436
061120204,177,12,1,3,1,8,4,206
061120205,330,19,5,10,6,3,11,384
061120206,307,27,5,6,0,0,3,348
061120207,266,12,1,0,0,0,9,288
061120208,108,10,0,2,0,5,11,136
061120209,194,3,2,0,0,1,8,208
061120210,292,14,3,2,4,1,18,334
061120211,421,13,1,0,1,0,8,444
061120301,72,0,1,0,0,4,14,91
061120302,7,0,0,1,0,3,1,12
061120303,7,0,0,0,0,0,9,16
061120304,8,1,0,0,0,1,2,12
061120305,11,9,0,0,0,0,0,20
061120306,8,6,0,0,0,0,0,14
061120307,10,4,0,0,0,0,0,14
061120308,8,0,0,0,0,3,9,20
061120309,10,7,0,0,0,0,1,18
061120310,64,11,0,1,0,0,2,78
061120401,6,1,0,0,0,3,0,10
061120402,4,5,0,0,0,0,0,9
061120403,5,9,0,0,1,0,7,22
061120501,153,20,0,3,2,2,13,193
061120502,10,1,0,0,0,0,8,19
061120503,4,0,0,0,0,0,2,6
061120504,4,0,0,0,0,7,7,18
061120505,3,3,0,0,0,0,5,11
061120506,7,14,0,0,0,0,0,21
061120601,14,0,0,0,1,1,1,17
061120602,9,5,0,0,0,0,1,15
061120603,14,2,0,0,0,1,19,36
061120604,15,0,0,0,0,1,10,26
061120605,10,4,0,0,0,1,2,17
061120606,8,13,0,0,0,0,0,21
061120701,153,13,2,2,0,1,16,187
061120702,342,18,2,9,0,4,26,401
061120703,76,4,1,2,0,3,8,94
061120704,10,0,3,2,0,6,7,28
061120705,8,0,0,0,0,0,8,16
061120706,7,1,0,0,0,4,0,12
061120707,6,16,0,0,0,0,6,28
061120708,6,0,0,0,0,0,14,20
061120709,159,21,0,6,1,3,1,191
061120710,78,3,0,0,0,0,1,82
061120801,7,0,0,0,1,3,1,12
061120802,19,1,0,2,1,4,5,32
061120803,13,2,0,0,0,0,4,19
061120804,6,0,0,0,0,0,5,11
061120805,13,0,0,0,0,0,4,17
061120901,40,5,0,0,0,1,10,56
061120902,2,0,0,0,0,4,0,6
061120903,10,0,0,0,0,0,5,15
061120904,14,1,0,0,0,0,0,15
061120905,6,0,0,0,0,5,0,11
061120906,27,0,0,0,0,1,6,34
061120907,10,0,0,1,0,0,0,11
061120908,3,0,0,0,0,1,7,11
061121001,45,24,1,1,0,1,1,73
061121002,162,2,1,10,0,34,2,211
061121003,197,38,2,11,13,30,15,306
061121004,53,32,0,1,0,1,18,105
061121005,192,12,1,5,0,7,3,220
061121101,193,9,5,1,4,8,20,240
061121102,67,6,0,3,0,3,7,86
061121103,175,15,1,2,1,9,11,214
061121104,41,10,0,0,0,0,3,54
061121105,0,0,0,0,0,0,2,2
061121106,35,7,1,1,3,18,45,110
061121107,7,2,0,0,2,4,0,15
061121108,316,26,0,4,1,0,13,360
061121109,251,45,0,40,0,1,9,346
061121201,10,12,0,0,0,0,1,23
061121202,5,0,0,0,0,0,5,10
061121203,6,4,0,0,0,0,2,12
061121204,4,9,0,0,0,0,5,18
061121205,5,8,0,0,0,0,1,14
061121301,120,15,3,1,1,2,13,155
061121302,11,0,0,0,0,2,14,27
061121303,23,12,0,2,0,7,29,73
061121304,12,3,0,0,0,7,18,40
061121305,86,15,1,4,0,2,19,127
061121401,273,19,1,5,1,4,5,308
061121402,326,15,4,5,4,0,4,358
061121403,272,19,0,6,2,2,21,322
061121404,313,27,5,6,7,3,17,378
061121405,271,29,10,6,7,1,17,341
061121406,274,34,4,3,8,4,22,349
061121407,272,26,9,4,11,3,11,336
061121408,292,28,11,3,5,3,27,369
061121409,268,26,8,3,14,1,13,333
061121410,274,31,9,2,11,1,20,348
061190101,25,11,5,0,0,0,6,47
061190102,13,1,0,0,1,0,6,21
061190103,10,8,0,0,0,5,2,25
061190104,15,7,1,0,0,0,3,26
061190201,10,6,0,1,0,0,0,17
061190202,11,0,0,0,0,5,5,21
061190203,109,12,11,5,1,100,15,253
061190204,25,5,0,0,0,0,1,31
061190205,31,11,0,2,0,18,1,63
061190206,17,16,0,2,0,1,5,41
061190301,284,27,8,8,17,0,6,350
061190302,306,14,12,2,20,4,17,375
061190303,362,20,4,4,9,1,6,406
061190304,423,42,2,8,0,0,8,483
061190305,354,13,8,14,1,2,6,398
061190306,176,0,2,38,0,2,1,219
061190307,276,10,2,8,0,3,7,306
061190308,317,33,7,21,0,5,6,389
061190309,243,14,4,1,0,3,2,267
061190310,64,10,0,4,0,5,12,95
061190401,148,18,7,10,4,42,10,239
061190402,12,11,0,0,0,0,2,25
061190403,119,5,6,6,0,58,27,221
061190404,55,116,4,10,0,20,9,214
061190405,24,6,0,0,0,1,11,42
061190406,39,10,2,5,0,12,11,79
061190407,311,43,4,11,1,5,12,387
061190408,107,7,2,12,0,26,5,159
061190409,239,15,8,9,0,7,28,306
061190501,70,96,0,23,0,144,2,335
061190502,30,7,0,26,0,10,4,77
061190601,19,1,0,2,1,10,0,33
061190602,19,3,0,1,0,9,1,33
061190603,26,8,0,0,1,3,0,38
061190701,199,8,0,3,2,8,11,231
061190702,347,19,0,19,0,9,14,408
061190703,23,2,0,0,0,16,1,42
061190704,12,0,0,0,0,8,11,31
061190705,17,6,0,1,2,5,39,70
061190706,7,0,0,0,0,2,5,14
061190707,234,18,3,8,0,2,7,272
061190801,76,7,1,5,0,14,17,120
061190802,12,3,0,0,0,0,3,18
061190804,7,5,0,0,0,0,4,16
061190805,15,5,0,0,0,1,0,21
061190806,20,5,0,0,0,0,3,28
061190901,66,8,0,2,0,11,7,94
061190902,21,6,0,0,0,9,12,48
061190903,15,4,0,0,0,7,0,26
061190904,96,9,0,8,0,12,9,134
061191001,78,1,0,0,0,2,44,125
061191002,343,9,3,5,0,1,7,368
061191003,311,24,5,5,2,1,9,357
061191004,218,10,5,7,0,2,8,250
061191005,288,19,4,7,0,5,4,327
061191006,419,24,11,11,2,2,8,477
061191007,270,16,9,3,1,3,6,308
061191008,336,25,9,8,4,2,9,393
061191009,264,17,0,4,0,1,8,294
061191010,33,0,2,0,2,13,7,57
061260101,275,4,1,2,0,1,10,293
061260102,408,1,14,4,2,0,13,442
061260103,269,2,11,4,1,0,8,295
061260104,211,0,7,4,1,1,6,230
061260105,244,0,2,3,2,1,7,259
061260106,231,13,9,7,0,0,8,268
061260107,241,12,6,2,2,1,10,274
061260108,251,3,2,3,3,1,4,267
061260109,319,37,4,1,0,1,11,373
061260110,278,34,17,3,1,0,11,344
061260111,250,21,17,21,3,1,7,320
061260112,356,25,9,5,4,0,7,406
061260113,230,20,7,1,0,0,7,265
061260114,220,22,2,3,5,0,8,260
061260201,314,5,0,0,0,0,8,327
061260202,402,21,2,1,4,0,16,446
061260203,340,34,5,5,8,2,7,401
061260204,310,20,5,4,0,0,5,344
061260205,353,21,4,3,7,4,28,420
061260206,201,11,1,1,0,0,5,219
061260207,230,14,2,3,1,0,0,250
061260208,263,9,3,6,0,1,2,284
061260209,360,15,4,6,0,1,16,402
061260210,288,30,6,1,0,1,22,348
061260211,201,17,7,1,0,1,10,237
061260301,252,42,14,1,6,0,23,338
061260302,266,38,27,2,40,1,47,421
061260303,351,48,17,3,7,2,26,454
061260304,166,33,10,1,14,0,15,239
061260305,189,12,5,1,5,0,4,216
061260306,226,45,18,4,8,0,18,319
061260307,306,35,12,2,6,4,14,379
061260308,218,31,6,6,3,1,7,272
061260309,299,12,20,12,12,1,9,365
061260310,351,28,8,2,2,1,17,409
061260311,288,5,10,2,3,0,35,343
061260401,245,43,10,4,1,0,9,312
061260402,233,23,22,1,3,0,21,303
061260403,16,0,0,0,0,0,4,20
061260404,387,22,0,3,2,0,9,423
061260405,28,4,0,0,0,0,1,33
061260406,14,17,0,0,0,0,1,32
061260407,457,10,1,11,1,0,17,497
061260501,314,15,5,3,0,2,4,343
061260502,363,32,5,2,0,0,4,406
061260503,310,21,1,0,0,0,19,351
061260504,301,17,0,2,0,0,12,332
061260505,325,13,1,2,0,0,5,346
061260506,262,13,0,2,0,0,3,280
061260507,237,9,0,1,0,0,4,251
061260508,207,23,1,1,0,0,6,238
061260509,458,18,1,3,0,0,6,486
061260510,222,11,0,4,4,0,6,247
061260511,233,8,1,4,2,0,7,255
061260512,369,18,0,2,0,0,2,391
061260513,211,26,4,6,0,13,14,274
061260514,227,14,3,11,3,1,9,268
061260515,307,18,0,3,0,9,13,350
061260516,323,38,7,12,1,10,14,405
061260517,17,2,0,0,0,0,0,19
061260601,110,36,5,10,0,64,13,238
061260602,17,6,0,0,0,3,6,32
061260603,32,7,0,11,0,3,0,53
061260604,104,9,7,11,0,63,10,204
061260605,98,28,2,8,0,31,12,179
061260606,116,29,5,9,1,63,14,237
061260607,105,39,1,2,0,163,42,352
061260608,99,1,5,4,0,88,4,201
061260609,106,12,1,5,0,228,30,382
061260701,300,13,2,14,1,0,1,331
061260702,258,5,9,1,4,0,10,287
061260703,403,20,5,1,0,0,5,434
061260704,273,18,0,6,1,0,7,305
061260705,301,13,3,4,0,1,12,334
061260706,224,20,1,3,1,0,4,253
061260707,280,11,1,3,0,1,10,306
061260708,299,8,1,2,0,0,2,312
061260709,453,24,14,14,8,0,11,524
061260710,290,11,6,2,0,2,3,314
061260801,19,1,2,1,0,0,1,24
061260802,158,46,8,4,8,0,15,239
061260803,209,40,19,8,12,2,17,307
061260804,264,36,10,8,52,0,24,394
061260805,263,35,7,8,31,0,28,372
061260806,250,32,16,3,13,1,12,327
061260807,261,19,3,4,9,1,31,328
061260808,289,25,8,1,3,0,7,333
061260809,235,27,16,4,2,0,9,293
061260901,457,24,1,5,0,0,9,496
061260902,263,8,2,2,0,1,1,277
061260903,220,5,0,5,0,0,4,234
061260905,86,13,0,2,2,20,22,145
061260906,83,18,0,2,0,43,1,147
061260907,485,23,0,28,0,0,13,549
061260908,305,6,8,2,0,0,7,328
061260909,361,15,4,14,1,0,9,404
061260910,405,16,2,2,0,0,3,428
061260911,335,16,3,0,1,0,3,358
061260912,1,0,0,0,0,0,1,2
061260913,112,40,1,9,0,35,7,204
061260914,226,16,0,3,0,0,9,254
061260915,150,12,1,5,0,0,2,170
061260916,49,49,19,16,1,0,11,145
061260917,61,18,2,0,0,45,4,130
061260918,171,15,0,7,0,3,2,198
061260919,75,17,1,8,0,6,15,122
061261001,35,18,1,1,0,53,40,148
061261002,28,4,0,2,0,30,8,72
061261003,163,69,0,2,1,68,61,364
061261004,37,9,0,0,0,7,65,118
061261005,30,9,1,1,1,24,22,88
061340101,280,3,3,4,2,16,14,322
061340102,148,7,0,8,0,8,11,182
061340103,216,6,0,28,2,39,11,302
061340104,88,13,1,1,0,0,5,108
061340105,413,10,9,13,0,7,17,469
061340106,238,11,2,9,0,10,10,280
061340107,180,6,1,8,2,23,21,241
061340108,58,1,3,15,0,22,4,103
061340109,162,8,2,10,1,17,6,206
061340110,141,2,3,16,1,52,9,224
061340111,121,5,2,16,1,47,6,198
061340112,218,25,0,4,1,531,18,797
061340113,32,3,0,2,0,0,11,48
061340114,41,5,0,1,0,3,13,63
061340201,341,24,2,4,0,1,2,374
061340202,248,16,0,14,3,4,13,298
061340203,286,12,3,14,0,1,7,323
061340204,421,23,8,8,4,13,4,481
061340205,39,6,0,9,0,8,4,66
061340206,194,2,1,5,1,3,16,222
061340207,365,8,4,8,0,10,6,401
061340208,307,9,7,8,1,5,3,340
061340209,287,22,1,10,1,2,4,327
061340301,524,20,9,14,0,9,22,598
061340302,288,10,5,5,1,1,5,315
061340303,244,3,5,5,0,2,9,268
061340304,376,22,12,9,10,1,7,437
061340305,285,22,3,5,9,5,22,351
061340306,303,15,7,4,15,2,24,370
061340307,435,23,7,8,0,3,10,486
061340308,449,10,4,17,0,6,9,495
061340309,443,30,9,1,10,2,19,514
061340401,40,0,0,5,0,1,0,46
061340402,180,11,2,7,1,54,6,261
061340403,55,35,0,2,0,9,17,118
061340404,64,19,0,1,0,15,7,106
061340405,12,6,0,1,0,1,0,20
061340406,150,14,2,11,0,17,16,210
061340501,137,9,1,1,2,29,33,212
061340502,30,3,0,0,1,8,13,55
061340601,45,10,0,1,0,5,3,64
061340602,45,4,1,1,0,5,6,62
061340701,24,0,1,0,0,4,12,41
061340702,18,0,2,1,1,6,10,38
061340801,104,18,0,4,0,4,1,131
061340802,14,2,0,0,1,3,7,27
061340803,31,3,0,0,0,17,0,51
061340804,11,5,0,0,1,1,8,26
061340901,37,12,0,0,1,1,2,53
061340902,156,30,2,4,1,20,19,232
061340903,131,27,1,2,0,33,22,216
061340904,138,3,1,0,0,0,4,146
061340905,127,14,0,4,0,6,4,155
061340906,157,7,1,9,0,4,1,179
061340907,205,14,0,11,1,5,7,243
061340908,306,18,1,18,0,1,10,354
061340909,350,17,1,4,1,3,17,393
061340910,265,11,0,7,0,4,4,291
061340911,263,7,1,14,1,3,6,295
061340912,44,3,0,0,0,1,5,53
061340913,261,18,2,4,0,12,7,304
061340914,145,22,2,3,1,2,3,178
061341001,35,7,0,0,0,6,3,51
061341002,366,19,1,136,0,1,10,533
061341003,292,25,2,5,0,23,3,350
061341004,280,16,2,10,0,0,3,311
061341005,278,15,3,13,0,3,6,318
061341006,276,21,10,7,11,3,15,343
061341007,192,2,2,4,1,1,3,205
061341008,284,19,4,0,1,2,8,318
061341009,471,25,5,17,2,2,7,529
061341010,388,19,3,12,1,4,6,433
061341011,72,2,0,9,1,24,1,109
061400101,35,0,0,0,0,0,0,35
061400102,17,5,0,0,0,0,0,22
061400103,29,3,0,0,0,2,7,41
061400201,9,1,0,0,0,0,11,21
061400202,15,0,0,1,0,8,12,36
061400203,20,0,0,0,0,7,6,33
061400204,19,0,0,0,0,2,2,23
061400301,202,11,1,7,0,0,1,222
061400302,387,26,7,4,1,3,5,433
061400303,243,20,4,7,2,2,10,288
061400304,267,15,1,2,2,4,1,292
061400305,317,30,6,4,13,1,14,385
061400306,226,11,1,8,1,0,1,248
061400307,277,20,7,2,2,6,6,320
061400308,303,21,3,5,7,8,9,356
061400309,246,15,0,4,0,6,8,279
061400310,184,14,3,5,0,4,2,212
061400311,17,1,0,0,0,12,0,30
061400312,18,4,0,0,0,1,13,36
061400313,13,0,0,0,0,2,10,25
061400314,11,2,0,0,0,6,7,26
061400315,343,12,2,27,1,6,7,398
061400316,317,23,2,2,3,0,4,351
061400317,269,22,0,4,0,1,9,305
061400318,240,9,2,3,2,0,8,264
061400319,271,12,3,2,0,3,9,300
061400401,82,7,0,1,0,11,7,108
061400402,22,3,0,1,0,6,5,37
061400403,29,0,0,0,0,0,0,29
061400501,19,3,0,0,0,0,1,23
061400502,14,1,0,0,0,7,1,23
061400503,14,0,0,0,0,1,5,20
061400601,6,0,0,0,0,0,0,6
061470101,326,24,1,7,0,1,9,368
061470102,313,23,6,9,6,4,22,383
061470103,236,23,10,2,3,2,16,292
061470104,249,23,3,6,0,0,7,288
061470105,285,30,3,2,3,3,11,337
061470106,288,15,7,3,3,1,25,342
061470107,282,11,0,0,0,0,4,297
061470108,280,20,0,1,0,0,13,314
061470109,358,20,0,8,0,0,10,396
061470201,165,24,2,2,3,1,12,209
061470202,11,3,0,0,0,2,21,37
061470203,43,9,0,0,0,1,1,54
061470204,8,0,0,0,0,0,8,16
061470205,9,0,0,0,0,6,13,28
061470301,142,23,2,2,2,4,15,190
061470302,25,6,0,1,2,1,21,56
061470303,3,0,0,0,0,0,1,4
061470304,16,1,0,0,0,0,15,32
061470305,15,0,0,0,0,0,18,33
061470306,7,13,0,0,0,0,0,20
061470307,15,8,0,0,0,0,27,50
061470401,6,0,0,0,0,0,16,22
061470402,15,7,0,1,0,3,0,26
061470403,15,0,0,0,0,21,21,57
061470501,471,23,4,7,0,0,15,520
061470502,14,1,0,0,0,3,4,22
061470503,14,0,0,0,0,1,12,27
061470601,4,0,0,0,0,5,12,21
061470602,123,9,1,0,0,4,1,138
061470603,20,3,0,0,0,0,10,33
061470604,4,0,0,0,0,0,0,4
061470701,224,22,2,9,0,29,17,303
061470702,4,8,0,0,0,0,1,13
061470703,70,0,0,0,0,0,0,70
061470704,16,0,0,0,0,9,9,34
061470705,4,0,0,0,0,0,9,13
061470706,2,0,0,1,0,0,11,14
061470707,1,0,0,0,0,2,8,11
061470708,25,1,0,3,1,7,10,47
061470709,8,2,0,0,0,4,11,25
061470710,6,5,0,0,0,0,0,11
061470711,7,0,0,0,0,8,3,18
061470712,2,3,0,1,0,0,6,12
061470801,183,24,2,6,0,7,30,252
061470802,12,1,0,0,0,4,0,17
061470803,7,2,0,0,1,6,0,16
061470804,15,0,0,0,0,0,2,17
061470805,20,5,0,0,0,1,0,26
061470901,73,1,0,1,0,2,12,89
061470902,42,6,0,0,1,2,20,71
061470903,9,0,0,0,0,7,10,26
061470904,10,10,0,0,0,6,0,26
061470905,9,0,0,0,0,0,18,27
061470906,12,1,0,0,0,0,39,52
061470907,22,0,0,0,0,0,34,56
061471001,71,0,0,0,2,0,31,104
061471002,23,3,0,0,0,9,14,49
061471003,15,0,0,0,0,2,40,57
061471101,40,11,0,0,0,0,28,79
061471102,9,11,0,0,1,0,10,31
061471103,13,6,0,0,0,0,0,19
061471201,335,32,5,8,2,4,11,397
061471202,295,11,4,5,1,1,14,331
061471203,290,19,2,8,0,4,3,326
061471204,234,14,4,4,4,4,3,267
061471205,229,24,2,1,2,3,13,274
061471206,248,38,9,5,7,4,12,323
061471207,279,24,4,1,5,3,15,331
061471208,360,34,9,7,1,2,20,433
061471209,302,19,2,3,0,2,9,337
061471210,216,7,0,2,1,0,0,226
061540101,131,8,3,0,0,4,8,154
061540102,108,24,0,1,0,0,6,139
061540103,14,5,0,0,0,6,4,29
061540104,13,2,0,0,0,2,16,33
061540105,21,11,0,0,0,1,0,33
061540201,339,26,2,8,0,2,11,388
061540202,138,15,3,3,0,0,5,164
061540203,23,2,0,0,0,0,0,25
061540204,23,2,0,0,0,1,8,34
061540205,129,14,0,1,0,0,9,153
061540206,9,0,0,0,0,0,2,11
061540207,15,0,0,0,0,2,3,20
061540208,30,4,0,0,0,0,1,35
061540209,346,31,7,5,3,3,17,412
061540210,136,11,1,7,0,2,10,167
061540301,24,4,0,0,0,2,3,33
061540302,31,7,0,0,0,4,5,47
061540401,38,37,0,0,0,0,16,91
061540402,141,32,1,6,0,9,18,207
061540403,10,0,0,0,0,7,23,40
061540404,12,1,0,0,0,2,32,47
061540405,15,0,0,0,0,0,0,15
061540501,13,12,0,0,0,6,11,42
061540502,12,0,0,0,0,6,3,21
061540601,156,8,1,4,1,1,10,181
061540602,146,8,1,2,0,2,4,163
061540603,175,15,0,2,0,1,11,204
061540604,134,10,5,0,7,0,12,168
061540605,136,12,6,1,0,1,9,165
061540606,60,7,0,0,0,0,2,69
061540607,227,23,2,0,1,0,7,260
061540608,194,9,1,2,2,2,10,220
061540609,20,6,0,0,0,4,6,36
061540610,56,62,0,40,0,2,36,196
061540611,188,23,4,0,1,1,4,221
061540612,245,25,1,6,0,0,3,280
061540701,22,0,0,0,0,7,22,51
061540702,22,21,0,0,0,2,11,56
061540703,15,1,0,0,0,4,9,29
061540801,90,19,2,2,0,0,3,116
061540802,46,0,1,0,0,1,16,64
061540803,19,2,0,0,0,0,12,33
061540804,16,1,0,0,0,1,2,20
061540805,21,4,0,1,0,2,0,28
061540806,35,1,0,0,0,1,19,56
061540901,27,0,0,0,0,4,4,35
061540902,11,3,0,1,0,5,0,20
061610101,175,20,1,2,0,0,0,198
061610102,203,13,6,1,1,5,9,238
061610103,195,23,5,1,0,4,7,235
061610104,112,12,1,4,0,3,2,134
061610105,172,20,2,6,2,5,2,209
061610106,262,14,5,1,2,3,6,293
061610107,162,17,2,1,3,3,7,195
061610108,173,5,8,0,2,5,8,201
061610109,271,23,17,5,3,2,17,338
061610110,176,9,0,4,2,5,0,196
061610111,223,14,0,5,1,0,2,245
061610112,162,13,4,8,0,9,13,209
061610113,282,11,10,7,7,6,19,342
061610114,211,12,4,11,1,5,8,252
061610115,146,5,0,0,0,1,0,152
061610116,198,11,9,3,0,3,16,240
061610117,343,12,7,12,3,4,10,391
061610118,99,11,0,6,0,7,20,143
061610201,11,0,0,0,0,0,2,13
061610202,11,0,0,0,0,1,3,15
061610203,7,2,0,0,0,0,7,16
061610204,10,6,0,0,0,0,4,20
061610301,29,6,0,0,0,4,2,41
061610302,8,0,0,0,0,3,9,20
061610401,26,3,0,0,0,3,2,34
061610402,25,3,0,1,0,7,15,51
061610403,175,14,1,18,0,16,5,229
061610404,84,1,1,1,0,6,6,99
061610405,46,8,0,2,1,7,7,71
061610406,127,16,5,6,1,9,12,176
061610501,14,5,0,0,0,12,2,33
061610502,7,0,0,0,0,1,3,11
061610503,7,7,0,0,0,0,0,14
061610504,33,6,0,0,0,0,2,41
061610601,111,4,0,3,0,2,4,124
061610602,10,0,0,0,0,3,8,21
061610603,6,5,0,0,0,0,1,12
061610604,12,1,0,1,0,6,5,25
061610605,23,4,0,0,1,4,1,33
061610606,28,4,0,0,0,1,4,37
061610701,26,0,0,0,0,24,7,57
061610702,20,0,0,2,1,2,0,25
061610703,11,1,0,0,1,3,16,32
061610801,40,16,0,0,0,0,6,62
061610802,10,2,0,0,0,1,8,21
061610803,2,0,0,0,0,0,5,7
061610804,14,6,0,0,0,0,0,20
061680101,12,0,0,0,0,0,3,15
061680102,10,0,0,0,0,3,2,15
061680103,12,0,0,0,0,0,8,20
061680104,10,0,1,0,0,0,6,17
061680201,11,0,0,0,0,0,0,11
061680202,8,0,0,0,0,0,0,8
061680203,13,2,0,0,0,0,5,20
061680204,4,0,0,0,0,1,2,7
061680301,16,12,0,0,0,0,2,30
061680302,3,0,0,0,0,0,9,12
061680303,16,0,0,0,0,4,7,27
061680401,6,0,0,0,0,1,5,12
061680402,10,0,0,0,0,0,2,12
061680403,8,0,0,0,0,2,1,11
061680404,3,1,0,0,0,2,1,7
061680405,1,0,1,0,0,0,9,11
061680406,2,0,0,0,0,4,1,7
061680501,45,13,0,0,0,10,5,73
061680502,7,7,0,0,0,0,0,14
061680503,8,3,0,0,0,1,2,14
061680601,3,1,0,0,0,0,7,11
061680602,5,0,0,0,0,7,12,24
061680603,13,0,0,0,0,8,0,21
061680604,7,0,0,0,0,2,4,13
061680701,10,9,0,0,0,2,6,27
061680702,7,1,0,0,0,3,4,15
061680801,17,2,0,0,0,4,6,29
061680802,11,3,0,0,0,0,2,16
061680803,21,5,0,2,0,3,3,34
061680804,6,0,0,0,0,0,7,13
061680805,34,8,0,0,0,5,3,50
061680806,9,0,0,0,0,0,2,11
061680807,184,14,2,3,0,3,4,210
061680901,246,20,0,1,1,0,4,272
061680902,278,23,4,6,2,2,9,324
061680903,214,25,1,4,2,3,13,262
061680904,343,47,3,12,2,2,10,419
061680905,311,20,1,8,3,1,23,367
061680906,221,27,1,6,0,0,7,262
061680907,180,16,0,7,0,0,1,204
061680908,178,26,2,5,0,1,3,215
061681001,95,3,0,1,1,1,22,123
061681002,9,0,0,0,0,0,1,10
061681003,22,6,0,0,0,4,13,45
061681101,23,4,0,0,0,4,2,33
061681102,14,3,0,0,0,0,1,18
061750101,76,9,3,0,1,2,3,94
061750102,30,3,0,0,0,6,8,47
061750103,12,1,0,1,0,1,3,18
061750104,7,5,0,0,0,0,1,13
061750201,69,17,1,4,2,0,11,104
061750202,5,0,0,0,0,9,0,14
061750203,5,0,0,0,0,2,8,15
061750204,2,0,0,0,0,2,6,10
061750301,6,0,0,0,0,0,5,11
061750302,5,0,0,0,0,4,0,9
061750303,5,0,0,0,0,2,2,9
061750304,1,0,0,0,0,0,3,4
061750401,29,9,0,2,0,3,5,48
061750402,324,13,0,7,1,0,7,352
061750403,258,11,1,6,1,0,6,283
061750404,168,16,6,3,3,1,8,205
061750405,272,16,9,2,8,1,19,327
061750406,243,21,8,3,18,1,24,318
061750407,250,20,7,2,12,1,23,315
061750408,345,19,2,8,9,4,10,397
061750409,320,23,8,15,0,3,15,384
061750410,314,18,7,6,6,4,9,364
061750411,194,7,3,2,1,0,7,214
061750412,242,9,5,6,0,2,3,267
061750413,191,25,3,2,4,1,4,230
061750414,264,13,4,8,0,1,4,294
061750415,162,18,6,20,0,10,3,219
061750416,142,3,1,4,0,1,4,155
061750417,95,11,0,0,0,5,14,125
061750501,21,7,0,0,0,5,12,45
061750502,28,21,0,0,0,0,6,55
061750503,5,1,0,0,0,0,6,12
061750504,5,14,0,0,0,0,9,28
061750505,35,14,0,0,0,10,29,88
061750601,270,14,0,6,0,0,11,301
061750602,218,11,3,0,2,0,3,237
061750603,226,10,2,4,0,0,5,247
061750604,269,12,5,4,0,0,5,295
061750605,344,17,10,1,0,0,11,383
061750606,179,10,2,4,0,2,5,202
061750607,196,9,1,2,0,2,1,211
061750608,289,8,5,8,0,0,10,320
061750609,271,10,1,1,3,2,4,292
061750610,296,8,0,4,0,0,7,315
061750611,272,16,4,2,2,0,4,300
061750612,280,22,3,0,1,1,12,319
061750613,589,30,0,3,2,4,11,639
061750614,81,12,2,1,0,1,6,103
061750615,16,1,0,0,0,0,0,17
061820101,248,0,5,1,0,3,16,273
061820102,366,1,9,6,2,1,91,476
061820103,369,1,9,1,1,0,18,399
061820104,217,19,11,0,0,0,2,249
061820105,353,6,9,4,2,0,11,385
061820106,254,18,4,0,3,0,10,289
061820107,297,23,11,9,2,4,8,354
061820108,202,7,2,1,0,0,6,218
061820109,380,15,1,0,0,0,10,406
061820110,307,3,0,0,0,0,11,321
061820111,314,7,3,0,0,0,8,332
061820112,319,2,12,2,3,0,10,348
061820113,246,2,17,0,1,1,3,270
061820114,326,12,0,1,0,0,9,348
061820201,215,2,0,2,1,0,12,232
061820202,324,29,6,2,7,0,19,387
061820203,277,18,4,4,0,0,16,319
061820204,264,8,4,2,4,1,46,329
061820205,223,8,13,3,10,0,27,284
061820206,260,22,10,2,2,1,14,311
061820207,263,40,24,2,8,0,12,349
061820208,276,42,2,4,2,0,21,347
061820209,252,48,17,1,9,0,36,363
061820210,254,6,36,3,3,0,25,327
061820211,214,0,0,0,0,1,8,223
061820212,222,9,3,2,2,0,26,264
061820213,242,8,8,0,2,0,32,292
061820301,32,2,0,0,0,0,13,47
061820302,6,0,0,0,0,0,13,19
061820303,43,4,7,0,1,2,3,60
061820304,42,0,0,0,0,0,36,78
061820305,68,1,0,0,1,0,111,181
061820306,1,1,0,0,0,0,0,2
061820307,0,0,0,0,0,0,1,1
061820308,14,0,0,0,0,1,11,26
061820309,192,7,2,0,0,0,7,208
061820310,18,1,6,0,0,0,1,26
061820311,149,5,42,0,1,0,48,245
061820312,24,1,0,0,0,0,26,51
061820401,21,0,0,0,0,4,18,43
061820501,134,23,2,23,0,27,11,220
061820502,124,10,3,2,0,0,3,142
061820503,140,9,1,1,0,0,7,158
061820504,259,21,2,4,0,6,9,301
061820505,102,20,0,1,1,16,33,173
061820601,19,16,0,0,0,2,15,52
061820602,56,8,1,1,1,1,14,82
061820603,14,3,0,2,0,16,2,37
061820604,292,19,1,8,0,1,5,326
061820605,432,18,13,5,0,2,6,476
061820606,371,18,2,7,0,0,9,407
061820607,402,26,3,4,0,0,15,450
061820608,304,17,5,6,2,1,12,347
061820609,265,16,2,3,1,0,3,290
061820701,14,10,0,0,0,3,10,37
061820702,193,16,1,16,3,0,3,232
061820703,355,18,9,15,1,0,8,406
061820704,238,11,4,4,1,0,5,263
061820705,265,10,4,4,0,0,7,290
061820706,116,9,0,5,0,0,1,131
061820707,0,0,0,0,0,0,1,1
061820708,265,21,8,8,0,0,4,306
061820709,272,21,5,7,0,0,10,315
061820710,351,18,3,7,1,0,36,416
061820801,23,17,0,1,0,0,10,51
061820901,88,10,13,14,3,291,13,432
061820902,38,110,26,4,1,109,9,297
061820903,13,2,0,1,0,1,0,17
061820904,70,4,31,8,0,220,4,337
061820905,37,40,7,3,2,223,5,317
061821001,193,16,6,2,1,0,8,226
061821002,143,19,8,1,2,0,11,184
061821003,331,26,18,13,7,1,21,417
061821004,301,31,6,6,2,2,20,368
061821005,254,34,5,4,6,0,15,318
061821006,243,30,9,0,4,0,14,300
061821007,245,23,12,7,6,0,10,303
061821008,329,29,11,6,3,1,31,410
061821009,371,11,6,6,4,1,16,415
061821010,309,27,11,9,2,2,16,376
061821011,286,22,7,4,3,1,18,341
061821101,214,14,11,3,1,0,5,248
061821102,318,31,11,7,4,0,10,381
061821103,326,27,6,1,2,1,19,382
061821104,229,23,1,6,5,1,9,274
061821105,194,15,8,4,0,2,12,235
061821106,243,15,2,6,2,1,11,280
061821107,195,9,2,3,1,0,13,223
061821108,265,8,6,11,1,0,11,302
061821109,296,13,6,2,1,0,15,333
061821110,74,1,1,1,0,0,1,78
061890101,9,0,0,0,0,2,5,16
061890102,9,0,0,0,0,8,0,17
061890103,3,0,0,0,0,1,5,9
061890104,7,0,0,0,0,11,0,18
061890201,1,8,0,0,0,0,0,9
061890202,2,13,0,0,0,0,0,15
061890203,3,0,0,0,0,0,15,18
061890204,1,0,0,0,0,0,12,13
061890205,1,3,0,0,0,0,1,5
061890206,6,7,0,0,0,0,2,15
061890207,9,1,0,0,0,0,8,18
061890301,24,2,1,0,0,1,3,31
061890302,5,4,0,0,0,0,7,16
061890303,7,10,0,0,0,0,1,18
061890304,2,2,0,0,0,1,5,10
061890305,5,4,0,0,0,2,11,22
061890401,2,2,0,0,0,0,9,13
061890402,5,6,0,0,0,0,2,13
061890403,8,0,0,0,0,0,7,15
061890501,2,0,0,0,0,1,6,9
061890502,4,3,0,0,0,1,6,14
061890503,6,4,0,0,0,0,6,16
061890504,5,9,0,0,0,0,2,16
061890505,4,2,0,0,0,0,11,17
061890601,17,6,0,0,0,0,4,27
061890602,10,1,0,0,0,0,5,16
061890603,5,0,0,0,0,1,2,8
061890604,7,0,0,0,0,0,1,8
061890605,1,0,0,0,0,0,7,8
061890606,1,0,0,0,0,0,5,6
061890607,4,5,0,0,0,0,0,9
061890608,6,1,0,0,0,0,0,7
061890701,6,3,0,0,0,0,8,17
061890702,3,0,0,0,0,0,11,14
061890703,11,0,0,0,0,4,4,19
061890704,2,1,0,0,0,0,0,3
061890705,6,8,0,0,0,0,0,14
061890706,2,0,0,0,0,6,5,13
061890707,9,2,0,0,0,2,3,16
061890801,2,0,0,0,0,0,13,15
061890802,9,0,0,0,0,0,10,19
061890803,4,2,0,0,0,0,2,8
061890804,3,1,0,0,0,0,9,13
061890901,7,6,0,0,0,0,0,13
061890902,10,3,0,0,0,2,5,20
061891001,204,24,0,2,3,2,18,253
061891002,236,13,0,5,0,0,11,265
061891003,246,18,3,3,0,0,1,271
061891004,273,18,2,3,0,2,11,309
061891005,255,22,2,5,4,0,9,297
061891006,299,47,10,5,12,0,12,385
061891007,339,34,5,5,2,1,15,401
061891008,216,14,0,5,0,0,4,239
061891009,176,15,0,0,1,0,7,199
061891010,16,1,2,2,0,2,7,30
061891101,4,2,0,0,0,0,8,14
061891102,10,3,0,0,0,2,15,30
061891103,5,4,0,0,0,0,2,11
061891104,4,0,0,0,0,1,3,8
061891105,10,0,0,0,0,0,2,12
061891106,5,0,0,0,0,3,3,11
061891107,3,3,0,0,0,1,1,8
061891201,151,19,9,3,0,1,8,191
061891202,7,5,0,0,0,0,0,12
061891203,6,2,0,0,0,1,5,14
061891204,3,0,0,0,0,0,5,8
061891205,6,7,0,0,0,0,2,15
061891206,7,0,0,0,0,0,18,25
061891207,2,1,0,0,0,0,6,9
061891208,5,0,0,0,0,1,8,14
061891209,3,0,0,0,0,0,4,7
061891210,8,5,0,0,0,0,0,13
061891211,136,19,1,0,4,7,23,190
061891301,34,11,0,0,0,0,17,62
061891302,7,8,0,0,0,0,0,15
061891303,12,2,0,0,0,0,13,27
061891304,6,9,0,0,0,0,0,15
061891305,2,1,0,0,0,0,4,7
061891306,4,4,0,0,0,0,4,12
061891307,11,2,0,0,0,2,1,16
061891308,5,1,0,0,0,1,7,14
061891309,1,9,0,0,0,0,1,11
061891401,5,4,1,0,0,2,6,18
061891402,2,11,0,0,0,0,1,14
061891403,7,1,0,0,0,1,5,14
061891404,2,3,0,0,0,0,4,9
061891405,4,8,0,0,0,0,0,12
061891406,5,2,0,0,0,0,3,10
061891501,155,17,4,0,0,1,10,187
061891502,359,60,8,1,0,1,34,463
061891503,62,12,4,13,0,200,11,302
061891504,24,15,0,0,0,0,14,53
061891505,18,0,1,0,0,4,12,35
061891506,2,5,0,0,0,4,3,14
061891507,5,10,0,0,0,16,4,35
061891508,9,0,0,0,0,0,4,13
061891509,176,18,8,0,0,1,24,227
061891601,11,0,0,0,0,6,5,22
061891602,1,0,0,0,0,3,11,15
061891603,10,5,0,0,0,4,2,21
061891604,3,0,0,1,0,3,0,7
061891605,4,0,0,2,0,0,16,22
061891701,23,0,0,0,0,2,4,29
061891702,170,16,1,7,0,2,5,201
061891703,309,26,5,3,2,1,14,360
061891704,217,20,3,3,3,1,16,263
061891705,208,24,4,3,0,1,19,259
061891706,224,45,10,1,5,0,15,300
061891707,326,46,1,8,3,0,14,398
061891708,262,40,3,2,0,0,7,314
061891709,11,0,0,0,0,4,3,18
061960101,280,20,1,18,0,3,6,328
061960102,299,18,2,6,0,0,3,328
061960103,259,28,1,7,0,0,3,298
061960104,253,16,4,4,0,0,8,285
061960105,97,11,0,0,0,0,5,113
061960106,100,6,0,1,0,0,2,109
061960107,105,10,3,1,0,0,2,121
061960108,302,13,2,1,0,2,5,325
061960109,117,5,3,0,0,0,30,155
061960110,119,11,0,21,0,2,8,161
061960111,116,7,2,102,0,1,1,229
061960112,336,26,1,4,1,2,3,373
061960113,226,17,4,3,1,0,4,255
061960114,200,20,3,2,6,0,7,238
061960115,195,26,9,0,9,0,6,245
061960116,326,40,0,3,3,1,8,381
061960117,178,19,6,5,0,0,9,217
061960118,155,24,3,0,0,0,2,184
061960119,156,10,3,4,0,1,1,175
061960201,76,9,0,1,0,2,8,96
061960202,94,5,1,4,0,0,3,107
061960203,104,6,2,2,0,0,2,116
061960204,235,15,3,7,0,0,9,269
061960205,322,46,11,3,1,2,23,408
061960206,313,39,14,4,2,0,16,388
061960207,237,37,11,1,4,2,16,308
061960208,256,33,5,2,11,1,14,322
061960209,318,42,13,3,3,2,16,397
061960210,311,43,9,4,0,2,8,377
061960211,152,8,0,3,0,0,5,168
061960212,131,10,2,6,0,2,6,157
061960213,199,16,4,6,0,0,4,229
061960214,200,28,5,8,0,0,5,246
061960301,9,3,0,0,0,3,9,24
061960302,10,1,0,0,0,2,4,17
061960303,8,0,0,0,0,3,5,16
061960304,4,0,0,0,0,0,11,15
061960305,7,0,0,0,0,2,3,12
061960306,8,3,0,0,0,0,1,12
061960401,19,0,0,0,0,2,9,30
061960402,10,4,0,0,0,1,6,21
061960403,6,4,0,0,0,0,0,10
061960404,7,1,0,0,0,1,4,13
061960501,6,0,0,0,0,3,6,15
061960502,2,8,0,0,0,0,6,16
061960503,12,0,0,0,0,0,17,29
061960504,4,0,0,0,0,0,11,15
061960601,7,2,0,0,0,0,6,15
061960602,3,3,0,0,0,0,6,12
061960603,7,6,0,0,0,0,3,16
061960604,4,0,0,0,0,1,6,11
061960701,134,9,5,3,1,0,4,156
061960702,5,1,0,0,0,0,4,10
061960703,3,3,0,0,0,0,8,14
061960704,6,5,0,0,0,0,1,12
061960705,12,1,0,0,0,0,6,19
061960706,3,0,0,0,0,0,1,4
061960707,20,0,0,0,1,0,14,35
061960708,33,17,0,0,1,1,12,64
061960709,19,0,0,0,0,1,11,31
061960801,9,2,0,0,0,0,2,13
061960802,13,6,0,0,0,0,6,25
061960803,11,2,0,0,0,4,6,23
061960804,13,0,0,0,0,4,7,24
061960805,1,2,0,0,0,0,0,3
061960806,10,4,0,0,0,3,7,24
061960901,1,1,0,1,0,0,0,3
061960902,5,7,13,1,0,0,0,26
061960903,12,0,0,0,0,1,5,18
061960904,14,1,1,0,0,0,1,17
061960905,10,5,0,0,0,0,9,24
061961001,9,2,0,0,0,1,2,14
061961002,9,1,0,0,0,4,1,15
061961003,3,6,0,0,0,0,0,9
061961004,5,0,0,0,0,0,0,5
061961005,13,0,0,0,0,6,7,26
061961101,8,2,0,0,0,0,4,14
061961102,14,4,0,0,3,0,6,27
061961103,12,4,0,0,0,3,7,26
061961104,6,11,0,0,0,0,0,17
061961105,16,6,0,0,0,0,0,22
061961106,8,1,0,0,0,5,2,16
061961107,6,4,0,0,0,0,13,23
061961108,7,8,0,0,0,0,0,15
061961201,4,7,0,0,0,0,1,12
061961202,15,3,1,0,0,4,7,30
061961203,6,3,0,0,0,0,10,19
061961204,2,0,0,0,0,0,7,9
061961205,11,4,0,0,0,1,1,17
061961206,8,8,0,0,0,0,5,21
061961301,3,4,0,0,0,0,2,9
061961302,5,1,0,0,0,1,11,18
061961303,10,3,0,0,2,4,11,30
061961304,12,5,0,0,0,0,13,30
061961305,11,5,0,0,0,4,1,21
061961401,5,2,0,0,0,0,0,7
061961402,13,5,0,0,0,0,10,28
061961403,8,1,0,0,0,0,7,16
061961501,70,10,2,0,0,0,9,91
061961502,9,8,0,0,0,0,1,18
061961503,6,7,0,0,0,0,0,13
061961504,6,11,0,0,0,2,5,24
061961505,2,0,0,0,0,0,4,6
061961506,91,17,2,2,0,2,6,120
061961507,147,25,1,2,0,2,6,183
061961508,94,25,0,0,0,0,4,123
062030101,333,27,7,1,2,2,15,387
062030102,252,39,2,0,16,3,8,320
062030103,290,39,0,9,20,5,27,390
062030104,275,26,8,0,7,0,9,325
062030105,265,20,1,3,3,0,5,297
062030106,275,29,2,2,4,0,9,321
062030107,214,32,6,4,16,2,14,288
062030108,283,19,1,7,0,1,4,315
062030109,216,15,4,1,4,5,11,256
062030110,309,18,2,0,0,2,6,337
062030111,283,24,4,2,0,0,5,318
062030112,302,19,4,6,2,2,7,342
062030113,249,13,2,5,2,1,6,278
062030201,177,16,0,2,0,0,7,202
062030202,226,19,11,3,2,1,12,274
062030203,198,7,3,3,3,1,19,234
062030204,178,29,1,1,0,1,7,217
062030205,18,1,0,0,0,0,10,29
062030206,11,3,0,1,0,5,8,28
062030207,36,12,0,1,0,5,23,77
062030208,10,0,0,0,0,1,32,43
062030209,8,1,0,0,0,8,17,34
062030210,244,18,3,4,1,1,13,284
062030211,145,13,2,1,0,1,6,168
062030212,316,21,2,63,0,0,13,415
062030213,124,14,0,3,0,1,2,144
062030214,26,9,0,1,0,0,4,40
062030215,195,15,3,6,0,1,11,231
062030301,14,1,0,0,0,6,6,27
062030302,13,3,0,0,0,0,6,22
062030303,8,12,0,0,0,0,2,22
062030304,14,14,0,0,0,0,0,28
062030305,9,10,0,0,0,0,7,26
062030306,9,2,0,0,0,0,6,17
062030401,58,15,1,0,0,3,16,93
062030402,5,2,0,0,0,0,14,21
062030403,10,7,0,0,0,1,11,29
062030404,5,3,0,0,0,0,10,18
062030405,6,3,0,0,0,0,4,13
062030406,6,5,0,0,0,0,2,13
062030407,5,10,0,0,0,0,0,15
062030408,11,7,0,0,0,0,0,18
062030501,37,13,0,2,0,4,10,66
062030502,3,12,0,0,0,1,1,17
062030503,10,4,0,0,0,0,2,16
062030504,14,0,0,0,0,0,12,26
062030505,7,11,0,0,0,0,5,23
062030506,7,2,0,0,0,0,6,15
062030507,3,0,0,0,0,0,6,9
062030601,9,9,0,0,0,0,1,19
062030602,8,3,0,0,0,0,3,14
062030603,5,2,0,0,0,1,5,13
062030604,12,4,0,0,0,0,0,16
062030605,5,6,0,0,0,0,0,11
062030701,2,2,0,0,0,0,9,13
062030702,5,0,0,0,0,0,9,14
062030703,5,1,0,0,0,0,0,6
062030704,5,0,0,0,0,3,7,15
062030705,4,0,0,0,0,0,5,9
062030706,3,4,0,0,0,0,0,7
062030707,4,4,0,0,0,0,12,20
062030708,2,0,0,0,0,0,5,7
062030709,2,7,0,0,0,0,0,9
062030710,9,5,0,0,0,0,0,14
062030711,5,6,0,0,0,1,3,15
062030801,12,3,0,0,0,0,15,30
062030802,28,1,3,1,0,2,10,45
062030803,232,14,2,1,0,2,4,255
062030804,324,28,8,4,2,0,2,368
062030805,411,36,6,4,0,4,13,474
062030806,384,25,6,10,5,4,6,440
062030807,342,35,4,6,0,4,12,403
062030808,478,41,4,10,1,7,12,553
062030809,327,15,8,7,0,6,4,367
062030810,303,21,14,24,0,4,14,380
062030811,93,12,1,65,0,8,11,190
062030812,159,8,3,4,0,17,14,205
062030901,9,5,0,0,0,0,8,22
062030902,14,13,0,0,0,0,1,28
062030903,2,8,0,0,0,0,1,11
062030904,4,0,0,0,0,0,6,10
062030905,3,7,0,0,0,0,0,10
062030906,1,2,0,0,0,0,5,8
062030907,5,1,0,0,0,0,0,6
062031001,1,8,0,0,0,0,0,9
062031002,10,16,0,0,0,0,5,31
062031003,12,1,0,0,0,2,8,23
062031004,6,1,0,0,0,4,7,18
062031005,6,0,0,0,1,4,9,20
062031101,12,2,0,0,0,0,0,14
062031102,12,6,0,0,0,1,1,20
062031103,0,0,0,0,0,4,8,12
062031104,4,7,0,0,0,0,0,11
062031105,3,0,0,0,0,5,3,11
062031106,2,0,0,0,0,0,0,2
062031201,7,18,0,0,0,1,1,27
062031202,6,0,0,0,0,6,3,15
062031203,12,7,0,0,0,0,5,24
062031204,12,2,0,0,0,0,0,14
062031205,12,0,0,0,0,7,2,21
062031301,7,1,3,0,0,1,8,20
062031302,5,5,0,0,0,0,1,11
062031303,7,3,0,0,0,0,1,11
062031304,12,8,0,0,0,0,5,25
062031305,13,0,0,0,0,3,13,29
062031306,9,3,0,0,0,0,6,18
062031307,11,1,0,2,0,7,2,23
062031308,9,4,0,0,0,0,1,14
062031401,144,17,8,20,0,120,7,316
062031402,10,7,0,0,0,5,0,22
062031403,7,3,0,0,0,1,0,11
062031404,5,0,0,0,0,2,5,12
062031405,22,4,0,0,0,4,1,31
062031406,3,11,0,0,0,0,0,14
062031407,3,1,0,0,0,0,0,4
062031408,0,0,0,55,0,0,0,55
062031501,4,1,0,0,0,0,2,7
062031502,14,20,0,0,0,0,0,34
062031503,4,1,0,0,0,2,0,7
062031504,8,11,0,0,0,0,0,19
062031601,418,49,0,319,0,2,22,810
062031602,276,22,2,3,0,1,6,310
062031603,242,16,4,76,0,1,11,350
062031604,415,31,5,4,0,2,2,459
062031605,266,27,4,7,0,1,3,308
062031606,149,20,0,2,0,0,0,171
062031607,318,30,5,16,0,7,6,382
062031608,299,25,4,5,0,1,14,348
062031609,393,38,3,13,1,2,15,465
062031610,314,22,4,7,4,3,17,371
062031611,104,10,0,0,0,3,12,129
062031612,271,30,1,19,1,0,14,336
062031613,297,24,3,7,1,9,8,349
062100101,182,4,5,2,0,2,14,209
062100102,180,12,6,2,0,1,10,211
062100103,159,13,4,4,1,0,7,188
062100104,167,12,5,12,2,0,6,204
062100105,173,7,2,0,1,0,10,193
062100106,261,18,8,6,3,3,9,308
062100107,259,11,2,10,2,3,8,295
062100108,216,7,7,2,0,1,11,244
062100109,173,8,10,3,9,1,15,219
062100110,166,15,11,5,19,0,8,224
062100111,266,33,13,4,17,6,13,352
062100112,156,7,9,5,1,1,8,187
062100113,202,14,9,5,1,2,9,242
062100114,149,6,7,9,0,0,10,181
062100115,275,16,1,2,2,0,9,305
062100116,286,16,11,2,10,3,34,362
062100117,295,24,10,6,1,2,12,350
062100118,266,25,4,6,1,0,9,311
062100119,276,14,3,14,0,2,8,317
062100120,297,13,3,6,0,2,8,329
062100121,262,11,4,4,0,1,11,293
062100201,265,28,1,5,0,34,23,356
062100202,383,17,9,10,0,6,11,436
062100203,376,16,12,1,1,3,8,417
062100204,341,24,7,9,1,1,11,394
062100205,206,25,6,3,4,1,9,254
062100206,185,23,3,1,0,1,2,215
062100207,414,17,10,3,3,6,18,471
062100208,278,31,6,7,2,7,14,345
062100209,261,30,5,5,3,4,22,330
062100210,397,23,3,3,0,1,26,453
062100301,70,15,0,0,0,8,64,157
062100401,52,20,0,0,0,14,8,94
062100501,112,19,2,0,0,4,28,165
062100601,24,17,0,0,0,0,7,48
062100602,20,0,0,0,0,3,11,34
062100603,160,17,1,3,0,5,10,196
062100604,51,2,0,1,0,1,8,63
062100605,116,13,0,3,0,3,6,141
062100606,194,17,9,3,3,12,25,263
062100607,121,11,3,0,0,6,6,147
062100608,92,15,0,3,1,4,7,122
062100609,14,9,0,0,0,0,0,23
062100610,21,1,0,0,0,7,10,39
062100611,64,7,3,0,0,7,17,98
062100612,134,24,0,9,0,8,27,202
062100613,68,10,0,3,0,2,8,91
062100701,62,10,0,0,0,10,24,106
062100801,113,1,1,3,4,9,20,151
062100802,255,8,4,3,1,3,17,291
062100803,310,21,6,18,0,23,16,394
062100804,294,10,3,4,6,3,3,323
062100805,516,24,3,21,2,35,32,633
062100806,200,9,0,0,0,14,21,244
062100807,70,6,0,5,1,2,14,98
062100808,576,74,7,41,3,4,25,730
062100809,277,8,6,3,0,2,10,306
062100810,345,23,1,5,1,10,10,395
062100811,84,5,0,1,0,7,25,122
062100901,217,13,3,5,0,4,16,258
062100902,235,13,4,2,3,6,19,282
062100903,63,27,0,0,0,9,21,120
062101001,47,0,0,0,0,4,35,86
062101101,17,0,0,0,0,3,22,42
062101201,78,20,0,0,0,3,35,136
062101301,343,31,12,2,3,4,7,402
062101302,308,17,4,1,2,0,8,340
062101303,179,7,2,1,1,0,4,194
062101304,334,22,9,2,2,0,11,380
062101305,233,15,3,5,0,3,2,261
062101306,383,26,2,1,0,1,12,425
062101307,270,16,7,6,0,0,6,305
062101308,404,31,13,5,1,1,13,468
062101309,326,9,7,8,1,3,5,359
062170101,278,39,3,2,1,2,18,343
062170102,299,30,19,3,1,2,17,371
062170103,249,17,4,6,5,0,33,314
062170104,317,18,6,8,2,3,20,374
062170105,290,26,3,5,2,0,13,339
062170106,171,23,10,7,25,6,10,252
062170107,277,28,10,5,21,6,28,375
062170108,211,20,6,0,11,5,29,282
062170109,254,31,7,10,15,3,10,330
062170110,227,32,7,10,5,4,14,299
062170111,199,36,4,3,24,3,8,277
062170112,260,24,12,12,4,6,10,328
062170113,389,48,8,6,1,8,15,475
062170114,146,17,7,6,10,2,19,207
062170201,29,11,0,0,0,20,15,75
062170202,18,4,4,0,0,6,0,32
062170203,9,1,0,0,0,1,15,26
062170204,23,0,2,0,0,6,10,41
062170205,21,17,0,2,0,5,9,54
062170206,15,0,0,0,0,0,0,15
062170207,15,3,0,0,0,11,1,30
062170301,48,9,0,0,0,5,6,68
062170302,49,11,0,2,0,2,1,65
062170303,79,13,1,2,0,0,1,96
062170304,37,14,0,1,0,23,9,84
062170401,143,15,0,0,0,25,10,193
062170402,189,5,0,5,1,0,11,211
062170403,123,29,6,12,0,4,2,176
062170404,160,9,0,5,0,3,17,194
062170405,99,21,4,6,0,16,6,152
062170406,80,3,0,13,0,64,7,167
062170407,88,16,3,5,0,52,6,170
062170408,92,15,2,10,0,78,2,199
062170409,173,29,0,13,2,40,5,262
062170410,218,21,4,2,0,0,4,249
062170411,212,13,3,10,0,2,9,249
062170412,191,16,1,11,1,0,10,230
062170413,405,28,6,6,1,2,10,458
062170414,404,17,6,7,0,3,4,441
062170415,232,19,0,4,2,2,7,266
062170416,245,19,4,7,1,1,9,286
062170501,11,0,0,8,1,14,1,35
062170502,3,0,1,3,0,20,0,27
062170503,6,3,0,4,0,14,1,28
062170504,5,2,0,7,0,1,6,21
062170505,55,5,2,5,0,93,13,173
062170506,14,15,0,0,0,0,1,30
062170507,20,6,0,0,0,2,4,32
062170508,19,14,0,0,0,0,4,37
062170509,4,0,0,0,0,15,0,19
062170510,7,0,0,0,0,19,0,26
062170511,12,0,0,0,0,2,0,14
062170512,6,4,0,0,0,0,0,10
062170601,9,1,0,2,1,27,9,49
062170602,3,2,0,0,0,1,11,17
062170603,9,10,3,0,0,6,0,28
062170604,21,12,0,0,0,5,12,50
062170605,17,3,0,0,0,61,0,81
062170701,7,3,0,0,0,1,2,13
062170702,11,0,0,1,0,10,0,22
062170801,27,6,0,1,0,19,1,54
062170802,21,4,0,0,0,3,10,38
062170803,22,9,0,0,0,4,4,39
062170901,18,3,0,0,0,0,14,35
062170902,29,0,0,0,0,3,1,33
062170903,24,7,0,0,0,5,4,40
062170904,22,4,0,0,0,1,0,27
062170905,11,1,0,0,0,0,6,18
062170906,20,2,0,0,0,0,0,22
062170907,18,8,0,0,0,3,0,29
062171001,258,20,4,7,0,1,9,299
062171002,417,17,5,8,1,1,9,458
062171003,370,15,8,5,8,5,18,429
062171004,293,23,1,9,4,4,19,353
062171005,18,0,0,0,0,8,6,32
062171006,22,1,6,1,0,3,0,33
062171007,17,7,0,0,0,0,2,26
062171008,21,1,0,1,0,15,9,47
062171009,22,13,1,0,0,14,3,53
062171010,69,22,1,9,0,1,8,110
062171011,74,15,0,0,0,13,12,114
062171012,11,6,0,0,0,9,12,38
062171013,220,18,5,15,3,2,4,267
062171101,57,11,0,0,0,8,16,92
062171102,17,4,0,0,0,4,7,32
062171103,19,0,0,0,0,5,15,39
062171104,9,9,0,0,0,1,1,20
062171105,35,0,0,0,0,8,24,67
062171106,13,8,0,0,0,0,6,27
062171201,158,38,12,14,2,108,18,350
062171202,569,21,0,0,0,1,5,596
062171203,298,9,11,8,0,4,5,335
062171204,203,9,2,1,0,0,2,217
062171205,310,20,4,11,0,3,7,355
062171206,247,22,7,8,1,4,5,294
062171207,232,19,4,1,1,1,9,267
062171208,248,16,2,6,2,2,7,283
062171209,218,13,9,3,0,0,5,248
062171210,424,25,7,30,3,8,8,505
062171211,190,17,3,7,4,6,4,231
062171212,292,32,7,8,0,15,3,357
062171213,268,23,12,26,2,13,4,348
062171214,176,33,6,11,0,19,6,251
062171215,215,41,12,8,1,34,7,318
062240101,162,21,0,11,0,4,2,200
062240102,295,21,15,7,4,0,11,353
062240103,403,27,5,10,7,2,27,481
062240104,233,30,2,3,0,2,4,274
062240105,310,24,9,4,1,8,12,368
062240106,277,28,12,33,3,1,6,360
062240107,314,21,16,3,1,1,12,368
062240108,214,24,5,1,12,3,16,275
062240109,317,28,12,4,13,3,20,397
062240110,282,42,26,5,29,1,11,396
062240111,351,34,6,5,4,5,12,417
062240112,335,58,8,6,12,1,22,442
062240113,271,16,0,1,1,0,6,295
062240114,310,23,7,20,2,0,5,367
062240115,166,15,2,6,0,3,9,201
062240116,170,10,2,9,1,5,8,205
062240117,230,21,6,10,1,2,14,284
062240201,219,16,3,4,0,14,7,263
062240202,240,10,1,5,4,0,11,271
062240203,148,7,2,1,0,0,2,160
062240204,388,33,1,13,0,2,11,448
062240205,257,10,7,15,2,4,6,301
062240206,266,25,5,10,6,1,7,320
062240207,297,33,10,5,3,0,19,367
062240208,356,21,15,11,4,1,26,434
062240209,257,8,1,5,1,2,3,277
062240210,306,60,14,4,15,4,18,421
062240211,258,33,16,4,9,5,16,341
062240212,103,15,0,6,0,0,3,127
062240213,92,5,1,2,0,4,6,110
062240214,234,13,5,9,1,0,1,263
062240301,267,7,8,13,0,5,10,310
062240302,288,16,2,21,0,1,9,337
062240303,300,11,7,4,2,0,21,345
062240304,283,40,16,2,11,5,21,378
062240305,209,15,8,6,2,2,5,247
062240306,236,13,4,4,0,0,9,266
062240307,272,10,1,6,0,0,12,301
062240308,193,23,5,27,0,0,13,261
062240309,158,11,0,15,1,4,2,191
062240310,253,11,2,5,0,0,9,280
062240401,212,14,0,8,0,0,2,236
062240402,406,16,14,14,1,4,18,473
062240403,373,28,12,3,0,5,17,438
062240404,281,14,14,4,6,1,24,344
062240405,357,19,10,5,4,1,25,421
062240406,278,20,15,1,11,1,18,344
062240407,308,13,10,3,19,1,16,370
062240408,266,33,18,2,19,3,30,371
062240409,367,23,12,12,4,1,17,436
062240410,228,16,1,8,0,1,10,264
062240411,315,19,8,13,0,0,12,367
062240412,141,7,6,38,0,2,3,197
062240413,332,33,2,3,2,2,14,388
062240414,148,16,1,5,0,0,8,178
062240415,128,6,2,9,0,0,1,146
062240416,165,7,3,19,0,1,6,201
062240417,240,5,0,5,0,0,3,253
062240501,12,0,1,0,0,3,3,19
062240502,8,0,0,0,0,1,6,15
062240503,25,6,0,0,0,0,23,54
062240504,4,0,0,1,0,0,9,14
062240505,16,4,0,0,0,0,3,23
062240601,19,6,0,0,0,5,3,33
062240602,29,1,0,0,0,2,1,33
062240603,35,20,2,0,1,15,5,78
062240604,35,2,0,0,1,6,5,49
062240701,2,1,0,0,0,1,8,12
062240702,14,5,0,0,0,3,1,23
062240703,14,1,0,0,0,9,4,28
062240801,9,3,0,0,0,6,8,26
062240802,12,0,0,1,0,7,12,32
062240901,139,15,0,14,0,44,5,217
062240902,283,21,1,6,0,1,18,330
062240903,83,6,1,6,0,105,5,206
062240904,57,15,0,0,0,9,4,85
062240905,10,1,0,0,0,1,3,15
062240906,69,11,0,1,0,15,4,100
062240907,29,12,0,0,0,5,10,56
062240908,270,19,1,4,0,7,16,317
062240909,80,12,0,0,0,5,11,108
062240910,52,1,0,0,0,7,1,61
062240911,163,7,2,7,0,1,12,192
062240912,140,9,7,25,0,51,17,249
062240913,67,2,0,6,0,90,12,177
062240914,67,10,1,3,0,50,8,139
062240915,173,6,4,17,0,6,5,211
062241001,9,3,0,0,0,2,8,22
062241002,21,8,0,1,1,8,33,72
062241101,33,8,0,0,0,3,11,55
062241102,46,13,2,6,0,5,12,84
062241103,68,6,3,1,1,7,5,91
062241201,45,15,0,3,0,16,13,92
062241202,10,13,0,0,0,0,4,27
062241203,22,10,0,1,0,2,13,48
062241204,99,5,5,9,1,66,28,213
062241301,69,3,3,3,0,27,7,112
062241302,14,3,0,0,0,5,22,44
062241303,13,0,0,1,0,3,9,26
062241401,12,0,0,0,0,1,9,22
062241402,24,2,0,0,0,4,11,41
062241403,51,5,2,1,0,15,12,86
062241501,8,1,0,0,0,1,5,15
062241502,18,14,0,0,0,0,0,32
062241503,10,14,0,0,0,3,0,27
062241601,9,2,0,0,0,12,10,33
062241602,5,0,0,0,0,2,10,17
062241701,72,19,7,1,4,29,15,147
062241702,13,12,0,0,0,7,2,34
062241703,21,1,0,0,0,3,10,35
062241801,10,1,0,0,0,2,6,19
062241802,16,0,0,0,0,2,1,19
062241901,48,16,2,1,2,1,23,93
062241902,8,2,0,0,0,1,4,15
062241903,14,12,0,0,0,4,14,44
062241904,18,1,0,0,0,0,17,36
062242001,117,14,4,24,9,7,3,178
062242002,127,12,3,3,2,3,3,153
062242003,291,28,1,4,0,7,13,344
062242004,5,0,0,0,0,0,0,5
062242005,17,16,0,0,0,2,2,37
062242006,6,0,0,0,0,8,10,24
062242007,11,0,0,0,0,3,13,27
062242008,11,7,0,0,0,3,1,22
062242009,79,13,6,0,1,1,1,101
062242010,134,8,4,3,5,2,7,163
062242101,9,0,0,0,0,4,18,31
062242102,4,0,0,0,0,1,9,14
062242103,7,0,0,0,0,2,10,19
062242201,221,37,7,1,7,1,31,305
062242202,248,36,4,4,13,3,12,320
062242203,327,17,11,6,6,7,33,407
062242204,307,25,22,7,9,3,30,403
062242205,291,21,11,2,4,0,16,345
062242206,345,29,17,5,3,1,16,416
062242207,235,12,4,12,0,1,10,274
062242208,270,33,13,5,0,0,15,336
062242209,208,13,3,10,0,1,3,238
062242210,218,20,4,12,0,2,5,261
062310101,227,28,5,6,0,0,4,270
062310102,166,22,1,1,1,0,2,193
062310103,16,2,0,0,0,0,12,30
062310104,79,10,0,0,0,3,7,99
062310105,22,1,0,1,0,1,11,36
062310106,29,10,0,1,0,0,34,74
062310107,189,19,5,4,1,9,6,233
062310201,22,0,0,0,0,5,13,40
062310202,21,8,0,0,0,0,0,29
062310203,13,5,0,0,0,5,1,24
062310204,8,4,0,0,0,0,16,28
062310301,11,3,0,0,0,0,0,14
062310302,25,5,1,0,0,0,2,33
062310303,21,4,0,0,0,0,0,25
062310304,8,4,0,0,0,0,2,14
062310401,2,9,0,0,0,0,0,11
062310402,7,3,0,1,0,1,1,13
062310403,9,3,0,0,0,4,1,17
062310404,12,2,0,0,0,5,8,27
062310405,7,5,0,0,0,4,0,16
062310501,12,4,0,0,0,1,3,20
062310502,10,10,0,0,0,0,6,26
062310601,3,0,0,0,0,0,12,15
062310602,7,0,0,0,0,2,2,11
062310603,33,6,1,2,0,0,0,42
062310604,5,0,0,0,0,1,6,12
062310605,6,0,0,0,0,0,4,10
062310606,23,1,0,0,0,1,20,45
062310701,14,4,0,0,0,1,1,20
062310702,10,7,0,0,0,0,0,17
062310703,10,0,0,0,0,0,0,10
062310704,16,3,0,0,0,0,4,23
062310705,1,3,0,0,0,0,11,15
062310706,5,2,0,0,0,0,8,15
062310707,4,1,0,0,0,0,21,26
062310801,14,19,0,0,0,1,10,44
062310802,2,2,0,0,0,0,11,15
062310803,225,28,1,2,0,0,5,261
062310804,2,8,0,0,0,0,1,11
062310805,6,2,0,0,0,4,9,21
062310901,16,8,0,0,0,7,10,41
062310902,37,10,0,0,0,2,13,62
062310903,14,2,0,0,0,5,3,24
062311001,358,29,1,3,0,5,21,417
062311002,3,10,0,0,0,0,1,14
062311003,11,0,0,0,0,0,0,11
062311004,1,0,0,0,0,0,8,9
062311005,56,3,0,1,0,3,9,72
062311101,2,4,0,0,0,0,0,6
062311201,233,41,0,14,0,3,13,304
062311202,279,23,3,3,0,0,6,314
062311203,221,15,4,4,1,0,3,248
062311204,318,33,5,3,2,0,8,369
062311205,289,36,8,1,11,0,9,354
062311206,180,17,1,0,5,1,8,212
062311207,326,19,5,7,2,1,2,362
062311208,386,16,6,9,0,2,16,435
062311209,239,16,10,2,1,2,3,273
062311210,287,28,5,5,3,0,7,335
062311211,346,19,4,7,0,3,14,393
062311212,173,11,1,4,0,1,6,196
062311213,171,7,0,2,0,1,3,184
062311214,36,4,2,1,0,3,5,51
062380101,192,5,0,1,0,1,10,209
062380102,188,6,5,0,1,2,17,219
062380103,351,20,5,7,1,1,36,421
062380104,351,23,3,5,1,0,19,402
062380105,350,31,2,7,3,0,13,406
062380106,243,30,15,4,14,0,11,317
062380107,413,33,6,10,2,1,16,481
062380108,231,28,6,5,5,0,13,288
062380109,262,38,8,4,5,0,20,337
062380110,330,39,0,4,1,0,10,384
062380111,213,18,0,1,0,2,10,244
062380112,248,14,5,1,0,1,2,271
062380113,160,13,2,3,0,0,6,184
062380114,152,12,7,2,1,3,4,181
062380201,240,11,4,7,0,0,12,274
062380202,386,29,6,10,1,0,18,450
062380203,323,23,3,1,3,1,25,379
062380204,194,19,6,0,4,0,15,238
062380205,238,29,8,2,17,0,15,309
062380206,271,43,8,5,2,1,6,336
062380207,373,34,3,5,4,2,22,443
062380208,316,26,5,4,0,0,12,363
062380209,300,20,2,2,0,1,11,336
062380210,227,29,0,7,0,0,0,263
062380211,86,5,0,0,0,0,1,92
062380212,327,29,5,16,1,2,7,387
062380213,146,21,1,8,0,0,5,181
062380214,172,10,2,4,0,2,3,193
062380215,20,0,0,1,0,1,3,25
062380301,98,11,1,0,0,1,2,113
062380302,25,14,0,2,0,4,3,48
062380401,29,13,0,0,0,13,3,58
062380501,51,6,0,1,0,19,6,83
062380601,125,8,0,9,1,0,3,146
062380602,88,15,0,1,0,1,3,108
062380603,204,22,1,3,1,2,5,238
062380604,258,16,7,1,0,0,18,300
062380605,9,4,0,0,0,0,0,13
062380606,18,0,0,0,0,6,2,26
062380607,42,21,0,0,0,2,9,74
062380608,4,0,0,21,0,1,0,26
062380609,136,10,1,5,0,0,3,155
062380610,16,6,0,0,0,0,0,22
062380611,177,6,0,1,0,0,5,189
062380701,39,7,0,0,0,21,2,69
062380702,45,8,1,3,0,13,11,81
062380801,22,6,0,0,1,3,13,45
062380901,43,10,0,0,0,3,1,57
062381001,8,25,0,1,0,3,4,41
062381101,27,15,0,0,0,0,6,48
062450101,382,7,6,3,3,1,15,417
062450102,365,1,3,8,2,1,14,394
062450103,409,11,3,10,0,0,9,442
062450104,265,15,5,1,2,0,10,298
062450105,344,22,11,2,19,2,23,423
062450106,415,18,2,5,0,0,12,452
062450107,257,15,10,7,3,0,11,303
062450108,282,28,6,5,3,0,24,348
062450109,257,20,4,3,2,0,21,307
062450110,294,10,3,5,5,0,12,329
062450111,294,46,4,4,5,1,18,372
062450201,390,9,3,4,1,0,8,415
062450202,231,17,2,3,0,1,2,256
062450203,170,9,0,0,0,0,6,185
062450204,201,3,2,1,0,0,8,215
062450205,324,34,5,7,0,0,11,381
062450206,468,28,10,2,0,0,2,510
062450207,367,24,3,1,2,2,14,413
062450208,292,22,8,6,0,1,23,352
062450209,299,19,4,6,0,0,6,334
062450210,186,11,3,4,0,0,6,210
062450211,466,20,4,3,0,0,6,499
062450212,375,20,0,3,1,1,11,411
062450213,254,10,1,7,0,0,11,283
062450214,262,12,0,0,3,0,8,285
062450215,196,9,5,8,6,0,4,228
062450301,293,23,4,2,0,1,6,329
062450302,363,20,7,1,3,0,12,406
062450303,337,21,16,1,1,0,9,385
062450304,420,18,1,4,1,0,2,446
062450305,373,6,0,0,0,0,10,389
062450306,381,27,3,2,7,0,8,428
062450307,267,27,6,4,0,0,10,314
062450308,248,15,4,2,2,0,15,286
062450309,367,20,0,3,0,0,8,398
062450310,287,13,0,0,0,0,0,300
062450311,308,13,0,1,0,0,10,332
062450401,208,42,6,3,1,59,27,346
062450402,137,22,1,12,1,35,11,219
062450403,244,25,12,13,2,80,22,398
062450404,230,29,6,11,0,52,14,342
062450405,229,28,5,9,1,79,22,373
062450406,186,7,0,0,0,10,13,216
062450407,268,8,1,3,0,10,16,306
062450408,138,15,3,9,0,65,3,233
062450409,221,29,0,2,1,3,16,272
062450410,227,6,0,2,0,0,6,241
062450411,24,35,3,0,0,7,1,70
062450412,81,0,1,1,0,11,12,106
062450413,236,18,1,6,2,11,7,281
062450414,99,8,3,3,0,58,4,175
062450415,445,16,6,7,0,4,14,492
062450416,120,1,0,7,1,44,28,201
062450417,91,10,0,0,0,0,4,105
062450418,128,10,0,2,0,13,4,157
062450501,297,19,2,1,3,0,5,327
062450502,190,17,5,1,0,2,21,236
062450503,185,27,1,1,0,0,6,220
062450504,275,11,0,1,0,0,11,298
062450505,481,33,22,6,0,1,16,559
062450506,3,0,0,0,0,0,0,3
062450507,54,4,0,1,0,29,4,92
062520101,142,8,0,3,0,1,3,157
062520102,252,18,0,6,0,5,3,284
062520103,160,6,0,1,0,1,3,171
062520104,421,10,3,7,0,4,11,456
062520105,370,22,8,3,0,3,2,408
062520106,443,25,2,9,0,1,5,485
062520107,513,38,5,12,1,1,14,584
062520108,484,16,6,7,2,3,7,525
062520109,246,27,11,4,4,0,3,295
062520110,153,15,16,1,0,0,8,193
062520111,231,29,6,3,10,0,10,289
062520112,361,25,2,3,0,1,10,402
062520113,283,39,8,0,4,16,14,364
062520114,235,16,8,3,2,1,10,275
062520115,216,14,0,4,0,0,5,239
062520201,104,33,1,9,0,58,53,258
062520202,139,85,4,1,0,217,26,472
062520203,194,9,5,13,0,132,22,375
062520204,227,14,13,6,0,99,5,364
062520205,132,26,4,11,0,43,19,235
062520206,127,45,4,5,0,38,10,229
062520207,169,38,6,10,0,35,16,274
062520208,62,19,0,3,0,5,7,96
062520209,346,29,5,1,0,0,8,389
062520210,215,24,3,15,0,12,12,281
062520211,254,6,6,3,1,2,2,274
062520212,185,14,1,1,0,2,9,212
062520213,241,29,8,4,0,3,5,290
062520214,281,21,5,2,0,1,1,311
062520215,406,11,1,3,0,5,6,432
062520216,283,8,0,2,0,0,2,295
062520217,252,7,1,6,0,0,9,275
062520301,51,10,0,0,2,0,0,63
062520302,83,12,2,4,0,14,1,116
062520303,110,18,6,40,0,11,6,191
062520304,221,10,3,4,0,1,14,253
062520305,393,11,1,10,0,0,7,422
062520306,358,31,4,7,1,3,10,414
062520307,64,4,0,0,0,8,1,77
062520308,87,16,1,1,0,55,63,223
062520309,193,18,3,2,2,27,8,253
062520401,275,27,0,2,0,7,14,325
062520402,358,36,3,11,0,0,11,419
062520403,168,13,1,1,0,2,1,186
062520404,250,11,2,2,3,0,7,275
062520405,299,10,1,6,0,3,11,330
062520406,224,33,6,3,2,0,26,294
062520407,214,3,3,3,1,0,10,234
062520408,453,33,6,20,0,20,30,562
062520409,426,43,3,14,0,11,12,509
062520410,237,54,1,5,0,29,25,351
062520411,23,0,0,1,1,1,2,28
062520412,459,14,0,10,0,0,11,494
062520413,352,72,25,28,3,43,20,543
062520501,380,39,46,4,18,0,16,503
062520502,245,62,3,1,1,0,3,315
062520503,351,26,6,2,13,0,4,402
062520504,427,49,60,5,11,1,34,587
062520505,264,31,35,2,5,0,12,349
062520506,201,23,17,3,2,1,4,251
062520507,404,30,8,10,0,0,18,470
062520508,426,3,8,10,0,1,11,459
062520509,368,2,0,2,0,1,4,377
062520601,216,0,1,1,0,0,5,223
062520602,3,0,0,0,0,0,1,4
062520603,54,1,0,0,1,3,4,63
062520604,221,0,9,11,1,104,10,356
062520605,304,0,5,4,3,23,11,350
062520606,289,0,11,26,1,216,17,560
062520607,35,6,2,2,0,0,0,45
062520608,22,0,0,0,0,9,0,31
062520609,37,1,0,5,0,4,1,48
062520610,35,0,3,0,0,4,0,42
062520611,99,0,3,74,0,41,5,222
062520612,151,0,1,8,0,38,17,215
062520613,141,4,5,6,2,121,8,287
062520614,190,1,0,1,1,0,2,195
062520701,320,0,4,2,0,0,6,332
062520702,352,1,0,5,1,3,12,374
062520703,348,3,8,36,0,3,14,412
062520704,374,4,1,5,0,1,18,403
062520705,425,6,1,1,1,0,10,444
062520706,477,18,1,0,0,0,3,499
062520707,336,24,0,6,0,1,8,375
062520708,378,12,4,10,3,2,9,418
062520709,255,8,8,2,0,1,17,291
062520710,261,10,3,8,0,1,9,292
062520711,450,28,5,15,0,25,12,535
062520801,54,0,1,5,0,1,6,67
062520802,433,25,3,3,1,17,19,501
062520803,398,20,5,14,2,3,13,455
062520804,400,14,2,11,0,0,1,428
062520805,363,14,2,1,0,0,19,399
062520806,405,38,13,7,5,5,7,480
062520807,291,23,0,7,3,3,9,336
062520808,258,11,3,5,0,1,5,283
062520809,85,6,7,0,0,13,1,112
062520810,155,195,0,12,0,140,18,520
062520901,836,89,10,21,0,20,9,985
062520902,484,14,2,3,0,1,5,509
062520903,408,7,1,1,0,1,0,418
062520904,389,4,2,2,1,1,8,407
062520905,325,4,0,0,0,1,11,341
062520906,301,15,1,1,0,0,1,319
062520907,298,20,3,1,0,1,7,330
062520908,221,10,6,10,0,1,1,249
062520909,265,11,1,5,1,1,4,288
062520910,362,12,0,0,0,0,5,379
062520911,419,7,0,3,0,0,6,435
062520912,352,5,0,1,0,0,5,363
062520913,617,27,0,2,0,1,6,653
062520914,412,12,2,20,0,4,12,462
062521001,170,74,19,6,0,49,5,323
062521002,42,5,2,2,2,7,3,63
062521003,284,9,12,2,2,34,12,355
062521004,293,23,9,2,0,17,7,351
062521005,211,9,1,12,0,1,3,237
062521006,299,12,1,4,1,0,7,324
062521007,247,13,1,13,0,3,6,283
062521008,173,8,8,96,0,0,8,293
062521009,310,12,3,3,0,2,6,336
062521010,302,15,14,15,0,8,7,361
062521011,316,10,2,2,0,0,1,331
062521012,372,13,1,12,0,0,4,402
062521013,405,39,5,28,0,25,22,524
062521014,221,34,17,18,0,36,11,337
062521015,193,37,4,9,0,48,6,297
062521016,271,20,11,3,0,7,6,318
062521017,201,24,4,7,0,21,18,275
062521101,246,12,7,7,1,1,2,276
062521102,447,32,4,6,6,5,6,506
062521103,226,21,8,1,5,4,6,271
062521104,351,32,4,1,2,4,12,406
062521105,359,36,2,1,5,7,6,416
062521106,266,6,9,7,1,15,16,320
062521107,300,39,3,6,0,6,9,363
062521108,96,14,16,6,0,27,6,165
062521109,166,9,1,7,0,41,4,228
062521110,299,32,19,9,1,25,15,400
062521201,329,3,1,3,0,8,8,352
062521202,482,17,3,11,0,1,15,529
062521203,372,5,2,0,2,0,4,385
062521204,388,8,1,4,5,0,7,413
062521205,422,8,0,11,0,0,19,460
062521206,330,25,6,4,0,4,5,374
062521207,350,5,8,5,0,0,3,371
062521208,269,11,2,4,1,0,1,288
062521301,177,7,1,1,1,2,2,191
062521302,352,8,10,10,0,1,0,381
062521303,354,15,1,4,0,0,12,386
062521304,298,14,3,5,1,2,9,332
062521305,338,13,3,3,0,3,7,367
062521306,287,16,4,1,1,3,3,315
062521307,225,19,4,3,4,2,4,261
062521308,242,18,2,6,1,2,4,275
062521309,225,13,3,3,8,1,13,266
062521310,213,13,1,0,0,0,12,239
062521311,283,11,7,4,1,1,7,314
062521312,318,17,1,4,0,1,5,346
062521401,335,22,3,15,1,8,8,392
062521402,388,12,5,0,0,0,4,409
062521403,476,18,0,0,0,0,3,497
062521404,298,10,1,0,0,5,19,333
062521405,185,6,1,8,1,1,2,204
062521406,202,10,3,1,0,0,6,222
062521407,297,8,2,5,1,1,7,321
062521408,479,12,6,4,4,1,8,514
062521409,336,16,6,3,2,1,16,380
062521410,287,30,0,5,1,3,5,331
062521411,288,12,7,12,0,2,7,328
062521412,372,9,6,14,0,1,14,416
062521413,531,8,2,4,0,2,12,559
062521414,267,6,1,1,0,3,9,287
062521415,245,9,1,1,0,0,1,257
062521416,284,10,5,1,0,2,4,306
062521417,285,15,3,6,0,2,16,327
062521418,278,13,6,2,0,1,3,303
062521419,387,10,4,5,0,0,4,410
062521501,4,0,0,0,1,0,0,5
062521502,2,0,0,0,0,0,0,2
062521503,305,8,1,2,0,2,6,324
062521504,410,10,4,10,0,2,17,453
062521505,335,16,0,6,0,1,6,364
062521506,353,11,1,3,0,1,9,378
062521507,325,13,0,5,0,0,1,344
062521508,348,9,1,5,1,0,4,368
062521509,298,24,13,11,0,19,15,380
062521510,193,67,0,7,0,111,30,408
062521511,372,18,4,4,0,6,6,410
062521512,418,8,3,4,1,0,5,439
062521513,213,114,25,16,1,131,62,562
062521514,294,14,2,0,0,0,11,321
062521515,498,14,4,0,0,0,16,532
062521601,173,45,2,15,0,117,135,487
062660101,8,0,3,4,0,5,0,20
062660102,65,2,0,0,1,50,5,123
062660103,31,1,0,1,0,13,14,60
062660104,61,4,0,0,0,13,1,79
062660201,15,0,0,0,0,9,1,25
062660202,38,4,0,0,0,0,3,45
062660203,26,1,0,2,0,16,1,46
062660204,287,16,0,3,0,3,3,312
062660205,115,28,0,6,1,63,7,220
062660301,286,20,4,13,0,2,4,329
062660302,268,13,4,2,3,2,6,298
062660303,265,11,2,2,0,1,5,286
062660304,195,5,1,4,3,1,5,214
062660305,99,7,0,16,0,1,5,128
062660306,158,11,1,1,0,0,11,182
062660307,182,13,3,2,2,1,6,209
062660308,156,14,3,2,2,4,4,185
062660309,188,33,4,3,7,2,14,251
062660310,257,17,8,8,3,1,6,300
062660311,258,11,4,4,1,2,11,291
062660312,25,0,0,1,0,4,1,31
062660401,52,1,2,1,0,17,1,74
062660402,5,0,0,0,0,3,1,9
062660403,87,0,0,7,0,83,10,187
062660501,380,7,4,16,2,59,29,497
062660502,162,10,0,1,5,4,9,191
062660503,131,35,2,10,2,17,11,208
062660504,64,8,5,4,2,64,22,169
062660505,54,20,1,4,0,58,28,165
062660506,74,15,10,14,1,64,6,184
062660507,35,23,3,6,0,21,2,90
062660508,215,33,4,15,0,102,11,380
062660509,75,1,0,3,0,100,13,192
062660601,129,9,0,3,0,22,16,179
062660602,216,74,3,15,1,239,35,583
062660603,108,9,2,6,5,38,5,173
062660604,77,3,5,14,2,122,13,236
062660605,97,25,1,10,4,62,23,222
062660606,59,2,5,0,0,71,35,172
062660607,63,6,2,2,2,25,141,241
062660608,102,2,18,8,0,166,4,300
062660609,184,6,7,11,1,34,5,248
062660610,150,24,9,15,0,75,34,307
062660611,114,35,8,16,0,77,31,281
062660612,114,50,5,6,0,41,17,233
062660701,227,12,1,4,0,5,3,252
062660702,272,30,5,4,7,28,7,353
062660703,406,16,9,10,0,26,2,469
062660704,104,19,8,44,0,25,21,221
062660705,426,25,1,10,1,19,20,502
062660706,74,14,1,5,0,19,3,116
062660707,254,18,11,8,17,2,12,322
062660708,313,14,5,6,2,7,6,353
062660709,382,17,7,9,3,13,9,440
062660710,288,16,1,5,0,3,7,320
062660711,150,7,1,4,0,11,9,182
062770101,4,7,0,0,0,0,1,12
062770102,120,5,2,28,1,1,17,174
062770103,111,8,0,17,0,1,3,140
062770104,22,0,0,0,0,1,11,34
062770105,7,9,0,0,0,0,0,16
062770106,44,27,0,165,1,8,59,304
062770107,255,27,0,21,1,5,3,312
062770108,228,19,4,26,1,0,4,282
062770109,212,23,0,8,1,2,7,253
062770110,239,13,2,3,0,2,2,261
062770111,417,30,7,4,4,1,20,483
062770112,216,29,7,1,9,1,15,278
062770113,255,15,2,5,1,1,13,292
062770114,222,17,1,0,0,0,7,247
062770115,285,25,2,10,1,2,8,333
062770116,20,11,0,0,0,0,16,47
062770201,31,13,0,0,0,0,4,48
062770202,97,32,2,4,0,4,5,144
062770203,29,9,0,0,0,0,10,48
062770204,66,7,1,13,0,1,11,99
062770205,10,8,0,0,0,0,2,20
062770206,33,17,0,0,0,0,18,68
062800101,176,17,2,0,0,4,8,207
062800102,172,11,10,4,0,18,7,222
062800103,172,9,2,5,3,7,3,201
062800104,224,11,2,0,0,4,2,243
062800105,142,5,1,2,0,9,9,168
062800106,132,24,0,39,0,1,8,204
062800107,248,28,0,2,0,0,34,312
062800108,157,34,0,3,0,0,4,198
062800109,124,17,0,2,0,0,2,145
062800110,168,21,1,1,1,11,7,210
062800201,298,2,1,2,0,9,6,318
062800202,226,17,2,6,0,26,16,293
062800203,171,18,7,4,4,24,14,242
062800204,224,17,1,3,1,18,4,268
062800205,332,36,10,7,1,28,12,426
062800206,234,43,4,3,3,16,4,307
062800207,276,84,8,2,4,17,27,418
062800208,169,91,2,6,6,30,11,315
062800301,56,56,44,5,1,62,6,230
062800302,50,51,0,0,1,280,54,436
062800303,62,24,42,0,2,274,26,430
062800304,56,27,17,0,0,296,33,429
062800305,83,57,36,3,2,134,19,334
062800306,50,21,0,1,1,264,96,433
062800307,90,184,0,0,0,276,71,621
062800308,48,127,36,0,2,125,13,351
062800309,46,3,11,1,0,283,2,346
062800310,52,17,24,0,4,247,9,353
062800311,37,46,38,0,3,630,59,813
062800312,28,3,0,0,0,244,151,426
062800313,29,51,19,0,1,226,6,332
062800401,241,36,34,6,3,113,21,454
062800402,54,36,4,4,2,104,18,222
062800403,33,63,7,0,0,87,22,212
062800404,12,0,0,1,0,340,15,368
062800405,45,41,14,0,1,250,8,359
062800406,102,11,12,6,2,173,42,348
062800407,66,22,18,7,1,47,12,173
062800408,91,2,11,2,0,48,18,172
062800409,121,5,2,7,2,38,9,184
062800410,89,20,4,6,0,31,13,163
062800501,7,0,0,0,0,0,8,15
062800502,13,0,0,0,0,6,4,23
062800503,7,4,0,0,0,0,0,11
062800504,3,10,0,0,0,0,0,13
062800505,9,1,0,0,0,0,2,12
062800506,12,1,0,0,1,4,0,18
062800507,8,2,0,0,1,2,0,13
062800508,13,0,0,0,0,5,4,22
062800509,7,0,0,0,1,3,3,14
062800601,5,1,0,0,0,0,5,11
062800602,7,0,0,0,0,0,7,14
062800603,32,0,0,4,2,77,0,115
062800604,24,1,10,5,0,84,2,126
062800605,12,0,1,0,0,98,17,128
062800606,191,37,13,17,2,110,20,390
062800607,68,19,3,4,0,46,0,140
062800608,110,4,6,0,0,28,11,159
062800609,40,3,3,14,0,38,5,103
062800610,121,19,0,0,0,12,1,153
062800611,71,5,3,4,0,45,11,139
062800612,38,18,2,3,2,24,39,126
062800613,26,0,2,1,0,46,27,102
062800614,33,0,1,5,0,81,20,140
062800615,44,20,6,0,0,17,3,90
062800616,33,29,5,9,0,23,1,100
062800617,25,35,1,5,0,13,0,79
062800701,10,1,0,0,0,4,1,16
062800702,9,1,0,0,0,0,1,11
062800703,21,6,1,0,0,2,5,35
062800704,54,15,0,3,0,1,10,83
062800705,18,4,0,0,1,2,2,27
062800706,15,3,0,0,0,6,3,27
062800707,10,7,0,0,6,2,3,28
062800708,13,1,0,0,1,2,3,20
062800709,19,0,0,0,1,4,13,37
062800710,10,5,0,0,0,3,4,22
062800711,11,3,0,2,0,64,2,82
062800801,96,4,0,0,0,0,6,106
062800802,4,0,0,0,0,3,3,10
062800803,5,0,0,0,0,3,8,16
062800804,5,0,0,0,0,1,4,10
062800805,3,0,0,0,0,5,6,14
062800806,7,1,0,0,0,2,4,14
062800807,13,1,0,0,0,3,8,25
062800808,6,2,1,0,0,2,4,15
062800809,17,0,0,0,1,2,5,25
062800810,9,2,0,0,0,2,3,16
062800811,8,0,0,0,0,0,4,12
062800812,12,8,0,0,0,1,0,21
062800813,11,4,0,0,0,0,0,15
062800814,7,2,0,0,0,0,0,9
062800815,14,4,0,1,0,0,3,22
062800816,38,6,0,2,0,3,10,59
062800817,10,11,0,0,0,0,0,21
062800818,4,0,0,1,0,0,2,7
062800819,214,22,0,1,1,1,9,248
062800820,95,10,1,2,0,4,4,116
062800901,36,1,3,2,0,14,41,97
062800902,12,0,2,3,1,106,1,125
062800903,5,2,0,0,0,0,3,10
062800904,11,1,5,1,0,18,7,43
062800905,17,0,0,1,0,8,6,32
062800906,22,6,0,0,0,0,0,28
062800907,6,0,0,0,0,0,0,6
062800908,11,6,0,1,0,10,6,34
062800909,41,0,5,6,0,98,46,196
062800910,10,15,0,8,4,89,4,130
062800911,9,14,7,5,0,58,10,103
062800912,57,1,2,4,0,93,14,171
062801001,200,31,22,8,4,60,18,343
062801002,194,25,29,4,3,49,10,314
062801003,78,3,39,4,1,117,28,270
062801004,118,35,37,0,3,172,23,388
062801005,93,106,5,2,7,151,13,377
062801006,30,32,0,0,1,56,55,174
062801007,64,7,8,1,3,233,7,323
062801008,125,25,17,3,2,134,34,340
062801101,226,13,8,5,1,17,2,272
062801102,295,15,4,5,1,29,15,364
062801103,345,31,6,8,5,42,30,467
062801104,139,31,6,1,0,9,17,203
062801105,155,31,9,0,1,21,11,228
062801106,173,19,5,7,4,32,8,248
062801107,146,11,6,2,2,25,18,210
062801108,161,14,8,4,0,7,5,199
062801109,202,38,2,10,0,35,9,296
062801110,127,15,2,4,0,13,13,174
062801111,147,20,1,5,0,7,3,183
062801112,133,12,2,5,1,17,5,175
062801201,39,2,0,0,0,1,7,49
062801202,30,0,0,1,0,1,4,36
062801203,3,1,0,0,0,3,2,9
062801204,29,5,0,3,0,0,1,38
062801205,399,18,5,6,1,1,16,446
062801206,331,7,1,2,3,2,14,360
062801207,379,22,6,3,1,2,7,420
062801208,449,31,0,5,0,4,7,496
062801209,190,2,2,1,0,0,4,199
062801210,189,5,1,5,0,0,8,208
062870101,91,19,0,1,0,18,31,160
062870201,53,32,0,0,0,2,2,89
062870301,8,9,0,0,0,0,2,19
062870302,14,2,0,0,0,9,5,30
062870401,66,7,3,4,0,2,16,98
062870402,9,1,0,0,0,5,7,22
062870403,91,13,0,2,0,0,0,106
062870404,164,16,1,5,0,2,8,196
062870405,287,26,0,5,2,0,13,333
062870406,195,23,5,2,3,2,6,236
062870407,244,22,2,9,0,3,9,289
062870408,193,10,1,5,0,5,0,214
062870409,124,18,0,5,0,0,6,153
062870410,130,12,0,3,0,3,6,154
062870411,264,24,7,7,2,4,16,324
062870412,178,23,6,5,5,1,10,228
062870413,317,33,9,3,0,9,29,400
062870414,220,15,3,3,0,4,15,260
062870415,248,42,1,10,0,4,8,313
062870416,28,9,0,4,0,9,10,60
062870417,6,1,0,0,0,2,2,11
062870501,27,8,0,0,0,3,5,43
062870502,60,4,1,0,1,9,26,101
062870601,66,5,0,1,0,13,23,108
062870701,43,13,0,0,0,8,8,72
062870702,48,19,0,1,0,8,4,80
062940101,9,0,0,0,0,0,21,30
062940102,2,0,0,0,0,0,20,22
062940103,0,0,0,0,0,0,17,17
062940201,6,0,0,0,0,1,9,16
062940202,98,3,0,6,0,0,10,117
062940203,379,15,7,31,1,0,6,439
062940204,330,44,1,9,3,8,8,403
062940205,20,4,0,0,0,4,19,47
062940206,8,0,0,0,0,2,25,35
062940207,8,0,0,0,0,0,3,11
062940208,1,0,0,0,0,2,8,11
062940209,11,1,2,0,0,0,5,19
062940210,10,0,0,0,0,4,17,31
062940211,96,5,0,1,1,1,15,119
062940301,10,0,1,0,0,0,2,13
062940302,5,0,0,0,0,1,2,8
062940303,7,2,0,0,0,3,10,22
062940401,232,16,2,2,0,0,6,258
062940402,328,32,7,14,0,1,9,391
062940403,383,29,9,6,3,11,24,465
062940404,155,10,2,3,4,3,7,184
062940405,37,4,0,2,0,1,6,50
062940406,51,7,0,95,1,3,13,170
062940407,9,3,0,0,0,0,0,12
062940408,303,28,4,5,0,0,9,349
062940501,25,4,0,0,0,1,2,32
062940502,5,16,0,0,0,0,7,28
062940503,5,0,0,0,0,0,29,34
062940504,4,0,0,0,0,2,8,14
062940505,13,14,0,0,0,0,0,27
062940506,26,4,0,0,0,1,27,58
062940601,262,27,2,6,2,1,6,306
062940602,144,7,2,3,0,2,8,166
062940603,215,27,7,4,3,0,8,264
062940604,130,17,6,6,0,0,8,167
062940605,4,4,0,0,0,0,24,32
062940606,17,1,0,0,0,0,15,33
062940607,15,1,0,0,0,6,6,28
062940608,70,2,0,10,0,0,20,102
062940609,121,13,0,2,1,1,12,150
062940610,132,11,2,5,0,7,6,163
062940701,7,2,0,0,0,0,5,14
062940702,12,0,0,0,0,9,3,24
062940703,7,0,0,0,0,0,9,16
062940704,8,0,0,0,0,0,18,26
062940705,9,0,0,0,0,0,15,24
062940706,0,0,0,0,0,0,14,14
062940801,63,6,0,5,0,1,7,82
062940802,205,17,4,7,1,1,1,236
062940803,198,7,7,8,0,2,9,231
062940804,118,9,2,4,0,3,4,140
062940805,142,10,2,3,3,1,16,177
062940806,151,11,1,8,2,1,9,183
062940807,216,10,4,0,0,0,11,241
062940808,243,11,5,6,1,4,16,286
062940809,54,1,1,3,0,2,10,71
062940810,103,7,0,10,0,0,11,131
062940811,3,1,0,0,0,0,7,11
062940812,3,0,0,0,0,1,10,14
062940813,1,0,0,0,0,0,0,1
062940814,7,0,0,0,0,3,16,26
062940815,12,7,0,0,0,2,7,28
063010101,195,3,1,4,1,18,45,267
063010201,46,7,0,0,0,7,17,77
063010301,43,0,0,0,0,7,11,61
063010401,60,14,0,0,0,7,14,95
063010501,5,0,0,0,0,15,2,22
063010502,55,22,1,1,0,3,12,94
063010503,29,11,0,1,0,1,1,43
063010504,215,14,5,5,0,7,21,267
063010505,218,26,6,11,0,7,3,271
063010506,220,23,2,4,1,5,5,260
063010507,182,19,2,6,2,3,9,223
063010508,238,25,1,2,1,3,6,276
063010509,252,15,3,12,3,12,11,308
063010510,237,26,2,8,1,8,8,290
063010511,282,25,8,2,10,6,13,346
063010512,332,15,2,3,3,5,30,390
063010513,389,41,2,12,0,4,14,462
063010514,185,2,0,1,0,6,7,201
063010601,76,46,0,4,1,14,23,164
063010701,77,25,1,1,0,0,21,125
063010801,88,29,1,1,2,10,16,147
063010802,40,22,0,3,1,18,4,88
063010803,51,4,4,0,1,54,9,123
063010804,54,7,4,6,1,59,41,172
063010805,191,16,3,14,0,176,10,410
063010806,270,59,3,13,1,89,17,452
063010807,116,10,7,7,1,32,6,179
063010808,275,16,5,2,8,7,18,331
063010809,244,22,11,5,9,1,21,313
063010810,142,7,2,6,0,20,7,184
063010811,278,24,5,2,6,4,22,341
063010812,351,30,0,15,1,6,15,418
063010813,222,36,1,6,1,5,7,278
063010814,212,27,0,8,2,7,10,266
063010815,9,0,0,1,0,7,1,18
063080101,18,0,0,0,0,0,11,29
063080201,16,3,0,0,0,5,12,36
063080301,27,0,0,0,0,3,13,43
063080401,24,0,0,0,0,7,18,49
063080501,100,8,0,1,0,2,5,116
063080502,85,42,0,0,1,4,20,152
063080601,129,9,2,3,1,1,9,154
063080602,142,6,3,27,1,4,23,206
063080603,30,3,0,2,0,1,3,39
063080604,4,6,0,0,0,0,1,11
063080701,28,12,0,0,0,3,18,61
063080801,12,11,0,0,0,4,1,28
063080901,34,2,0,0,0,0,15,51
063081001,39,12,0,0,0,18,32,101
063081002,283,34,3,5,0,10,41,376
063081003,27,1,0,0,0,2,13,43
063150101,212,16,1,5,0,4,8,246
063150102,378,37,4,2,5,3,13,442
063150103,170,21,0,6,0,0,14,211
063150104,310,40,7,5,4,4,11,381
063150105,314,43,6,5,9,1,24,402
063150106,303,34,4,7,9,2,24,383
063150107,184,19,4,6,0,1,8,222
063150108,220,21,4,5,0,1,3,254
063150109,364,35,9,2,13,1,19,443
063150110,367,33,5,6,1,7,18,437
063150111,450,39,11,8,0,1,13,522
063150112,294,30,7,16,0,2,3,352
063150113,327,28,3,13,0,4,13,388
063150114,359,22,3,13,0,3,12,412
063150115,256,15,1,25,0,1,6,304
063150116,191,20,0,2,0,1,11,225
063150117,191,11,0,6,0,2,8,218
063150118,281,33,2,22,0,1,9,348
063150201,56,15,0,1,0,16,17,105
063150301,258,42,5,10,1,2,7,325
063150302,103,7,0,8,0,1,5,124
063150303,139,22,4,1,0,19,18,203
063150401,83,36,0,0,0,16,28,163
063150501,77,20,2,3,1,13,23,139
063150502,122,14,0,3,0,29,10,178
063150601,117,0,0,0,0,7,32,156
063150701,36,6,0,0,0,2,9,53
063220101,2,5,0,0,0,0,0,7
063220102,3,0,0,0,0,0,10,13
063220103,11,0,0,0,0,0,4,15
063220201,16,1,0,0,0,0,1,18
063220202,6,2,0,0,0,0,10,18
063220203,4,0,0,0,0,0,5,9
063220204,7,5,0,0,0,0,13,25
063220301,96,22,1,2,0,0,5,126
063220302,19,1,0,0,0,7,4,31
063220303,4,2,0,0,1,3,7,17
063220304,18,11,0,0,0,1,8,38
063220305,13,1,0,0,0,0,0,14
063220306,11,1,0,0,0,0,2,14
063220307,121,19,2,3,7,4,9,165
063220401,6,0,1,0,0,0,1,8
063220402,6,2,0,0,0,2,2,12
063220403,10,0,0,0,0,0,0,10
063220404,6,1,0,0,0,1,5,13
063220405,5,1,0,0,0,0,1,7
063220501,10,1,0,0,0,0,6,17
063220502,10,0,0,0,0,2,4,16
063220503,9,14,0,0,0,0,0,23
063220504,4,0,0,0,0,0,11,15
063220505,11,13,0,0,0,0,7,31
063220601,384,54,0,11,1,4,21,475
063220602,267,38,4,1,1,0,4,315
063220603,188,27,1,2,2,4,7,231
063220604,192,12,10,1,1,0,4,220
063220605,205,37,1,1,5,1,8,258
063220606,132,14,6,1,0,0,9,162
063220607,186,17,0,0,4,0,10,217
063220608,26,2,0,0,0,0,21,49
063220609,5,0,0,0,0,4,3,12
063220610,1,0,0,0,0,0,5,6
063220611,52,7,0,0,1,2,2,64
063220612,233,33,1,3,0,0,48,318
063220613,134,43,1,13,0,0,83,274
063220614,176,17,0,0,0,2,2,197
063220615,145,21,0,5,1,0,6,178
063220616,182,18,0,6,0,1,6,213
063220617,252,22,1,9,0,3,6,293
063220701,68,6,0,2,2,2,8,88
063220702,16,10,0,0,0,0,2,28
063220703,17,0,0,1,0,0,8,26
063220704,6,0,0,0,0,0,3,9
063220705,10,17,0,0,0,0,1,28
063220801,8,4,0,0,0,0,1,13
063220802,7,4,0,0,0,0,2,13
063220803,13,1,0,0,0,0,0,14
063220901,17,6,0,0,0,2,6,31
063220902,10,6,0,0,0,2,9,27
063220903,5,5,0,0,0,0,3,13
063221001,112,14,1,2,1,3,19,152
063221002,24,4,0,1,0,1,12,42
063221003,9,5,0,0,0,0,1,15
063221004,24,8,0,0,0,0,4,36
063221005,21,2,0,0,0,1,5,29
063221006,9,2,0,0,0,0,9,20
063221007,43,4,0,0,0,2,17,66
063221008,16,4,0,0,0,6,4,30
063221101,11,3,0,0,0,3,1,18
063221102,12,0,0,0,0,1,7,20
063221103,10,2,0,0,0,0,11,23
063221201,8,0,0,0,0,1,5,14
063221202,3,0,0,0,0,5,4,12
063221203,7,1,0,0,0,2,0,10
063221301,6,0,0,0,0,5,0,11
063221302,9,4,0,0,0,0,0,13
063221303,12,1,0,1,0,1,2,17
063221304,8,1,0,1,0,0,10,20
063290101,13,0,1,2,3,8,4,31
063290102,35,0,0,2,0,3,13,53
063290103,24,7,0,0,0,0,2,33
063290104,22,0,0,0,0,1,8,31
063290201,55,5,0,2,0,10,2,74
063290202,18,0,0,1,0,1,13,33
063290203,30,0,0,0,0,8,12,50
063290301,32,1,0,0,0,12,2,47
063290302,44,3,0,0,0,1,23,71
063290303,64,1,0,2,0,8,7,82
063290304,241,15,6,5,2,6,7,282
063290305,292,0,6,7,0,5,9,319
063290306,202,12,3,46,0,1,4,268
063290307,145,9,1,3,0,4,5,167
063290308,300,23,1,4,2,8,15,353
063290309,228,19,4,5,0,3,9,268
063290310,298,13,1,7,0,11,12,342
063290311,321,22,6,4,1,8,8,370
063290312,326,33,5,1,12,1,18,396
063290313,180,10,3,3,2,2,11,211
063290314,181,11,2,9,0,3,11,217
063290315,289,19,4,11,0,7,4,334
063290316,254,4,2,16,1,9,5,291
063290317,138,6,0,1,0,1,3,149
063290401,32,2,2,0,0,4,1,41
063290402,68,1,2,0,1,43,6,121
063290403,80,3,0,0,1,14,9,107
063290501,89,14,0,1,1,7,3,115
063290502,101,2,0,0,0,5,3,111
063290503,36,0,0,0,0,0,1,37
063290504,24,4,0,0,0,0,2,30
063290505,111,15,1,9,1,12,8,157
063290506,152,12,4,7,0,17,1,193
063290601,25,13,0,1,0,0,4,43
063290602,16,2,0,1,0,16,8,43
063360101,35,13,1,0,0,6,3,58
063360201,173,24,2,5,1,11,11,227
063360202,149,30,1,2,0,1,9,192
063360203,88,13,0,11,0,6,3,121
063360204,14,12,0,0,0,0,0,26
063360205,123,17,3,3,0,5,5,156
063360301,27,16,0,0,0,0,1,44
063360401,16,6,1,0,0,1,2,26
063360501,111,51,0,3,0,2,11,178
063360601,16,5,0,0,0,0,15,36
063360701,57,31,0,4,0,8,9,109
063360801,42,11,0,0,0,2,0,55
063360901,30,12,0,1,0,2,9,54
063361001,122,18,0,7,0,11,7,165
063361002,143,34,0,5,0,12,18,212
063430101,198,34,5,16,0,8,12,273
063430102,26,7,0,0,0,7,6,46
063430103,64,20,0,5,0,7,0,96
063430104,18,9,0,0,0,0,2,29
063430105,24,5,0,0,0,4,11,44
063430201,44,17,0,0,0,9,6,76
063430301,28,13,0,1,0,13,7,62
063430302,15,2,1,0,0,9,8,35
063430303,19,2,0,0,0,1,14,36
063430401,25,16,0,0,0,9,6,56
063430402,30,1,0,0,0,11,18,60
063430501,16,3,0,0,0,10,17,46
063430502,20,3,0,0,0,5,7,35
063430503,31,5,0,0,0,22,7,65
063430601,181,17,7,4,0,28,27,264
063430602,95,48,11,3,1,189,38,385
063430603,25,1,2,0,0,17,0,45
063430604,11,3,0,1,0,11,2,28
063430605,17,0,0,0,0,10,7,34
063430606,4,0,0,1,0,4,1,10
063430701,100,7,2,4,0,15,16,144
063430702,177,13,2,10,1,3,2,208
063430703,262,25,6,6,1,11,6,317
063430704,133,7,1,2,0,8,5,156
063430705,230,21,3,3,2,5,8,272
063430706,255,23,2,8,2,2,2,294
063430707,243,21,2,2,3,5,9,285
063430708,161,15,0,8,0,13,10,207
063430709,305,45,10,4,11,6,4,385
063430710,323,30,20,54,12,5,25,469
063430711,208,11,8,12,0,5,9,253
063430712,182,18,2,5,1,10,21,239
063430713,144,30,6,8,0,38,28,254
063430801,15,0,0,0,1,11,10,37
063430802,18,0,0,1,0,8,4,31
063510101,12,0,0,0,0,0,6,18
063510102,132,4,2,2,4,1,10,155
063510103,140,10,0,11,0,1,12,174
063510104,10,8,0,0,0,1,0,19
063510201,50,25,0,1,0,1,7,84
063510202,22,4,0,0,0,0,19,45
063510301,18,14,0,0,0,0,6,38
063510302,7,1,0,0,0,0,7,15
063510303,4,1,0,0,0,0,4,9
063510304,12,2,0,0,0,0,27,41
063510401,202,19,1,28,0,2,11,263
063510402,13,0,0,0,0,1,12,26
063510403,17,18,0,0,0,0,0,35
063510404,17,15,0,0,0,0,0,32
063510405,15,5,0,2,0,0,8,30
063510406,289,21,6,7,1,2,17,343
063510501,15,8,0,0,0,2,5,30
063510502,6,1,0,0,0,1,1,9
063510601,151,10,2,65,0,1,8,237
063510602,100,21,0,118,0,2,31,272
063510603,308,12,2,4,2,0,28,356
063510604,367,27,8,12,8,5,26,453
063510605,250,20,0,0,0,1,11,282
063510606,332,29,1,4,1,2,11,380
063510607,333,28,4,4,7,4,19,399
063510608,97,13,2,2,1,5,11,131
063510609,2,2,0,0,0,0,5,9
063510610,4,0,0,0,0,5,6,15
063510611,9,0,0,0,0,4,7,20
063510612,4,8,0,0,0,0,1,13
063510613,15,0,0,2,0,5,4,26
063510614,11,17,0,0,0,0,0,28
063510615,271,25,1,2,0,1,0,300
063510701,16,0,0,0,0,2,15,33
063510702,13,3,0,0,0,7,3,26
063510703,9,8,0,0,0,0,4,21
063510801,21,0,0,1,0,13,10,45
063510802,11,13,0,0,0,0,0,24
063510803,25,10,0,0,0,0,10,45
063510901,409,24,7,28,4,9,28,509
063510902,8,4,0,0,0,2,4,18
063510903,45,3,2,1,1,5,6,63
063511001,7,2,0,0,0,0,0,9
063511002,9,12,0,0,0,0,1,22
063511003,12,0,0,0,0,0,10,22
063570101,229,20,4,8,0,4,7,272
063570102,309,6,2,11,2,6,11,347
063570103,338,11,2,8,2,8,12,381
063570104,371,48,6,11,0,3,13,452
063570105,329,29,8,8,0,9,9,392
063570106,241,18,6,2,0,9,12,288
063570107,252,36,0,0,0,0,9,297
063570108,337,39,2,2,0,3,13,396
063570109,249,18,4,9,2,12,24,318
063570201,275,19,5,5,0,3,10,317
063570202,254,32,3,2,0,1,5,297
063570203,263,28,9,11,0,13,10,334
063570204,340,37,9,11,0,12,14,423
063570205,264,49,3,8,0,6,12,342
063570206,272,21,5,1,0,10,20,329
063570207,210,21,1,3,0,7,9,251
063570208,173,14,5,3,0,5,11,211
063570209,268,37,6,10,0,7,11,339
063570210,240,16,8,3,2,6,8,283
063570301,143,19,10,1,0,23,17,213
063570302,170,18,19,14,1,51,10,283
063570303,124,50,12,19,0,34,7,246
063570304,200,19,4,6,2,13,4,248
063570305,218,34,11,5,1,31,13,313
063570306,319,34,15,4,8,23,10,413
063570307,278,66,13,5,2,26,67,457
063570308,331,49,9,4,0,24,6,423
063570309,357,58,9,4,0,13,15,456
063570310,283,39,9,5,1,19,12,368
063570311,336,40,15,6,8,21,18,444
063570401,224,12,5,5,0,68,3,317
063570402,169,36,6,5,1,130,13,360
063570403,158,19,3,2,0,134,7,323
063570404,158,20,4,0,0,53,15,250
063570405,147,20,1,2,0,48,6,224
063570406,185,23,8,3,3,25,4,251
063570407,255,38,20,3,0,82,61,459
063570408,299,39,5,2,0,62,12,419
063570409,224,48,5,2,1,41,7,328
063570410,215,59,27,2,4,104,43,454
063570501,350,30,7,5,1,9,4,406
063570502,329,25,5,10,1,8,9,387
063570503,243,28,8,3,0,4,2,288
063570504,242,35,17,3,2,11,5,315
063570505,187,34,8,2,2,4,4,241
063570506,220,22,11,2,0,29,10,294
063570507,178,27,4,5,1,6,5,226
063570508,193,30,2,4,4,8,6,247
063570509,331,41,7,6,3,26,14,428
063570510,303,61,10,4,0,24,27,429
063570511,169,20,18,0,2,31,22,262
063570512,189,50,15,1,1,55,9,320
063570513,147,34,5,3,1,29,8,227
063570514,115,80,6,5,0,57,4,267
063570601,292,15,3,10,0,2,14,336
063570602,228,11,4,3,1,2,19,268
063570603,240,13,6,7,2,2,7,277
063570604,372,24,4,5,0,1,23,429
063570605,247,15,2,3,0,1,5,273
063570606,230,34,5,0,7,1,10,287
063570607,323,55,6,0,0,0,10,394
063570608,333,26,12,7,4,10,8,400
063570609,359,38,6,3,0,8,8,422
063570610,310,18,10,3,2,9,6,358
063570611,279,22,4,2,2,3,8,320
063570701,286,29,0,3,0,11,13,342
063570702,329,44,12,5,0,3,5,398
063570703,255,24,5,2,0,9,3,298
063570704,303,22,5,12,0,7,7,356
063570705,371,13,5,13,0,4,9,415
063570706,333,14,8,15,0,5,3,378
063570707,244,15,6,13,4,2,10,294
063570708,258,9,0,2,0,3,11,283
063570709,413,14,5,13,2,3,13,463
063570710,283,12,3,4,2,0,13,317
063570711,224,16,1,4,0,4,9,258
063570801,301,14,2,1,1,0,11,330
063570802,237,18,4,4,0,2,2,267
063570803,197,10,6,1,0,1,6,221
063570804,245,30,4,3,0,8,9,299
063570805,309,30,6,4,0,6,13,368
063570806,253,13,6,2,0,1,12,287
063570807,313,16,11,2,1,5,7,355
063570808,259,14,7,1,1,1,8,291
063570809,343,29,13,1,0,4,18,408
063570810,354,30,12,1,0,3,10,410
063570811,368,17,3,2,0,5,19,414
063570812,348,39,3,3,2,1,9,405
063570813,204,9,1,3,5,3,14,239
063570814,144,14,5,5,0,2,8,178
063570901,412,17,4,14,1,3,13,464
063570902,278,13,3,2,0,0,0,296
063570903,244,10,5,5,0,0,14,278
063570904,318,15,4,5,0,2,4,348
063570905,286,22,3,4,0,2,15,332
063570906,353,17,5,6,1,1,8,391
063570907,299,18,3,3,0,1,7,331
063570908,265,8,1,4,0,0,3,281
063570909,279,24,1,4,0,0,12,320
063570910,347,19,6,2,1,1,10,386
063570911,319,13,1,0,1,2,10,346
063570912,397,28,8,10,1,1,15,460
063570913,275,22,1,4,0,0,9,311
063571001,222,17,3,8,0,6,1,257
063571002,212,39,6,3,0,2,12,274
063571003,376,40,0,1,2,2,10,431
063571004,288,22,1,35,0,2,10,358
063571005,314,23,1,4,2,2,11,357
063571006,360,22,1,0,1,3,21,408
063571007,240,5,1,4,1,2,5,258
063571008,378,7,2,7,0,1,12,407
063571009,236,8,0,2,0,2,15,263
063571010,216,25,1,1,0,0,4,247
063571011,298,14,4,3,0,1,8,328
063571012,283,18,1,1,0,1,12,316
063571013,210,12,0,5,0,0,5,232
063571014,248,14,3,5,0,1,7,278
063571015,210,16,7,4,0,1,11,249
063571101,205,6,8,4,3,5,14,245
063571102,316,11,4,5,0,3,16,355
063571103,241,18,0,0,0,3,5,267
063571104,364,15,4,6,2,0,6,397
063571105,283,16,0,2,0,1,18,320
063571106,318,10,2,8,0,2,9,349
063571107,264,9,1,3,0,0,7,284
063571108,193,9,6,8,1,2,8,227
063571109,368,18,11,4,0,3,11,415
063571110,244,14,3,3,0,2,10,276
063571111,289,36,6,2,0,0,14,347
063571112,302,24,2,3,0,0,7,338
063571201,316,26,6,3,0,1,6,358
063571202,193,16,0,1,0,0,4,214
063571203,280,14,4,3,0,1,16,318
063571204,264,14,4,4,2,0,11,299
063571205,379,36,2,5,4,1,15,442
063571206,174,14,2,1,1,2,0,194
063571207,282,15,2,10,0,0,18,327
063571208,345,10,3,8,0,0,11,377
063571209,296,9,3,3,8,2,3,324
063571210,321,5,12,18,8,0,12,376
063571211,365,20,0,4,0,1,8,398
063571212,292,10,0,3,1,2,5,313
063571213,275,22,2,1,0,1,5,306
063571214,293,33,30,1,0,2,19,378
063571215,328,21,2,1,0,1,11,364
063571301,266,28,2,2,5,0,13,316
063571302,305,37,2,4,2,1,7,358
063571303,385,20,6,11,1,2,11,436
063571304,456,25,5,10,2,2,19,519
063571305,249,22,8,3,2,1,7,292
063571306,393,30,8,5,0,2,9,447
063571307,313,25,12,0,3,1,4,358
063571308,279,24,3,2,4,0,8,320
063571309,183,34,2,0,0,0,4,223
063571401,368,34,9,2,11,9,22,455
063571402,299,47,17,2,0,0,8,373
063571403,400,29,14,4,5,5,6,463
063571404,311,30,2,0,3,1,13,360
063571405,211,41,8,1,5,0,21,287
063571406,297,48,15,5,2,5,21,393
063571407,376,28,9,2,2,1,13,431
063571408,342,39,9,6,1,0,22,419
063571409,306,32,13,8,0,9,19,387
063571501,323,26,8,6,2,9,17,391
063571502,200,17,9,3,2,2,10,243
063571503,269,24,7,4,0,5,3,312
063571504,345,36,8,2,1,1,12,405
063571505,353,38,11,5,6,5,13,431
063571506,242,15,8,1,2,1,14,283
063571507,662,61,19,3,4,14,59,822
063571508,350,43,9,2,2,1,24,431
063571509,257,29,10,2,2,8,15,323
063571510,292,42,12,4,1,4,17,372
063571511,158,10,4,1,5,0,13,191
063571601,257,34,15,4,3,4,17,334
063571602,254,27,8,9,7,8,13,326
063571603,268,50,12,3,7,13,21,374
063571604,315,61,10,6,0,6,28,426
063571605,189,38,7,1,2,18,26,281
063571606,211,21,5,1,3,1,11,253
063571607,186,43,11,1,2,1,22,266
063571608,210,35,4,4,3,12,15,283
063571609,155,35,2,1,22,9,27,251
063571610,164,18,8,1,16,9,12,228
063571611,169,25,1,2,15,3,20,235
063571612,158,9,7,6,5,12,11,208
063571613,196,17,3,0,6,2,13,237
063571701,262,71,1,0,0,4,5,343
063571702,109,31,0,1,0,33,2,176
063571703,182,41,0,0,0,52,3,278
063571704,198,28,3,1,0,12,11,253
063571705,327,47,2,14,1,61,14,466
063571706,193,66,1,0,0,4,3,267
063571707,172,50,1,0,0,6,1,230
063571708,246,61,1,0,0,4,4,316
063571709,226,63,1,1,1,16,1,309
063571710,185,46,2,0,0,36,2,271
063571801,277,64,7,4,2,34,6,394
063571802,188,34,8,5,0,145,24,404
063571803,139,8,24,1,0,131,11,314
063571804,216,20,16,1,2,56,27,338
063571805,319,16,11,1,5,48,29,429
063571806,250,35,9,3,2,3,10,312
063571807,238,24,12,9,0,11,14,308
063571808,298,33,5,5,4,24,29,398
063571809,232,57,11,3,1,44,42,390
063571810,209,22,16,2,3,198,18,468
063571901,285,82,21,3,2,44,19,456
063571902,165,41,28,2,2,87,22,347
063571903,150,13,11,2,3,188,36,403
063571904,82,17,48,1,0,183,1,332
063571905,162,6,1,0,0,354,33,556
063571906,125,37,22,3,3,82,16,288
063571907,225,54,18,3,4,51,13,368
063571908,207,34,8,2,5,94,26,376
063571909,121,17,2,0,0,64,48,252
063571910,107,5,0,0,0,158,23,293
063571911,145,131,28,0,1,148,59,512
063572001,175,6,7,0,5,147,31,371
063572002,327,133,58,0,0,131,17,666
063572003,164,25,2,0,6,115,32,344
063572004,151,30,14,2,8,138,23,366
063572005,103,7,1,0,0,141,5,257
063572006,110,33,2,7,1,180,11,344
063572007,150,19,34,2,3,183,31,422
063572008,44,3,2,0,1,125,5,180
063572009,88,28,1,0,0,207,10,334
063572101,154,28,7,0,4,41,13,247
063572102,261,68,33,0,17,50,30,459
063572103,212,60,5,1,5,21,13,317
063572104,131,33,8,3,40,10,13,238
063572105,297,48,10,2,39,49,36,481
063572106,190,57,5,1,4,53,76,386
063572107,195,64,6,6,12,67,23,373
063572108,214,34,19,2,12,47,58,386
063572201,193,71,24,17,0,71,12,388
063572202,110,63,20,0,1,112,19,325
063572203,191,64,9,42,3,155,65,529
063572204,164,36,6,11,1,33,36,287
063572205,180,62,23,0,2,84,29,380
063572206,240,51,19,0,55,81,18,464
063572207,193,34,50,3,8,20,26,334
063572208,224,22,11,9,14,81,33,394
063572209,245,4,14,0,44,86,25,418
063572210,165,71,2,0,22,8,40,308
063572211,168,76,3,0,4,79,21,351
063572212,186,70,7,2,25,120,5,415
063572213,136,13,8,0,27,100,12,296
063572214,203,63,13,0,7,151,22,459
063572301,164,51,25,1,5,205,16,467
063572302,188,14,31,0,21,184,45,483
063572303,110,42,7,0,1,81,25,266
063572304,166,31,42,1,4,156,21,421
063572305,93,43,31,0,0,100,8,275
063572306,175,99,25,0,1,410,31,741
063572307,110,58,1,0,0,334,41,544
063572308,58,38,1,0,0,108,150,355
063572401,67,62,1,0,0,149,51,330
063572402,52,3,146,0,1,137,0,339
063572403,155,56,32,0,2,426,43,714
063572404,141,62,55,0,1,233,20,512
063572405,229,120,80,0,2,350,15,796
063572501,242,331,19,0,3,378,98,1071
063572502,239,439,8,0,1,367,21,1075
063572503,138,175,37,0,3,397,21,771
063572601,242,25,54,3,8,533,22,887
063572602,320,27,37,0,1,652,16,1053
063572603,263,124,3,0,0,272,78,740
063572604,269,91,61,0,1,193,139,754
063572701,175,131,11,0,0,153,39,509
063572702,180,60,49,2,4,135,36,466
063572703,236,132,62,0,1,253,11,695
063572704,162,42,6,0,4,291,10,515
063572705,239,196,80,0,0,257,66,838
063572801,238,77,41,1,2,507,28,894
063572802,133,87,138,0,3,265,22,648
063572803,159,11,23,0,20,331,6,550
063572804,129,32,76,2,56,114,8,417
063572805,198,27,60,0,31,207,58,581
063572806,174,87,37,0,1,296,15,610
063572901,148,84,8,0,1,176,18,435
063572902,109,62,35,0,3,60,36,305
063572903,126,14,25,0,1,240,9,415
063572904,201,34,12,0,47,216,82,592
063572905,46,17,5,0,1,16,31,116
063572906,273,156,254,1,0,67,19,770
063573001,170,72,22,0,32,129,31,456
063573002,157,7,22,0,42,124,32,384
063573003,77,18,2,0,3,45,5,150
063573004,181,70,13,0,10,116,5,395
063573005,157,23,6,0,33,65,6,290
063573006,236,103,2,0,2,12,32,387
063573007,128,81,0,0,3,30,40,282
063573008,110,35,13,0,0,25,5,188
063573009,210,37,2,1,3,128,57,438
063573010,159,58,45,0,52,56,18,388
063573011,205,60,123,0,2,182,19,591
063573101,270,82,32,0,110,54,12,560
063573102,212,22,24,3,44,76,11,392
063573103,176,36,21,0,17,31,39,320
063573104,104,7,13,1,10,68,11,214
063573105,204,12,29,3,4,74,84,410
063573106,186,23,3,1,8,120,30,371
063573107,291,79,48,0,5,144,55,622
063573108,253,30,115,0,1,107,54,560
063573109,257,160,13,0,4,193,20,647
063573201,242,68,8,6,11,13,26,374
063573202,253,38,4,17,29,10,44,395
063573203,235,41,3,2,13,19,32,345
063573204,310,65,25,0,9,40,10,459
063573205,137,42,4,0,2,31,1,217
063573206,218,41,5,0,22,20,37,343
063573207,225,46,9,3,13,25,50,371
063573208,117,24,8,1,22,25,17,214
063573209,251,45,8,0,4,21,21,350
063573210,197,67,3,0,6,25,31,329
063573301,264,9,6,3,10,16,26,334
063573302,326,4,24,20,7,30,31,442
063573303,301,39,2,4,14,4,32,396
063573304,303,25,10,3,47,24,33,445
063573305,268,26,8,0,20,30,42,394
063573306,224,30,27,1,23,33,17,355
063573307,274,42,10,1,9,84,16,436
063573308,240,15,11,48,29,69,15,427
063573309,180,2,13,2,7,54,5,263
063573310,136,12,9,2,16,47,22,244
063573311,165,3,11,2,20,40,9,250
063573401,172,19,4,1,8,34,10,248
063573402,196,29,2,0,20,15,21,283
063573403,150,25,1,1,4,35,26,242
063573404,362,43,24,0,4,323,28,784
063573405,174,36,14,1,27,14,9,275
063573406,158,35,1,0,12,127,7,340
063573407,187,25,27,1,7,67,20,334
063573408,95,12,11,0,2,60,43,223
063573501,254,39,71,0,0,408,47,819
063573502,312,104,19,0,2,394,97,928
063573503,153,12,28,0,0,143,28,364
063573504,195,32,30,1,0,144,25,427
063573505,269,32,44,2,3,101,5,456
063573506,216,60,31,4,10,72,11,404
063573507,229,45,9,0,8,136,21,448
063573508,268,81,2,1,2,213,89,656
063573509,237,48,24,0,5,208,54,576
063573510,132,80,30,0,0,92,28,362
063573601,245,65,12,0,3,247,6,578
063573602,260,22,21,0,5,380,28,716
063573603,172,23,24,0,0,288,62,569
063573604,247,129,63,0,4,428,65,936
063573605,55,37,4,0,1,118,32,247
063573701,208,108,15,3,9,141,10,494
063573702,218,26,50,0,0,342,13,649
063573703,203,121,6,30,3,54,31,448
063573704,143,136,2,0,0,105,12,398
063573705,213,30,46,0,3,258,101,651
063573706,168,158,20,1,0,223,31,601
063573707,159,46,16,1,1,170,48,441
063573708,125,26,14,0,5,74,21,265
063573801,234,22,42,0,1,647,56,1002
063573802,179,76,10,0,3,489,26,783
063573803,207,117,15,91,0,227,108,765
063573804,111,24,45,1,0,150,56,387
063573901,206,36,21,2,1,401,38,705
063573902,160,25,1,0,2,230,65,483
063573903,165,16,10,0,2,227,39,459
063573904,288,62,9,1,1,289,59,709
063573905,138,16,11,0,3,217,8,393
063573906,93,57,9,1,2,96,7,265
063573907,191,36,7,0,12,123,72,441
063573908,171,17,15,0,11,141,11,366
063573909,101,5,14,1,8,89,2,220
063574001,20,2,4,0,0,46,3,75
063574002,160,23,23,2,0,332,63,603
063574003,160,4,38,0,0,418,28,648
063574004,197,152,0,0,6,484,5,844
063574005,142,15,75,0,2,276,85,595
063574006,159,39,6,1,0,490,49,744
063574007,258,23,23,0,5,546,33,888
063574008,194,7,4,0,3,433,44,685
063574101,271,52,9,7,3,307,27,676
063574102,242,34,33,0,1,627,15,952
063574103,260,93,56,0,3,746,14,1172
063574104,205,243,181,0,4,316,51,1000
063574105,206,229,125,0,3,463,25,1051
063574106,60,18,0,0,0,221,3,302
063574107,115,205,1,1,2,99,38,461
063574201,163,94,18,0,0,387,10,672
063574202,128,3,4,2,8,182,32,359
063574203,92,48,1,0,1,99,24,265
063574204,68,12,8,1,0,124,7,220
063574205,135,55,0,0,1,145,43,379
063574206,168,11,24,0,3,235,4,445
063574207,93,66,4,6,32,17,15,233
063574301,80,17,1,0,1,246,15,360
063574302,86,5,29,1,5,95,4,225
063574303,106,4,6,24,3,249,2,394
063574304,161,28,5,5,0,162,15,376
063574305,55,7,32,0,1,196,5,296
063574306,97,29,2,1,2,136,17,284
063574307,134,32,3,2,0,138,30,339
063574308,47,9,2,6,1,194,6,265
063574309,102,9,6,0,1,211,16,345
063574310,96,1,42,0,1,385,33,558
063574311,81,10,0,1,1,150,3,246
063574312,91,8,1,0,0,259,4,363
063574401,25,10,0,0,1,7,8,51
063574402,73,14,16,0,13,9,6,131
063574403,230,48,12,2,2,15,20,329
063574404,232,41,1,8,4,35,13,334
063574405,207,22,52,6,9,108,32,436
063574406,111,14,42,0,6,266,13,452
063574407,146,43,5,2,3,157,15,371
063574408,122,33,8,4,3,24,35,229
063574409,83,11,36,0,1,141,6,278
063574501,170,1,8,0,8,19,21,227
063574502,184,1,13,0,16,21,34,269
063574503,222,0,5,1,15,38,52,333
063574504,222,4,8,1,9,32,12,288
063574505,147,1,4,5,9,42,34,242
063574506,305,5,21,0,15,88,36,470
063574507,271,2,7,6,34,42,51,413
063574508,266,7,9,11,35,19,12,359
063574509,325,3,9,6,4,21,23,391
063574510,274,4,11,6,2,48,11,356
063574511,126,0,21,1,1,188,39,376
063574512,134,0,1,1,0,145,5,286
063574513,74,0,1,0,0,153,3,231
063574514,97,0,0,2,6,52,29,186
063574515,162,1,0,18,0,204,17,402
063574516,266,29,40,2,5,212,58,612
063574601,177,16,8,0,17,22,5,245
063574602,170,32,5,1,12,6,4,230
063574603,237,68,10,5,19,29,13,381
063574604,144,33,15,0,14,3,6,215
063574605,280,6,32,4,30,36,19,407
063574606,299,62,20,2,17,6,14,420
063574607,194,22,5,1,17,9,14,262
063574608,194,29,7,3,13,10,25,281
063574609,270,46,10,1,6,7,25,365
063574610,245,37,6,2,6,2,18,316
063574611,243,26,4,5,11,7,14,310
063574612,245,49,4,5,4,15,19,341
063574613,194,49,10,6,12,14,27,312
063574701,312,34,4,3,3,5,24,385
063574702,276,29,7,3,7,3,20,345
063574703,309,39,14,6,7,6,12,393
063574704,260,35,8,4,9,4,9,329
063574705,344,39,10,3,19,8,41,464
063574706,185,43,19,0,5,7,14,273
063574707,168,37,3,5,6,2,9,230
063574708,283,36,16,2,20,15,49,421
063574709,293,33,10,0,8,12,15,371
063574710,309,64,20,1,12,4,24,434
063574801,353,51,6,7,6,2,22,447
063574802,318,28,6,5,2,1,9,369
063574803,291,45,14,2,7,2,13,374
063574804,144,16,1,1,0,0,10,172
063574805,203,13,9,5,0,0,4,234
063574806,151,26,3,5,2,6,13,206
063574807,197,19,7,1,2,4,13,243
063574808,196,13,5,1,2,0,19,236
063574809,168,21,7,2,2,2,9,211
063574810,319,47,20,6,10,12,15,429
063574811,294,26,6,1,6,4,31,368
063574812,187,18,7,0,4,3,12,231
063574813,191,20,8,1,0,3,11,234
063574814,231,26,4,5,2,2,8,278
063574815,204,34,15,2,1,6,6,268
063574901,227,28,6,1,0,8,9,279
063574902,305,29,12,1,2,6,15,370
063574903,220,29,3,0,2,2,25,281
063574904,221,12,7,4,2,9,40,295
063574905,282,48,8,5,3,10,30,386
063574906,241,44,9,3,10,4,32,343
063574907,287,46,14,4,12,15,15,393
063574908,237,39,6,4,9,3,26,324
063575001,246,26,10,4,4,1,16,307
063575002,298,35,8,2,6,1,19,369
063575003,297,37,6,4,7,1,16,368
063575004,340,39,5,2,2,1,14,403
063575005,344,22,11,2,6,0,13,398
063575006,342,30,12,3,1,1,14,403
063575007,349,19,10,5,8,1,23,415
063575008,520,33,0,0,0,0,10,563
063575009,602,25,2,1,0,0,10,640
063575010,204,20,4,1,7,3,13,252
063575011,152,26,2,0,1,0,3,184
063575012,332,19,6,2,4,4,22,389
063575013,186,7,6,2,1,1,17,220
063575014,187,17,10,5,2,2,18,241
063575101,224,14,3,6,3,1,30,281
063575102,281,28,3,6,4,3,32,357
063575103,354,17,5,3,0,0,23,402
063575104,275,33,2,2,0,4,23,339
063575105,295,20,2,4,0,4,6,331
063575106,273,13,10,7,0,0,19,322
063575107,357,13,6,3,1,2,1,383
063575108,266,8,2,3,1,0,6,286
063575109,396,46,3,3,0,4,9,461
063575201,416,18,3,2,1,3,9,452
063575202,365,10,2,5,1,1,6,390
063575203,374,32,3,2,0,1,13,425
063575204,378,17,11,2,0,1,7,416
063575205,265,17,2,2,0,0,2,288
063575206,236,16,3,3,0,0,1,259
063575207,349,33,2,5,2,0,10,401
063575208,229,14,1,0,1,1,5,251
063575209,238,15,0,0,0,0,11,264
063575210,452,8,6,5,0,0,6,477
063575211,349,12,1,6,1,0,4,373
063575212,305,13,3,5,1,0,6,333
063575213,288,21,1,2,0,0,2,314
063575214,365,15,2,4,0,0,8,394
063575215,410,13,3,4,0,0,16,446
063575216,424,23,1,6,1,0,8,463
063575301,308,19,8,2,2,2,16,357
063575302,312,18,0,4,1,2,11,348
063575303,366,30,11,5,1,5,18,436
063575304,274,17,8,1,6,8,20,334
063575305,256,22,2,3,0,6,13,302
063575306,244,25,1,5,2,17,11,305
063575307,366,36,0,7,1,1,16,427
063575308,324,22,8,3,1,1,4,363
063575309,394,32,4,10,1,2,17,460
063575310,362,11,7,8,0,17,8,413
063575311,316,25,1,1,1,1,3,348
063575312,317,10,2,85,2,2,19,437
063575313,245,13,2,3,1,3,4,271
063575314,210,21,1,2,0,1,4,239
063575315,265,9,0,2,0,1,2,279
063575316,243,12,2,6,0,1,5,269
063575401,283,22,7,1,0,1,10,324
063575402,298,15,0,0,0,2,4,319
063575403,353,8,9,0,0,0,26,396
063575404,384,54,3,4,3,2,13,463
063575405,271,32,5,1,3,0,8,320
063575406,242,37,5,0,1,1,3,289
063575407,236,14,5,4,2,4,8,273
063575408,228,14,3,3,1,0,8,257
063575501,183,21,7,3,1,3,9,227
063575502,268,4,6,5,4,1,19,307
063575503,355,53,22,2,8,3,22,465
063575504,414,61,14,2,0,0,20,511
063575505,175,15,3,2,6,0,6,207
063575506,250,4,7,1,2,3,3,270
063575507,219,9,9,4,0,3,3,247
063575508,424,5,9,7,0,3,54,502
063575601,315,6,7,3,3,3,22,359
063575602,326,16,5,7,2,4,10,370
063575603,305,22,10,2,1,3,26,369
063575604,368,21,11,5,21,9,15,450
063575605,285,24,12,4,15,7,9,356
063575606,264,14,3,1,13,7,28,330
063575607,330,11,15,2,6,4,18,386
063575608,314,16,8,4,4,4,29,379
063575609,276,15,9,2,4,7,5,318
063575610,152,13,1,2,6,2,9,185
063575611,383,13,22,1,7,8,19,453
063575612,281,26,10,1,13,5,8,344
063575701,447,7,8,3,0,9,14,488
063575702,339,28,4,2,1,7,23,404
063575703,266,2,12,2,5,0,14,301
063575704,395,26,18,8,4,3,13,467
063575705,210,5,4,6,0,0,4,229
063575706,317,22,9,1,1,0,7,357
063575707,219,17,8,1,0,3,8,256
063575708,195,20,8,0,0,0,14,237
063575709,371,23,6,3,8,5,18,434
063575710,222,15,4,3,0,0,19,263
063575801,268,24,7,9,4,3,6,321
063575802,275,29,16,2,2,0,19,343
063575803,276,39,2,1,6,2,5,331
063575804,286,23,8,3,1,2,23,346
063575805,339,39,4,2,0,5,3,392
063575806,334,40,2,1,3,4,12,396
063575807,278,17,5,2,7,2,11,322
063575808,410,17,5,1,1,3,17,454
063575901,347,32,18,0,1,3,55,456
063575902,293,19,9,0,9,29,32,391
063575903,236,45,9,4,9,6,6,315
063575904,286,42,12,2,6,4,20,372
063575905,275,28,10,4,4,6,18,345
063575906,401,32,17,11,4,18,11,494
063575907,299,22,4,2,1,5,7,340
063575908,297,19,8,5,2,8,34,373
063575909,171,23,4,2,0,0,17,217
063575910,173,19,10,3,2,5,22,234
063575911,309,28,10,7,1,8,22,385
063576001,309,41,8,4,1,4,8,375
063576002,223,18,9,2,0,4,16,272
063576003,289,38,12,0,3,4,17,363
063576004,196,15,7,2,3,2,16,241
063576005,269,27,9,3,0,1,5,314
063576006,332,31,6,3,2,5,14,393
063576007,310,41,7,8,3,0,16,385
063576008,229,19,6,3,0,2,8,267
063576009,206,20,1,2,1,1,5,236
063576010,238,15,3,2,0,0,14,272
063576011,229,18,3,1,1,0,6,258
063576101,295,50,14,4,2,7,4,376
063576102,374,43,8,3,0,10,9,447
063576103,158,30,8,2,4,4,9,215
063576104,214,25,7,4,3,3,20,276
063576105,280,29,4,3,0,2,6,324
063576106,364,46,4,6,3,17,14,454
063576107,139,24,1,4,1,23,5,197
063576108,11,2,0,0,0,0,0,13
063576109,198,27,3,2,0,2,11,243
063576110,319,28,17,2,0,56,29,451
063576111,197,15,11,1,0,14,3,241
063576112,84,1,7,0,0,0,1,93
063576113,238,36,37,1,1,42,17,372
063576201,314,41,14,3,5,3,20,400
063576202,184,4,3,2,0,4,4,201
063576203,168,24,18,5,0,3,13,231
063576204,283,26,0,4,2,15,14,344
063576205,271,16,10,3,2,10,23,335
063576206,254,36,8,2,15,5,15,335
063576207,223,14,10,2,1,3,29,282
063576208,181,20,3,2,17,0,11,234
063576209,259,52,11,1,10,14,4,351
063576210,101,0,18,1,16,4,44,184
063576211,211,32,8,5,25,6,36,323
063576301,4,1,0,0,0,0,0,5
063576302,54,29,10,2,0,110,72,277
063576303,69,17,23,1,1,182,19,312
063576304,118,4,13,2,1,189,14,341
063576305,131,17,32,5,3,215,43,446
063576306,59,27,7,2,0,175,4,274
063576307,56,13,25,0,1,169,5,269
063576308,79,22,16,2,2,297,6,424
063576309,55,5,10,3,0,199,48,320
063576401,345,27,12,17,0,2,17,420
063576402,344,16,8,18,3,11,19,419
063576403,199,22,6,17,0,23,6,273
063576404,219,18,4,16,2,22,5,286
063576405,200,23,16,21,2,41,2,305
063576406,142,8,9,8,0,74,27,268
063576407,166,12,12,8,0,132,26,356
063576408,137,12,18,5,0,159,1,332
063576409,78,89,30,1,1,57,1,257
063576410,63,10,13,0,2,95,24,207
063576411,117,73,31,1,0,229,12,463
063576501,177,15,7,2,1,4,11,217
063576502,221,18,11,3,6,28,10,297
063576503,3,0,0,0,0,0,0,3
063576504,321,41,7,9,0,49,28,455
063576505,202,9,1,3,1,21,10,247
063576506,193,14,10,5,0,37,13,272
063576507,246,19,4,12,0,26,11,318
063576508,286,25,19,19,1,45,10,405
063576509,249,40,19,7,0,154,4,473
063576510,184,29,10,0,3,48,4,278
063576511,186,25,15,2,1,51,17,297
063576512,200,59,30,7,1,88,22,407
063576513,68,98,2,1,0,54,9,232
063576514,94,36,22,1,0,177,7,337
063576601,274,19,2,3,1,1,23,323
063576602,278,15,0,4,2,2,11,312
063576603,387,16,9,0,3,1,14,430
063576604,333,26,6,1,3,6,18,393
063576605,258,20,3,4,1,0,5,291
063576606,246,7,7,13,1,1,10,285
063576607,259,10,3,4,0,8,15,299
063576608,198,16,5,2,4,3,9,237
063576701,184,19,6,0,0,4,6,219
063576702,210,17,3,1,9,2,8,250
063576703,303,26,9,4,4,4,11,361
063576704,287,14,6,3,0,2,8,320
063576705,308,13,5,5,0,3,4,338
063576706,228,17,1,4,0,1,8,259
063576707,379,25,2,1,3,2,5,417
063576708,233,19,0,2,0,1,4,259
063576709,276,10,3,2,0,1,3,295
063576710,323,16,4,7,0,4,3,357
063576711,343,24,4,3,3,0,8,385
063576712,308,0,4,3,1,9,19,344
063576713,183,1,1,0,0,0,2,187
063576714,184,10,3,3,0,3,2,205
063576715,330,18,1,0,0,0,1,350
063576801,410,22,2,3,0,1,6,444
063576802,379,26,2,0,1,2,4,414
063576803,226,22,1,0,0,0,2,251
063576804,178,7,0,5,1,2,1,194
063576805,172,12,1,1,0,3,6,195
063576806,243,14,4,3,0,4,10,278
063576807,262,23,2,1,0,0,3,291
063576808,225,10,4,4,9,2,11,265
063576809,242,11,2,6,5,2,6,274
063576810,307,14,3,4,1,1,6,336
063576901,209,27,1,8,1,3,0,249
063576902,221,23,7,2,1,2,7,263
063576903,176,10,5,0,3,0,5,199
063576904,245,19,4,0,0,0,8,276
063576905,212,15,9,0,2,0,6,244
063576906,276,11,2,1,0,0,9,299
063576907,350,18,0,2,0,2,7,379
063576908,268,15,7,2,1,0,3,296
063576909,272,10,1,2,0,1,5,291
063576910,289,14,4,3,0,0,3,313
063576911,176,14,6,7,0,1,10,214
063577001,233,18,1,2,0,1,18,273
063577002,302,26,5,4,0,3,9,349
063577003,433,41,8,3,5,0,15,505
063577004,407,34,4,2,0,6,9,462
063577005,201,20,3,0,0,0,7,231
063577006,243,18,4,0,0,1,7,273
063577007,353,12,9,7,3,2,21,407
063577008,351,25,4,2,1,4,11,398
063577009,224,3,1,2,1,2,6,239
063577010,192,16,1,2,0,2,4,217
063577011,221,7,3,4,0,0,6,241
063577012,178,17,3,0,2,0,5,205
063577013,259,4,4,1,0,0,2,270
063577014,264,19,2,0,0,1,6,292
063577101,213,12,5,1,0,0,13,244
063577102,262,16,3,6,3,0,9,299
063577103,375,19,3,5,2,9,24,437
063577104,374,35,3,1,0,2,9,424
063577105,249,29,6,3,0,1,4,292
063577106,296,24,10,40,0,1,21,392
063577107,287,15,2,1,2,4,10,321
063577108,395,26,11,6,0,6,11,455
063577109,399,34,2,2,0,7,20,464
063577110,263,5,2,0,0,0,12,282
063577111,367,18,1,8,0,0,7,401
063577201,276,18,1,2,0,0,2,299
063577202,299,3,1,4,0,0,7,314
063577203,216,11,0,3,0,0,6,236
063577204,309,10,0,3,0,3,6,331
063577205,320,22,4,0,0,0,8,354
063577206,288,18,0,3,0,2,5,316
063577207,323,12,3,1,0,1,3,343
063577208,172,19,1,0,0,5,22,219
063577209,358,15,2,10,1,4,11,401
063577210,387,17,7,11,3,1,17,443
063577211,338,34,2,0,1,1,2,378
063577301,67,9,0,0,1,3,16,96
063577302,359,41,6,12,2,4,24,448
063577303,12,5,0,0,0,0,0,17
063577304,60,3,0,0,0,0,4,67
063577305,336,6,0,30,0,14,18,404
063577306,342,25,1,2,0,1,7,378
063577307,70,0,0,13,0,9,3,95
063577308,142,5,0,2,0,5,9,163
063577309,153,13,2,2,0,3,12,185
063577310,3,0,0,0,0,0,2,5
063577311,109,3,3,10,1,67,7,200
063577312,73,11,2,18,1,42,13,160
063577401,330,52,23,0,1,20,39,465
063577402,294,25,0,3,1,1,12,336
063577403,216,9,5,4,0,7,15,256
063577404,269,6,2,8,0,3,8,296
063577405,214,13,2,10,0,0,8,247
063577406,370,18,1,16,0,0,15,420
063577407,220,35,5,3,0,1,5,269
063577408,247,27,5,17,0,19,6,321
063577409,171,11,6,22,0,19,15,244
063577410,177,5,5,14,0,29,0,230
063577411,128,26,4,3,1,33,5,200
063577412,162,12,2,7,0,47,20,250
063577413,202,56,15,9,4,37,35,358
063577414,308,23,21,19,0,50,15,436
063577415,175,12,9,24,0,44,16,280
063577416,153,19,4,11,0,54,10,251
063577417,189,44,11,31,0,26,7,308
063577418,174,28,11,18,0,33,14,278
063577501,146,6,40,4,1,153,15,365
063577502,68,71,17,0,0,78,62,296
063577503,26,1,10,4,0,137,39,217
063577504,115,1,1,12,0,78,32,239
063577505,64,41,7,3,0,104,57,276
063577506,123,8,9,7,0,157,6,310
063577507,187,31,14,17,0,96,11,356
063577508,135,8,21,16,3,115,2,300
063577509,81,28,20,5,0,97,12,243
063577510,73,43,23,5,0,22,19,185
063577511,112,38,12,6,2,72,22,264
063577512,146,13,16,13,0,63,21,272
063577513,144,10,4,13,1,66,26,264
063577514,88,19,10,4,1,71,8,201
063577515,74,16,0,4,0,49,24,167
063577516,58,35,4,1,0,60,1,159
063577601,94,11,0,8,1,14,3,131
063577602,151,26,6,4,0,52,8,247
063577603,53,3,4,7,0,88,2,157
063577604,101,5,21,9,2,156,7,301
063577605,90,46,25,2,1,56,40,260
063577606,45,0,2,3,2,75,15,142
063577607,91,8,35,3,0,163,39,339
063577608,128,76,5,8,1,166,14,398
063577609,136,4,0,0,0,126,58,324
063577610,234,31,6,7,1,117,47,443
063577611,108,14,8,7,0,41,14,192
063577612,87,25,2,6,0,87,11,218
063577613,75,15,11,16,0,117,12,246
063577614,49,4,2,6,1,182,4,248
063577615,77,43,5,1,2,71,1,200
063577616,78,1,5,12,0,92,4,192
063577617,62,12,4,10,0,57,14,159
063577701,193,13,1,6,0,1,3,217
063577702,181,10,1,5,0,2,1,200
063577703,58,8,0,1,0,0,4,71
063577704,43,8,0,0,0,7,10,68
063577705,51,14,0,0,1,2,15,83
063577706,21,0,0,0,1,3,3,28
063577707,55,2,0,3,0,68,7,135
063577708,41,4,1,12,0,76,5,139
063577709,128,23,4,8,0,160,10,333
063577710,74,4,11,4,0,127,59,279
063577711,60,18,12,10,1,53,3,157
063577712,56,7,10,6,0,45,22,146
063577713,49,5,2,4,0,79,8,147
063577714,63,23,9,10,0,74,19,198
063577715,48,8,14,8,0,71,34,183
063577716,65,18,9,6,0,207,9,314
063577717,34,23,16,13,0,128,24,238
063577718,40,19,2,8,0,132,27,228
063577801,12,7,0,0,0,4,0,23
063577802,157,7,0,11,0,4,2,181
063577803,106,4,6,4,2,1,3,126
063577804,283,11,1,22,0,0,8,325
063577805,255,13,2,11,1,3,13,298
063577806,46,8,0,0,2,3,8,67
063577807,104,9,0,2,1,2,8,126
063577808,198,39,4,15,0,25,27,308
063577809,221,8,4,1,0,0,10,244
063577810,285,13,0,4,0,0,5,307
063577811,316,26,0,4,2,0,2,350
063577812,398,25,2,4,1,0,9,439
063577813,254,8,3,3,0,0,22,290
063577814,323,5,0,1,1,1,7,338
063577815,180,7,3,2,0,2,6,200
063577816,196,5,1,1,0,0,5,208
063577901,2,2,0,0,0,0,0,4
063577902,278,24,9,12,0,20,6,349
063577903,82,7,0,0,0,8,13,110
063577904,224,16,1,4,0,1,16,262
063577905,221,18,1,6,2,1,15,264
063577906,213,12,0,0,0,0,2,227
063577907,177,14,1,2,0,0,4,198
063577908,296,39,1,6,2,1,12,357
063577909,363,50,0,7,0,0,25,445
063577910,216,3,0,26,1,1,7,254
063577911,157,8,1,3,1,2,3,175
063577912,219,21,1,0,6,0,4,251
063577913,335,19,1,19,1,2,17,394
063577914,399,30,8,1,2,0,10,450
063577915,525,11,3,4,2,1,10,556
063577916,40,7,0,2,0,2,7,58
063577917,42,0,1,0,3,1,2,49
063578001,316,26,3,18,1,17,16,397
063578002,240,31,11,3,2,8,27,322
063578003,269,17,3,4,0,11,15,319
063578004,281,17,2,4,0,3,9,316
063578005,379,45,4,13,0,11,20,472
063578006,316,29,4,7,0,6,13,375
063578007,160,17,1,2,0,6,10,196
063578008,173,16,1,5,0,3,4,202
063578009,127,6,4,1,0,9,8,155
063578010,110,6,7,8,0,29,13,173
063578011,140,46,1,5,0,20,3,215
063578012,98,13,1,2,1,18,14,147
063578013,152,8,3,3,0,24,2,192
063578014,135,4,0,1,0,16,20,176
063578015,3,0,0,0,0,0,1,4
063578016,224,7,3,3,1,21,54,313
063578017,140,0,3,2,0,6,74,225
063578018,98,11,1,5,0,19,43,177
063578101,95,10,0,0,0,2,11,118
063578102,18,2,0,0,0,7,6,33
063578103,10,1,0,0,0,0,0,11
063578104,73,19,1,4,0,11,3,111
063578105,67,7,0,0,1,8,10,93
063578106,137,14,2,3,1,12,6,175
063578107,122,18,8,6,0,15,5,174
063578108,145,17,9,21,0,10,22,224
063578109,153,17,3,2,0,6,9,190
063578110,160,17,1,14,0,5,10,207
063578111,167,18,3,15,0,25,2,230
063578112,165,20,8,9,2,1,12,217
063578113,126,8,1,6,0,3,14,158
063578114,333,18,3,8,0,3,8,373
063578201,35,3,0,0,0,0,16,54
063578202,41,10,1,6,1,40,3,102
063578203,225,31,6,12,1,22,34,331
063578204,175,15,0,9,1,3,15,218
063578205,265,13,1,3,1,20,48,351
063578206,195,27,0,17,1,15,17,272
063578207,78,18,6,3,0,51,4,160
063578208,90,48,3,14,0,42,13,210
063578209,67,7,3,6,0,59,24,166
063578210,71,22,7,13,0,17,4,134
063578211,151,63,9,20,2,62,2,309
063578212,144,58,12,18,0,87,16,335
063578213,120,16,1,0,0,1,0,138
063578301,86,4,0,0,0,9,26,125
063578302,136,6,2,3,2,10,6,165
063640101,320,17,6,12,0,4,5,364
063640102,199,6,12,7,1,3,3,231
063640103,329,16,7,8,0,3,10,373
063640104,258,16,3,10,0,4,4,295
063640105,297,18,13,7,1,0,7,343
063640106,271,1,5,11,0,4,5,297
063640107,211,16,1,3,1,6,0,238
063640108,247,7,2,0,0,1,4,261
063640109,239,6,3,18,1,2,2,271
063640110,236,13,0,3,0,6,9,267
063640111,263,8,8,3,1,1,10,294
063640112,180,9,6,1,0,8,5,209
063640113,195,2,3,4,1,3,6,214
063640114,385,5,15,6,0,0,12,423
063640115,189,24,10,9,9,2,12,255
063640116,197,8,6,4,30,3,12,260
063640117,187,5,11,7,5,2,13,230
063640118,201,15,2,5,23,0,11,257
063640119,366,22,4,16,7,1,18,434
063640201,153,13,4,4,0,70,11,255
063640202,193,9,4,8,2,12,11,239
063640203,350,177,1,6,1,84,24,643
063640204,79,21,0,14,1,1,11,127
063640205,273,26,7,12,0,105,10,433
063640206,175,8,3,2,0,46,3,237
063640207,320,2,8,11,0,1,6,348
063640208,205,10,1,0,0,0,3,219
063640209,165,9,2,5,0,3,6,190
063640210,271,25,8,7,1,16,24,352
063640211,114,15,0,5,1,13,19,167
063640212,97,2,6,3,1,40,16,165
063640213,139,17,2,7,1,53,6,225
063640214,114,44,3,3,0,39,0,203
063640301,208,1,1,11,0,41,14,276
063640302,249,11,6,13,1,5,10,295
063640303,224,8,3,22,0,4,13,274
063640304,196,6,0,10,0,4,5,221
063640305,185,4,2,5,0,5,2,203
063640306,294,48,7,10,0,29,13,401
063640307,440,17,8,6,0,1,11,483
063640308,286,19,5,7,0,0,11,328
063640309,131,11,2,1,1,3,4,153
063640310,155,2,3,10,1,6,10,187
063640311,135,2,0,125,0,0,197,459
063640312,236,13,13,76,0,0,21,359
063640313,101,19,0,85,0,0,91,296
063640314,0,0,0,0,0,0,213,213
063640315,166,14,0,1,0,0,100,281
063640316,0,0,0,15,0,0,302,317
063640317,66,16,0,18,1,12,25,138
063640318,279,15,6,2,0,0,8,310
063640401,357,7,2,8,1,5,15,395
063640402,124,13,0,10,1,7,15,170
063640403,338,25,1,10,1,1,9,385
063640404,117,7,2,8,0,1,1,136
063640405,323,7,0,12,1,7,7,357
063640406,212,13,3,6,0,4,4,242
063640407,176,10,6,6,1,8,14,221
063640408,195,8,0,9,0,2,4,218
063640409,239,5,6,8,1,12,6,277
063640410,243,9,1,13,1,1,16,284
063640411,161,5,1,4,0,1,11,183
063640412,211,29,2,7,0,3,4,256
063640413,189,8,3,3,0,26,11,240
063640414,47,1,0,0,1,1,1,51
063640501,89,22,0,14,0,12,19,156
063640502,18,2,0,0,0,9,0,29
063640503,15,0,0,0,2,5,1,23
063640504,99,3,0,1,0,3,2,108
063640601,12,0,0,0,0,2,1,15
063640602,12,1,0,0,0,6,16,35
063640603,24,0,0,14,0,45,0,83
063640604,17,0,0,0,0,10,8,35
063640701,250,31,1,2,0,17,5,306
063640702,244,14,7,6,0,14,27,312
063640703,226,1,5,7,0,29,25,293
063640704,321,16,2,3,3,4,42,391
063640705,259,9,1,1,3,1,11,285
063640706,298,40,15,4,11,1,35,404
063640707,242,10,12,6,6,0,8,284
063640708,247,16,10,5,2,0,15,295
063640709,382,21,9,4,1,3,19,439
063640710,180,35,35,8,1,2,10,271
063640711,203,19,5,3,1,1,6,238
063640712,415,21,8,6,6,1,16,473
063640713,274,20,7,8,1,2,12,324
063640714,266,16,5,2,0,0,6,295
063640715,218,11,3,1,1,2,8,244
063640716,179,4,3,9,0,5,9,209
063640717,153,10,15,10,1,6,4,199
063640801,138,12,0,26,0,51,13,240
063640802,147,15,1,2,0,3,18,186
063640803,153,15,2,6,0,13,12,201
063640804,133,13,1,6,0,13,16,182
063640805,248,5,4,12,0,21,8,298
063640806,182,14,0,8,2,18,13,237
063640807,80,18,1,9,0,15,14,137
063640808,84,28,2,4,0,11,5,134
063640809,252,10,4,14,0,6,15,301
063640810,276,14,1,14,1,18,8,332
063640811,158,8,3,1,0,5,3,178
063640812,149,4,0,17,5,5,6,186
063640813,251,20,3,25,1,21,5,326
063640814,172,21,0,8,0,32,16,249
063640815,185,1,15,12,2,11,2,228
063640816,214,14,11,8,4,50,29,330
063640817,236,17,3,4,5,8,10,283
063640818,253,4,6,5,0,9,15,292
063640819,256,14,2,13,2,7,11,305
063640820,188,6,3,3,0,7,17,224
063640821,155,16,0,2,0,1,5,179
063640822,169,17,3,24,0,7,3,223
063640823,301,17,5,8,0,36,17,384
063850101,247,29,1,7,0,2,21,307
063850102,14,10,0,0,0,1,11,36
063850103,15,1,0,0,0,11,24,51
063850104,1,3,0,0,0,1,6,11
063850105,9,2,0,0,0,1,5,17
063850106,179,19,2,0,2,5,7,214
063850107,224,29,1,6,0,0,4,264
063850201,117,10,2,4,0,2,16,151
063850202,12,0,0,0,0,5,19,36
063850203,20,0,0,1,0,11,7,39
063850204,11,0,0,0,0,9,8,28
063850301,6,0,1,0,1,0,7,15
063850302,8,3,0,0,0,2,17,30
063850303,11,2,0,0,0,5,15,33
063850401,62,0,0,0,2,8,27,99
063850402,18,0,0,0,0,1,14,33
063850403,13,1,0,0,0,7,7,28
063850404,10,0,0,0,0,3,2,15
063850405,5,0,0,0,0,1,19,25
063850501,7,0,0,0,1,9,11,28
063850601,19,0,0,0,0,11,12,42
063850701,314,17,2,4,1,2,17,357
063850702,286,17,3,10,2,2,9,329
063850703,202,11,8,7,0,1,9,238
063850704,298,6,3,4,0,3,14,328
063850705,302,15,3,4,5,5,53,387
063850706,204,19,2,10,0,2,13,250
063850707,324,26,7,2,7,4,16,386
063850708,305,35,1,6,3,1,20,371
063850709,261,22,6,12,0,4,16,321
063850710,256,17,3,11,0,0,21,308
063850711,208,14,9,4,1,2,10,248
063850712,47,25,0,0,0,0,1,73
063850713,239,17,0,8,5,5,9,283
063850714,274,15,4,1,0,4,32,330
063850715,259,23,3,7,0,3,11,306
063850716,212,18,5,0,2,1,12,250
063850717,211,15,7,3,0,1,4,241
063850718,53,2,0,1,1,4,6,67
063850801,31,0,0,0,0,16,18,65
063850802,18,2,0,0,0,1,8,29
063850901,30,0,0,0,0,4,2,36
063850902,25,3,0,0,0,0,1,29
063851001,312,8,0,0,0,5,4,329
063851002,459,41,1,9,2,47,44,603
063851101,15,8,0,0,0,10,2,35
063851102,19,2,0,0,0,5,24,50
063920101,224,16,1,29,4,3,6,283
063920102,432,30,7,7,1,2,10,489
063920103,214,16,7,3,3,1,16,260
063920104,208,18,5,2,7,0,18,258
063920105,355,40,8,4,7,0,13,427
063920106,385,35,15,9,7,0,7,458
063920107,311,20,8,6,4,0,13,362
063920108,316,20,10,7,1,1,13,368
063920109,360,29,3,17,1,0,31,441
063920110,298,17,11,29,1,3,4,363
063920111,240,19,5,8,1,1,6,280
063920112,288,13,4,2,5,2,11,325
063920113,303,19,1,1,0,0,5,329
063920114,295,10,2,19,0,3,8,337
063920115,248,32,3,14,0,0,10,307
063920116,201,18,8,7,2,2,3,241
063920201,19,3,0,0,0,0,11,33
063920202,19,3,0,0,0,0,2,24
063920203,14,3,0,0,0,0,1,18
063920204,6,1,0,0,0,0,0,7
063920301,255,16,2,14,0,0,9,296
063920302,9,0,0,0,0,0,17,26
063920303,18,0,0,0,0,0,5,23
063920304,6,0,0,0,0,5,6,17
063920305,21,3,0,0,0,3,16,43
063920306,29,5,0,3,0,0,15,52
063920401,123,19,4,0,0,1,11,158
063920402,12,0,0,0,0,2,20,34
063920403,22,5,0,0,0,3,6,36
063920404,6,3,0,0,0,0,5,14
063920405,11,16,0,0,0,2,3,32
063920501,6,5,0,0,1,0,0,12
063920502,23,1,0,0,0,0,13,37
063920503,11,4,0,0,0,0,3,18
063920504,8,0,0,0,0,0,18,26
063920505,1,10,0,0,0,0,0,11
063920601,93,4,3,1,5,2,20,128
063920602,23,5,0,0,0,0,9,37
063920603,7,0,0,0,0,0,21,28
063920604,26,3,0,0,0,1,6,36
063920605,54,13,0,1,0,5,25,98
063920701,12,0,0,0,0,0,16,28
063920702,202,12,2,8,2,3,19,248
063920703,57,3,1,0,0,5,21,87
063920704,17,16,0,0,0,0,4,37
063920705,107,10,1,3,0,0,4,125
063920706,118,7,2,0,0,0,4,131
063920707,111,6,7,3,0,0,5,132
063920708,148,8,2,3,0,1,2,164
063920709,23,4,0,0,0,1,8,36
063920710,24,17,3,2,0,4,5,55
063920801,252,25,6,4,0,0,6,293
063920802,31,2,0,0,0,1,15,49
063920803,42,4,0,0,0,0,25,71
063920804,17,0,0,0,0,2,28,47
063920805,27,3,0,0,0,2,13,45
063920806,371,27,0,6,0,4,11,419
063920901,304,17,8,11,5,2,11,358
063920902,77,9,1,4,0,0,6,97
063920903,102,19,0,1,0,4,21,147
063920904,35,0,0,0,0,3,9,47
063920905,20,1,0,0,0,5,5,31
063920906,127,7,7,6,5,2,5,159
063920907,177,18,5,7,0,1,7,215
063921001,18,14,0,0,0,0,10,42
063921002,10,5,0,0,0,2,3,20
063921003,6,5,0,0,0,0,0,11
063921004,19,8,0,0,0,1,4,32
063921005,46,5,0,0,0,10,12,73
063921006,8,3,0,0,0,0,4,15
063921101,9,5,0,0,0,0,1,15
063921102,20,2,0,0,0,0,2,24
063921103,2,1,0,0,0,5,0,8
063921201,277,11,0,4,0,0,4,296
063921202,276,10,2,2,1,0,6,297
063921203,296,35,1,7,0,0,4,343
063921204,42,6,0,0,0,1,6,55
063921205,16,1,0,0,0,2,12,31
063921206,245,27,1,6,1,6,3,289
063921207,103,7,1,4,2,6,10,133
063921208,19,2,0,0,0,0,0,21
063921209,18,1,0,3,0,3,0,25
063921301,24,2,0,2,1,3,12,44
063921302,25,18,0,0,0,13,6,62
063921303,26,8,0,0,2,3,1,40
063921401,17,1,0,2,0,1,11,32
063921402,10,3,0,0,0,0,4,17
063921403,2,0,0,0,0,0,5,7
063921404,10,5,0,1,0,3,2,21
063921501,212,25,2,6,1,1,10,257
063921502,214,18,2,9,1,0,6,250
063921503,58,8,0,0,0,2,3,71
063921504,23,2,0,0,0,2,2,29
063921505,12,3,0,1,1,7,0,24
063921506,145,24,0,0,1,2,33,205
063921507,11,0,0,0,0,0,11,22
063990101,275,29,6,3,2,3,16,334
063990102,230,25,4,3,1,2,9,274
063990103,139,25,3,0,1,3,5,176
063990104,22,24,0,1,0,24,5,76
063990105,235,36,1,1,2,3,45,323
063990106,288,15,7,4,0,2,16,332
063990107,120,13,2,5,2,0,4,146
063990108,173,13,4,6,0,0,4,200
063990109,181,15,2,4,0,2,8,212
063990201,11,13,0,0,0,0,5,29
063990202,38,16,0,1,0,0,6,61
063990301,43,24,0,0,0,1,4,72
063990302,56,6,0,0,0,6,17,85
063990303,134,7,3,4,0,5,6,159
063990304,222,30,1,0,1,0,8,262
063990401,20,1,0,0,0,8,9,38
063990402,18,8,0,0,0,0,6,32
063990501,412,41,10,4,4,8,15,494
063990502,152,15,2,0,1,2,7,179
063990503,40,14,0,0,1,5,12,72
063990504,67,25,0,1,0,9,14,116
063990601,51,53,1,0,0,4,17,126
063990602,39,20,0,0,0,0,15,74
063990701,11,2,0,0,0,1,15,29
063990702,87,16,1,0,0,2,12,118
063990703,263,21,1,4,1,9,13,312
063990704,269,27,0,7,6,3,12,324
063990705,217,30,2,4,8,1,22,284
063990706,220,22,0,1,3,0,16,262
063990801,19,2,0,0,0,0,18,39
063990802,27,2,0,0,0,5,10,44
063990803,20,14,0,0,0,1,3,38
063990804,18,3,0,0,0,0,6,27
063990805,17,10,0,0,0,9,2,38
064060101,3,0,0,0,0,4,0,7
064060102,2,3,0,0,0,1,0,6
064060103,11,0,0,0,0,0,0,11
064060104,7,0,0,1,0,0,2,10
064060105,9,0,0,0,0,2,11,22
064060106,8,1,0,0,0,1,5,15
064060107,1,2,0,1,0,0,1,5
064060201,279,16,1,5,1,1,14,317
064060202,303,30,8,4,8,0,11,364
064060203,305,13,5,15,2,2,22,364
064060204,330,17,2,9,1,4,12,375
064060205,346,26,8,6,10,5,14,415
064060206,321,21,4,7,3,6,19,381
064060207,229,29,0,6,2,1,12,279
064060208,22,2,0,0,0,1,3,28
064060209,5,18,0,1,0,0,1,25
064060210,100,0,0,1,0,20,23,144
064060211,20,20,0,0,0,1,5,46
064060212,6,17,0,0,0,0,0,23
064060213,18,23,0,0,0,5,8,54
064060214,222,11,4,3,0,3,10,253
064060215,296,21,4,10,2,2,16,351
064060216,211,15,0,13,1,5,6,251
064060301,10,6,0,0,0,0,2,18
064060302,42,12,0,0,0,2,9,65
064060303,10,4,0,0,0,0,0,14
064060304,18,2,0,0,0,1,4,25
064060305,16,5,0,0,0,0,6,27
064060306,12,14,0,0,0,0,3,29
064060307,5,2,0,0,0,0,9,16
064060308,33,4,0,0,0,2,4,43
064060309,6,3,0,0,0,0,0,9
064130101,269,0,0,2,1,4,5,281
064130102,257,0,4,5,5,0,7,278
064130103,281,0,6,7,1,2,8,305
064130104,363,0,5,0,1,0,8,377
064130105,269,6,0,0,0,0,3,278
064130106,362,26,5,5,0,0,5,403
064130107,326,11,2,1,0,1,20,361
064130108,285,13,20,6,1,0,2,327
064130109,272,1,7,1,3,2,24,310
064130110,337,24,12,10,1,2,15,401
064130201,389,14,1,10,0,1,7,422
064130202,277,10,1,8,0,1,6,303
064130203,304,19,2,9,1,0,19,354
064130204,265,20,1,13,0,0,3,302
064130205,261,5,3,1,0,0,4,274
064130206,284,9,3,4,0,0,4,304
064130207,362,37,17,7,2,1,12,438
064130208,302,24,6,2,2,0,12,348
064130209,299,18,13,4,3,1,17,355
064130210,319,32,6,8,0,1,13,379
064130211,283,52,5,6,3,5,21,375
064130212,292,0,5,4,0,48,3,352
064130213,250,10,3,2,4,0,5,274
064130301,135,43,5,1,7,0,4,195
064130302,246,67,5,3,12,0,41,374
064130303,311,71,11,1,6,8,11,419
064130304,208,3,7,9,36,1,49,313
064130305,237,63,8,3,24,7,31,373
064130306,271,30,21,0,3,0,4,329
064130307,353,24,8,8,0,0,8,401
064130308,206,10,1,0,1,0,5,223
064130309,285,14,3,4,0,0,5,311
064130310,275,5,0,0,1,1,6,288
064130311,266,7,8,4,6,1,0,292
064130401,257,46,6,2,6,3,3,323
064130402,221,42,17,10,78,3,26,397
064130403,319,33,13,5,16,2,18,406
064130404,389,21,8,4,2,1,13,438
064130405,284,29,7,5,12,3,22,362
064130406,288,0,18,5,61,49,38,459
064130407,254,28,2,3,0,0,5,292
064130408,414,22,11,10,0,4,10,471
064130409,377,0,9,5,16,28,32,467
064130410,191,18,13,4,2,0,7,235
064130411,320,20,5,3,0,0,5,353
064130412,248,17,4,3,0,0,5,277
064130413,373,21,15,15,2,2,9,437
064130501,384,45,11,7,6,2,26,481
064130502,293,25,9,6,5,2,5,345
064130503,325,34,7,1,8,3,14,392
064130504,304,18,19,1,9,4,15,370
064130505,156,34,4,0,4,1,36,235
064130506,264,35,17,3,32,1,32,384
064130507,365,23,10,7,5,1,12,423
064130508,264,35,5,9,29,1,12,355
064130509,319,19,7,5,8,0,16,374
064130510,199,7,3,5,1,0,4,219
064130511,319,30,12,8,9,0,23,401
064130512,330,24,5,5,1,0,5,370
064130513,143,34,9,2,26,0,10,224
064130601,186,13,1,1,1,1,3,206
064130602,259,11,5,6,4,2,2,289
064130603,328,21,5,1,4,1,15,375
064130604,354,50,9,7,0,1,12,433
064130605,332,35,16,11,6,0,24,424
064130606,303,34,9,1,2,0,18,367
064130607,369,32,13,6,6,2,13,441
064130608,246,9,2,7,0,3,9,276
064130609,316,13,4,11,2,2,10,358
064130610,222,9,4,7,0,0,4,246
064130611,277,21,3,5,2,0,6,314
064130612,232,6,1,10,0,1,2,252
064130703,37,3,0,0,0,0,0,40
064130704,32,0,0,0,0,0,0,32
064130901,41,5,0,1,0,3,0,50
064130902,9,0,0,0,0,0,1,10
064131101,47,3,0,0,1,4,1,56
064131106,38,10,0,0,0,0,1,49
064131301,117,10,0,2,0,8,10,147
064131302,318,7,0,4,0,1,13,343
064131303,164,4,1,5,0,10,16,200
064131304,276,29,1,63,0,0,10,379
064131305,151,13,1,4,0,10,2,181
064131306,34,2,1,0,0,1,2,40
064131307,342,13,1,4,0,0,5,365
064131308,132,11,3,7,0,26,8,187
064131309,202,11,2,4,0,3,6,228
064131401,35,4,0,0,0,2,3,44
064131402,35,0,0,2,1,4,0,42
064131403,84,2,0,0,0,2,7,95
064131404,24,8,0,0,0,0,2,34
064131405,1,0,0,0,0,0,0,1
064131406,143,7,0,1,1,0,2,154
064131407,347,13,1,2,0,0,3,366
064131408,175,5,1,4,4,7,4,200
064131409,127,10,0,0,0,0,5,142
064131501,107,5,0,2,1,2,6,123
064131502,27,0,0,0,0,0,0,27
064131503,21,3,0,0,0,0,11,35
064131504,2,1,0,0,0,4,3,10
064131505,39,63,9,15,0,40,2,168
064131506,7,1,2,0,0,33,2,45
064131507,66,86,63,7,1,149,11,383
064131508,33,1,1,11,2,57,5,110
064131509,27,3,0,8,0,82,1,121
064131601,8,1,1,0,0,10,0,20
064131801,103,2,0,2,0,1,5,113
064131802,37,2,0,1,0,0,2,42
064131803,14,3,1,6,0,3,0,27
064131804,3,1,0,1,0,1,0,6
064131805,2,1,0,0,0,4,0,7
064131806,17,0,0,0,0,1,0,18
064131901,14,8,0,0,0,3,14,39
064131902,154,6,3,2,0,15,7,187
064131903,40,4,0,0,0,15,3,62
064131904,45,3,1,9,0,30,1,89
064131905,44,1,2,4,0,17,0,68
064131906,34,2,0,1,0,18,8,63
064132101,424,12,4,9,0,0,12,461
064132102,291,10,3,5,1,0,13,323
064132103,224,18,7,4,1,0,7,261
064132104,399,34,11,6,6,2,20,478
064132105,279,21,3,3,0,1,6,313
064132106,203,19,4,2,0,0,2,230
064132107,256,26,4,3,1,1,13,304
064132108,422,30,7,9,1,0,8,477
064132109,468,3,9,13,1,2,21,517
064132110,344,32,5,1,0,0,37,419
064132201,111,14,1,4,1,3,4,138
064132202,87,3,2,3,1,13,17,126
064132203,42,29,1,11,0,20,2,105
064132204,50,0,1,3,2,50,4,110
064132205,163,9,2,5,0,11,7,197
064132206,106,16,1,11,2,23,1,160
064132207,66,15,0,7,1,1,9,99
064132208,82,5,6,2,1,2,11,109
064132209,126,6,7,2,1,2,3,147
064132210,154,24,1,3,0,3,1,186
064132211,200,36,1,10,0,3,6,256
064132212,96,16,5,19,3,1,0,140
064200101,6,2,0,0,0,2,0,10
064200102,152,9,4,5,1,32,16,219
064200103,105,19,8,6,1,95,7,241
064200104,214,27,21,13,2,81,37,395
064200105,93,64,12,10,2,97,28,306
064200106,80,61,18,7,0,112,38,316
064200107,59,38,17,6,2,131,27,280
064200108,80,8,7,3,0,181,8,287
064200109,131,8,13,2,2,107,20,283
064200110,180,56,19,12,0,63,16,346
064200111,118,83,20,8,0,94,57,380
064200112,58,35,11,3,0,99,53,259
064200113,63,0,5,0,2,315,5,390
064200114,67,18,9,4,1,214,23,336
064200115,68,21,0,1,1,28,150,269
064200116,165,44,46,4,3,170,47,479
064200201,29,7,25,1,0,178,4,244
064200202,37,14,17,0,0,239,32,339
064200203,36,53,6,1,1,137,4,238
064200204,47,11,26,0,0,183,11,278
064200205,21,92,0,0,1,137,6,257
064200206,24,43,4,0,0,153,34,258
064200207,55,0,50,1,1,224,10,341
064200208,87,42,44,4,1,214,24,416
064200209,66,55,83,1,0,145,17,367
064200210,49,31,5,2,3,26,7,123
064200211,62,66,16,1,1,75,15,236
064200212,111,11,28,5,2,166,2,325
064200213,191,15,18,3,0,73,6,306
064200214,91,6,7,2,1,126,8,241
064200215,130,18,23,12,2,206,22,413
064200216,219,51,7,3,2,118,5,405
064200301,73,107,55,9,1,269,36,550
064200302,76,20,38,4,1,179,7,325
064200303,61,0,36,10,0,185,42,334
064200304,102,20,26,10,5,65,28,256
064200305,102,6,14,2,1,131,6,262
064200306,86,104,22,2,2,50,8,274
064200307,94,42,6,8,1,71,16,238
064200308,140,24,13,4,0,121,28,330
064200309,84,24,4,9,0,56,3,180
064200310,70,26,0,0,0,27,6,129
064200311,128,14,3,6,1,41,15,208
064200312,92,15,2,15,0,69,38,231
064200313,40,29,3,8,1,86,6,173
064200314,48,2,11,14,0,133,2,210
064200315,19,32,1,6,1,63,7,129
064200316,34,75,40,16,1,154,19,339
064200317,58,116,37,9,0,72,49,341
064200318,38,20,25,16,0,232,15,346
064200319,55,23,2,20,0,152,51,303
064200320,131,17,6,8,0,71,52,285
064200401,52,116,133,9,1,174,64,549
064200402,71,36,29,20,0,349,13,518
064200403,126,38,22,2,3,73,6,270
064200404,93,67,3,12,0,118,14,307
064200405,79,87,66,14,0,133,17,396
064200406,101,28,29,3,1,258,20,440
064200407,112,0,42,13,1,150,19,337
064200408,57,0,6,2,2,250,8,325
064200409,46,0,52,9,2,239,27,375
064200410,108,2,5,15,0,101,24,255
064200411,92,1,5,11,0,76,26,211
064200412,102,54,4,9,0,117,10,296
064200413,60,11,18,5,1,212,6,313
064200414,74,6,12,1,0,109,152,354
064200415,72,9,33,9,0,298,29,450
064200416,70,15,79,2,0,286,31,483
064200417,38,23,33,1,2,136,4,237
064200418,42,2,92,22,3,241,72,474
064200419,78,4,82,21,2,223,12,422
064200501,4,0,0,0,0,0,2,6
064200502,37,66,5,1,3,144,36,292
064200503,164,14,16,14,0,141,31,380
064200504,160,14,34,2,0,46,30,286
064200505,136,52,17,7,0,88,14,314
064200506,226,53,13,3,1,163,30,489
064200507,173,33,9,8,0,96,4,323
064200508,209,38,5,11,0,40,8,311
064200509,257,62,4,5,1,25,27,381
064200510,96,7,2,6,0,73,19,203
064200511,81,23,24,3,3,102,18,254
064200512,79,34,23,0,1,110,26,273
064200601,73,60,59,3,1,187,51,434
064200602,18,0,3,0,0,243,1,265
064200603,68,72,39,3,0,88,15,285
064200604,57,48,113,1,0,56,16,291
064200605,50,185,3,0,0,112,16,366
064200606,15,0,0,0,3,271,4,293
064200607,42,24,0,0,0,30,381,477
064200608,75,89,26,0,2,120,72,384
064200609,66,55,85,0,0,165,27,398
064200610,49,203,19,0,0,7,19,297
064200611,8,242,0,0,0,2,3,255
064200612,28,0,38,0,4,256,74,400
064200701,55,158,23,1,2,198,99,536
064200702,30,35,59,6,2,241,4,377
064200703,12,62,17,0,1,103,5,200
064200704,40,53,16,1,1,187,21,319
064200705,54,30,20,1,1,151,15,272
064200706,86,28,68,2,0,142,24,350
064200707,67,3,13,15,2,286,41,427
064200708,53,2,41,2,1,279,1,379
064200709,22,1,57,2,1,248,6,337
064200710,37,18,37,0,0,141,15,248
064200711,41,111,14,1,0,132,25,324
064200801,254,40,15,5,0,22,11,347
064200802,255,43,19,8,0,47,35,407
064200803,123,83,11,6,1,18,11,253
064200804,119,12,23,6,1,108,14,283
064200805,147,11,9,6,0,58,18,249
064200806,92,10,30,1,0,166,17,316
064200807,108,56,27,1,1,193,24,410
064200808,86,36,22,4,4,129,42,323
064200809,54,3,76,2,2,160,43,340
064200901,327,53,6,8,1,44,12,451
064200902,157,30,4,2,0,1,9,203
064200903,190,14,4,8,0,90,11,317
064200904,96,19,15,1,1,74,35,241
064200905,75,53,39,7,0,105,31,310
064200906,59,4,38,4,0,187,4,296
064200907,79,103,60,4,2,140,58,446
064200908,81,22,17,7,0,91,16,234
064200909,49,52,72,3,2,179,27,384
064200910,47,32,97,0,0,136,30,342
064200911,63,7,44,12,1,188,7,322
064200912,23,15,32,5,2,196,41,314
064201001,103,2,6,2,1,39,22,175
064201002,52,13,12,3,0,82,48,210
064201003,28,30,3,0,2,92,134,289
064201004,72,1,8,3,1,161,7,253
064201005,120,46,7,11,0,295,18,497
064201006,110,14,37,16,5,296,27,505
064201007,126,24,11,6,2,85,66,320
064201008,51,97,72,6,2,223,56,507
064201009,58,1,8,1,3,173,8,252
064201010,95,33,44,9,7,400,49,637
064201011,119,113,59,16,2,203,85,597
064201012,58,21,78,20,0,251,8,436
064201013,108,41,68,12,0,298,66,593
064201101,67,25,23,14,1,94,3,227
064201102,47,10,78,1,1,153,4,294
064201103,43,30,15,4,0,124,120,336
064201104,67,31,27,10,3,215,30,383
064201105,57,78,29,0,0,157,4,325
064201106,84,35,9,10,0,59,19,216
064201107,57,44,25,11,0,242,8,387
064201108,37,162,26,1,0,44,11,281
064201109,39,74,33,0,1,156,81,384
064201110,121,0,62,3,0,332,29,547
064201111,74,112,38,10,2,217,29,482
064201112,97,19,4,16,0,96,3,235
064201113,78,46,26,17,0,113,24,304
064201114,71,82,38,6,2,217,86,502
064201115,68,119,14,8,4,247,10,470
064201116,115,127,43,19,2,400,48,754
064201117,130,91,2,2,3,48,14,290
064201201,117,49,157,14,1,250,30,618
064201202,14,7,2,10,0,25,0,58
064201203,101,126,223,59,1,225,27,762
064201204,45,73,73,23,0,216,12,442
064201205,69,19,21,20,0,199,12,340
064201206,62,6,57,21,3,181,8,338
064201207,41,133,19,25,2,157,10,387
064201208,90,97,232,18,5,220,141,803
064201209,0,0,0,0,0,0,0,0
064201210,19,19,96,8,1,78,8,229
064201211,60,51,47,14,0,114,17,303
064201212,46,44,64,12,0,129,28,323
064201213,49,19,90,9,1,147,10,325
064201214,30,11,2,32,1,10,5,91
064201301,24,21,72,5,1,185,4,312
064201302,43,30,69,23,1,115,10,291
064201303,44,89,101,6,1,86,24,351
064201304,16,21,47,1,2,163,3,253
064201305,31,1,77,0,1,235,9,354
064201306,57,2,69,3,1,176,5,313
064201307,85,22,144,4,2,193,52,502
064201308,38,39,120,9,1,191,18,416
064201309,46,27,88,2,1,200,12,376
064201310,76,148,120,5,0,46,64,459
064201311,72,38,82,11,1,148,49,401
064201401,57,79,45,5,6,215,28,435
064201402,36,68,111,11,1,130,12,369
064201403,103,75,45,23,1,104,33,384
064201404,162,60,33,0,4,145,43,447
064201405,37,19,6,0,0,281,45,388
064201406,25,16,34,16,0,339,6,436
064201407,19,44,37,1,0,187,10,298
064201408,31,35,24,1,1,244,3,339
064201409,33,1,12,1,1,564,24,636
064201410,25,0,24,0,0,281,3,333
064201501,12,2,0,0,0,193,69,276
064201502,24,0,1,0,0,415,7,447
064201503,30,88,30,1,3,213,62,427
064201504,16,95,21,4,1,260,15,412
064201505,25,3,60,0,1,291,6,386
064201506,54,43,44,3,0,377,31,552
064201507,32,3,8,7,1,312,114,477
064201508,156,53,24,6,0,220,17,476
064201509,98,11,18,8,8,65,11,219
064201510,163,40,10,9,1,22,7,252
064201601,22,0,24,0,1,394,4,445
064201602,19,243,3,0,1,218,20,504
064201603,30,37,60,11,4,264,94,500
064201604,15,0,3,0,2,296,0,316
064201605,14,236,26,1,1,75,21,374
064201606,18,117,33,0,0,118,32,318
064201607,16,83,51,0,2,163,32,347
064201608,25,57,18,0,0,154,32,286
064201609,36,94,40,0,0,66,47,283
064201610,37,45,61,1,0,155,5,304
064201611,157,33,14,8,1,57,32,302
064201612,204,74,79,13,2,90,24,486
064201701,72,102,0,0,0,162,43,379
064201702,5,1,0,1,0,37,2,46
064201703,25,90,8,0,0,301,139,563
064201704,33,25,4,4,1,352,12,431
064201705,33,139,14,1,0,284,22,493
064201706,27,0,19,4,0,293,21,364
064201707,43,22,28,10,0,161,20,284
064201708,118,50,13,6,1,122,47,357
064201709,181,43,35,9,3,88,41,400
064201710,107,11,1,10,0,4,9,142
064201801,16,38,0,1,0,203,45,303
064201802,15,21,3,0,2,177,5,223
064201803,33,75,54,1,1,198,117,479
064201804,23,90,2,0,0,190,16,321
064201805,21,69,26,0,6,188,12,322
064201806,21,18,53,0,0,124,4,220
064201807,23,105,36,0,1,110,5,280
064201808,112,52,35,1,0,124,15,339
064201809,38,38,51,0,0,77,47,251
064201810,23,89,9,3,0,194,15,333
064201811,10,1,6,6,0,162,1,186
064201812,173,67,17,4,1,313,42,617
064201901,10,24,0,0,0,69,66,169
064201902,17,45,1,0,0,252,69,384
064201903,97,5,31,4,0,218,12,367
064201904,130,284,30,2,2,37,41,526
064201905,156,52,31,3,1,170,38,451
064201906,168,78,53,1,0,165,7,472
064201907,146,10,6,4,0,79,4,249
064201908,79,92,53,2,1,27,37,291
064201909,61,3,22,2,1,184,0,273
064201910,125,32,27,4,0,41,29,258
064201911,107,125,44,4,1,90,9,380
064201912,54,39,86,1,1,180,44,405
064202001,193,24,30,10,0,115,8,380
064202002,130,14,18,5,2,209,12,390
064202003,93,68,41,1,0,100,36,339
064202004,44,196,0,0,2,547,78,867
064202005,43,21,8,0,4,211,12,299
064202006,51,84,7,0,1,255,37,435
064202007,32,51,12,0,0,138,2,235
064202008,25,0,0,0,0,229,11,265
064202009,53,38,61,1,1,176,22,352
064202010,65,67,28,1,0,123,30,314
064202011,46,49,9,6,2,198,3,313
064202012,57,9,1,1,0,408,24,500
064202013,84,5,13,2,1,155,13,273
064202101,76,18,3,0,1,96,6,200
064202102,63,33,22,0,0,65,41,224
064202103,148,31,27,7,0,52,26,291
064202104,144,25,10,2,0,88,27,296
064202105,136,15,24,1,0,71,18,265
064202106,236,29,19,5,1,72,21,383
064202107,221,48,9,7,1,16,74,376
064202108,296,42,10,16,3,23,24,414
064202109,330,45,12,11,0,16,10,424
064202110,197,20,0,3,1,10,12,243
064202111,190,27,2,3,0,4,17,243
064202112,254,28,8,4,0,25,23,342
064202201,165,11,7,7,0,6,6,202
064202202,232,19,6,9,0,65,72,403
064202203,140,72,12,6,0,62,26,318
064202204,65,33,15,2,0,138,11,264
064202205,81,26,67,2,4,198,17,395
064202206,118,103,37,15,2,160,15,450
064202207,64,1,36,11,1,195,4,312
064202208,68,23,57,13,0,105,8,274
064202209,128,50,0,4,0,9,7,198
064202210,61,17,23,25,0,143,4,273
064202211,59,18,96,35,3,81,10,302
064202212,55,3,47,49,3,195,2,354
064202213,62,1,28,38,3,210,8,350
064202214,26,34,0,0,0,39,1,100
064410101,291,39,8,2,4,2,22,368
064410102,282,34,7,6,11,1,16,357
064410103,220,35,5,0,2,1,2,265
064410104,247,12,8,2,7,0,8,284
064410105,227,30,28,3,2,1,4,295
064410106,204,27,3,0,1,0,12,247
064410107,212,33,8,1,4,0,10,268
064410108,184,38,2,0,5,0,8,237
064410109,287,45,10,2,3,0,7,354
064410110,317,53,30,5,7,0,32,444
064410111,161,36,18,0,7,0,10,232
064410112,298,35,27,3,16,1,33,413
064410113,175,35,7,3,5,0,8,233
064410201,174,0,21,2,2,0,45,244
064410202,200,11,14,0,9,2,13,249
064410203,271,5,11,1,9,1,15,313
064410204,201,0,13,4,10,0,18,246
064410205,233,0,9,2,9,0,4,257
064410206,295,7,21,0,6,1,8,338
064410207,368,3,27,2,5,0,40,445
064410208,45,2,1,1,1,0,1,51
064410209,336,8,20,8,2,0,35,409
064410210,374,3,19,10,1,0,15,422
064410211,211,8,15,3,3,0,6,246
064410301,210,3,5,2,0,0,5,225
064410302,387,2,14,3,5,0,15,426
064410303,180,4,9,2,2,0,13,210
064410304,239,1,4,0,3,0,10,257
064410305,254,30,14,0,0,0,6,304
064410306,290,3,17,4,5,3,7,329
064410307,362,3,17,0,3,0,16,401
064410308,197,2,2,3,1,1,12,218
064410401,350,87,14,4,8,1,20,484
064410402,347,35,21,6,5,2,17,433
064410403,362,47,20,4,7,1,16,457
064410404,190,45,5,3,3,0,6,252
064410405,186,21,6,10,6,1,9,239
064410406,249,64,19,3,7,0,11,353
064410407,291,56,33,4,9,0,16,409
064410408,279,63,18,4,8,2,18,392
064410409,285,35,25,5,8,1,18,377
064410410,257,10,34,1,8,2,34,346
064410411,341,54,29,3,10,3,34,474
064410412,270,76,15,3,5,0,23,392
064410413,196,53,6,3,9,0,15,282
064410414,237,39,15,2,14,2,12,321
064410501,292,69,7,5,6,0,25,404
064410502,268,51,8,2,3,1,5,338
064410503,222,24,7,3,0,0,16,272
064410504,240,68,46,2,2,1,34,393
064410505,171,59,5,1,2,1,7,246
064410506,181,69,8,0,8,0,4,270
064410507,135,37,7,2,3,0,15,199
064410508,195,40,8,3,8,1,24,279
064410509,149,28,23,2,2,1,10,215
064410601,232,75,30,1,1,0,7,346
064410602,163,38,22,1,5,0,4,233
064410603,209,55,27,0,2,1,13,307
064410604,184,57,11,1,9,0,30,292
064410605,254,94,9,1,9,1,11,379
064410606,175,41,11,2,9,0,16,254
064410607,210,56,16,1,4,0,10,297
064410608,181,79,19,2,12,1,8,302
064410609,282,67,7,2,8,2,28,396
064410701,144,49,7,0,5,0,13,218
064410702,183,71,11,0,21,2,14,302
064410703,274,35,18,1,8,2,49,387
064410704,221,24,3,1,3,4,17,273
064410705,316,79,13,0,5,0,54,467
064410706,180,39,10,1,3,2,12,247
064410707,260,46,35,3,1,3,55,403
064410708,160,46,6,1,2,0,14,229
064410709,238,49,4,2,5,0,19,317
064410801,309,107,8,2,7,3,23,459
064410802,224,59,13,3,5,0,15,319
064410803,114,36,6,0,17,0,3,176
064410804,134,39,8,0,21,1,12,215
064410805,157,45,22,0,12,6,29,271
064410806,41,23,2,0,0,0,2,68
064410807,166,35,11,3,49,0,32,296
064410808,226,55,14,0,14,5,11,325
064410809,244,104,6,2,43,5,12,416
064410901,148,1,3,0,4,0,16,172
064410902,283,3,29,2,11,2,60,390
064410903,192,0,12,1,7,0,18,230
064410904,286,28,12,1,10,0,6,343
064410905,225,54,21,0,5,0,8,313
064410906,260,61,19,1,2,2,24,369
064410907,241,40,18,1,17,0,18,335
064410908,203,42,8,1,3,1,20,278
064410909,242,61,30,0,5,2,33,373
064410910,71,11,5,0,3,0,8,98
064410911,208,66,13,0,9,1,32,329
064410912,276,110,13,1,8,2,17,427
064410913,233,72,17,1,13,3,8,347
064410914,193,46,2,1,2,1,12,257
064411001,384,13,3,2,3,0,7,412
064411002,191,10,5,0,5,1,8,220
064411003,217,7,3,1,2,1,10,241
064411004,205,26,15,2,6,1,10,265
064411005,178,23,16,1,3,0,1,222
064411006,308,35,16,6,11,2,23,401
064411007,194,6,30,2,0,2,8,242
064411008,227,16,4,1,0,0,7,255
064411009,351,27,35,3,16,1,39,472
064411010,191,16,5,1,3,0,17,233
064411011,189,29,4,2,11,0,19,254
064411012,231,26,19,2,14,2,19,313
064411013,233,35,5,0,7,2,14,296
064411014,185,18,16,3,6,0,12,240
064411015,173,89,6,1,5,1,8,283
064411101,191,49,36,2,1,0,1,280
064411102,262,40,24,5,6,0,24,361
064411103,184,35,11,3,4,0,5,242
064411104,173,50,16,2,5,0,15,261
064411105,225,17,5,2,9,2,16,276
064411106,179,27,16,3,12,4,6,247
064411107,168,22,14,2,11,1,13,231
064411108,177,24,15,4,9,1,21,251
064411109,199,51,13,0,6,0,10,279
064411110,174,41,8,3,4,11,17,258
064411111,276,29,18,3,16,1,26,369
064411112,355,57,9,3,15,1,52,492
064411113,315,58,23,1,15,5,23,440
064411114,235,58,10,1,17,1,19,341
064411115,198,46,17,3,8,2,23,297
064411116,203,40,37,0,21,0,13,314
064411201,209,63,26,3,23,5,9,338
064411202,239,91,19,0,9,2,8,368
064411203,132,55,9,1,14,2,12,225
064411204,216,71,10,0,37,3,26,363
064411205,305,58,7,4,22,2,45,443
064411206,182,59,24,3,6,2,11,287
064411207,231,89,17,0,12,1,11,361
064411208,130,55,21,0,7,0,17,230
064411209,158,37,15,2,31,1,17,261
064411210,105,25,19,4,7,0,22,182
064411211,248,101,25,3,6,0,11,394
064411212,143,43,9,0,33,1,5,234
064411213,199,72,38,2,43,1,3,358
064411214,167,38,14,2,68,2,31,322
064411215,152,42,18,1,174,1,13,401
064411216,171,91,10,1,20,0,41,334
064411301,180,54,17,0,11,0,12,274
064411302,254,72,14,0,22,2,5,369
064411303,98,55,9,0,6,1,3,172
064411304,272,83,22,1,53,2,27,460
064411305,134,39,7,2,19,4,17,222
064411306,145,24,16,1,24,2,20,232
064411307,209,61,9,0,12,1,0,292
064411308,196,53,9,2,25,3,19,307
064411309,253,85,19,1,29,1,12,400
064411401,157,81,11,3,10,0,4,266
064411402,137,45,14,1,11,0,5,213
064411403,184,55,10,3,24,1,14,291
064411404,254,79,33,3,29,5,10,413
064411405,291,84,21,2,9,0,16,423
064411406,152,19,5,1,5,0,18,200
064411407,210,70,11,1,11,0,11,314
064411408,226,91,15,0,5,1,4,342
064411409,188,58,5,0,33,3,12,299
064411501,287,90,17,3,4,0,13,414
064411502,273,72,9,0,7,3,24,388
064411503,223,33,21,0,11,1,15,304
064411504,238,49,24,9,15,3,27,365
064411505,275,68,21,2,10,3,12,391
064411506,207,63,10,2,5,3,4,294
064411507,232,63,11,1,9,1,17,334
064411508,198,43,19,2,3,1,3,269
064411509,303,78,25,3,9,0,13,431
064411510,263,36,34,0,8,1,20,362
064411511,220,43,12,4,3,0,12,294
064411512,192,61,7,3,9,2,13,287
064411601,318,59,14,6,12,0,10,419
064411602,204,34,6,5,3,1,7,260
064411603,209,32,3,3,5,0,12,264
064411604,209,31,11,1,2,1,13,268
064411605,171,16,5,2,4,15,11,224
064411606,345,38,12,6,3,1,13,418
064411607,343,57,40,4,14,0,31,489
064411608,194,20,7,1,9,1,14,246
064411609,218,34,4,5,3,4,16,284
064411610,381,30,21,8,5,1,37,483
064411611,337,66,21,4,7,0,25,460
064411612,263,39,37,6,4,0,18,367
064411613,162,24,5,0,12,0,12,215
064411614,295,44,10,0,2,0,19,370
064411615,81,26,3,0,0,0,10,120
064411701,187,14,7,4,9,1,10,232
064411702,211,18,13,5,4,2,6,259
064411703,258,20,33,5,5,0,22,343
064411704,198,24,4,3,4,1,13,247
064411705,302,45,10,6,7,3,15,388
064411706,181,24,8,2,1,3,9,228
064411707,177,14,3,3,2,1,10,210
064411708,240,28,24,12,5,0,7,316
064411709,188,13,6,4,5,0,13,229
064411710,175,7,6,2,5,0,12,207
064411711,166,26,21,3,1,0,11,228
064411712,294,13,25,4,5,2,17,360
064411713,181,6,9,1,4,0,14,215
064411801,159,50,16,7,3,0,7,242
064411802,214,18,27,1,9,3,12,284
064411803,171,14,16,1,13,0,32,247
064411804,173,55,4,0,0,0,9,241
064411805,236,33,16,1,24,1,32,343
064411806,162,36,5,9,3,0,1,216
064411807,230,52,11,3,3,6,8,313
064411808,279,55,31,4,2,0,5,376
064411809,200,45,58,0,6,2,5,316
064411810,244,46,44,2,10,1,12,359
064411811,380,106,13,2,10,0,32,543
064411812,204,55,12,1,2,0,12,286
064411813,199,57,5,5,9,2,5,282
064411901,273,80,17,1,19,1,8,399
064411902,314,63,6,2,26,2,25,438
064411903,228,34,9,3,22,1,17,314
064411904,219,51,21,5,16,0,22,334
064411905,144,38,8,3,4,1,3,201
064411906,229,34,7,6,11,3,17,307
064411907,209,31,25,6,17,1,5,294
064411908,151,11,10,3,29,5,16,225
064411909,200,30,12,0,6,2,15,265
064411910,181,42,17,6,3,1,17,267
064411911,236,30,11,3,5,0,21,306
064412001,319,82,23,4,11,0,17,456
064412002,216,46,14,15,22,1,8,322
064412003,260,59,11,2,15,1,6,354
064412004,166,22,12,5,13,4,10,232
064412005,213,48,17,3,2,0,3,286
064412006,207,35,11,0,9,4,10,276
064412007,182,48,10,0,1,0,16,257
064412008,227,49,21,2,15,3,9,326
064412009,256,53,15,2,14,2,7,349
064412010,173,49,20,2,7,0,13,264
064412011,133,21,19,0,1,0,17,191
064412012,128,51,12,0,9,1,8,209
064412013,146,43,16,3,120,1,11,340
064412014,57,17,1,1,160,1,4,241
064412015,161,43,29,0,116,0,33,382
064412016,146,36,27,1,215,1,16,442
064412017,146,21,8,2,16,0,21,214
064412101,192,32,6,0,6,0,5,241
064412102,217,35,34,6,12,0,26,330
064412103,375,72,22,5,6,1,13,494
064412104,361,57,11,0,2,0,6,437
064412105,314,23,8,4,3,0,20,372
064412106,194,27,28,2,9,2,15,277
064412107,193,40,9,3,4,3,10,262
064412108,187,32,24,4,7,2,9,265
064412109,202,31,8,12,7,0,11,271
064412110,215,31,10,1,4,0,5,266
064412111,187,32,8,4,7,0,5,243
064412112,203,40,4,4,6,1,13,271
064412113,344,77,10,4,16,0,21,472
064412114,197,34,7,1,2,1,16,258
064412115,344,60,10,2,8,3,21,448
064412201,259,59,12,9,1,0,20,360
064412202,276,40,11,5,10,1,10,353
064412203,358,50,20,4,1,3,15,451
064412204,362,60,33,4,2,2,20,483
064412205,299,30,13,3,4,1,15,365
064412206,230,23,42,2,1,1,9,308
064412207,213,14,12,4,4,0,17,264
064412208,250,41,7,8,1,0,10,317
064412209,243,37,5,6,11,1,22,325
064412301,250,41,15,4,1,0,9,320
064412302,181,22,2,3,6,0,8,222
064412303,230,15,24,0,7,0,15,291
064412304,191,21,10,0,1,1,12,236
064412305,225,24,19,4,3,0,15,290
064412306,221,36,5,1,3,0,7,273
064412307,245,37,13,2,5,0,4,306
064412308,234,20,5,1,10,2,11,283
064412309,157,15,14,3,3,1,1,194
064412401,202,15,14,4,10,2,22,269
064412402,206,31,38,12,5,2,13,307
064412403,181,25,6,2,0,0,6,220
064412404,196,18,7,2,3,0,13,239
064412405,403,46,22,5,3,0,17,496
064412406,318,52,69,11,3,0,13,466
064412407,188,31,19,2,3,0,8,251
064412408,191,33,7,5,11,0,19,266
064412409,274,32,24,3,7,0,16,356
064412410,186,27,15,0,5,0,31,264
064412411,366,47,24,3,5,0,24,469
064412501,229,45,7,1,8,2,9,301
064412502,256,59,5,1,3,1,10,335
064412503,194,35,17,6,9,0,13,274
064412504,186,22,13,0,1,0,4,226
064412505,323,61,18,1,12,2,13,430
064412506,230,43,11,9,8,2,15,318
064412507,208,29,19,5,13,0,6,280
064412508,218,23,9,1,2,0,11,264
064412509,189,35,1,2,6,1,6,240
064412510,271,55,6,2,7,0,17,358
064412601,218,21,5,1,6,0,10,261
064412602,198,32,12,2,6,1,18,269
064412603,227,36,9,1,5,2,11,291
064412604,159,27,0,2,2,3,16,209
064412605,172,26,6,4,2,1,15,226
064412606,309,33,11,0,2,0,9,364
064412607,259,24,12,4,3,0,19,321
064412608,166,20,8,2,4,0,6,206
064412609,197,29,20,5,1,0,8,260
064412610,389,34,7,1,2,1,14,448
064412611,217,22,13,3,2,1,14,272
064412612,243,37,7,1,4,0,26,318
064412613,208,27,6,5,3,0,6,255
064412614,267,31,21,1,4,0,20,344
064412701,321,50,14,5,6,2,17,415
064412702,350,33,10,4,9,1,45,452
064412703,312,8,10,6,1,1,21,359
064412704,322,41,20,5,2,0,7,397
064412705,364,36,27,8,3,0,10,448
064412706,206,18,5,4,2,0,17,252
064412707,223,21,14,0,0,1,9,268
064412708,381,27,18,3,4,0,22,455
064412709,344,19,9,4,0,0,28,404
064412801,218,30,9,2,1,0,17,277
064412802,300,41,8,0,4,0,17,370
064412803,232,20,23,4,4,0,10,293
064412804,161,41,17,0,2,0,10,231
064412805,210,27,9,12,1,1,8,268
064412806,190,21,10,2,1,0,17,241
064412807,170,26,1,3,1,2,12,215
064412808,214,23,16,2,0,1,7,263
064412809,239,20,11,0,0,2,8,280
064412810,263,35,14,2,1,1,5,321
064412811,307,50,35,9,6,2,11,420
064412812,355,33,11,1,5,1,29,435
064412813,346,42,22,0,2,4,11,427
064412901,203,18,9,2,4,2,19,257
064412902,208,13,6,4,3,0,4,238
064412903,236,20,10,3,3,0,13,285
064412904,188,24,21,1,1,1,11,247
064412905,228,17,10,0,3,0,4,262
064412906,192,22,12,2,6,2,21,257
064412907,232,24,11,2,1,0,18,288
064412908,190,26,1,1,3,1,1,223
064412909,298,40,14,2,7,2,10,373
064412910,195,19,4,4,3,0,7,232
064412911,178,16,8,19,3,0,12,236
064412912,175,9,19,1,1,1,8,214
064412913,326,28,2,8,3,1,17,385
064412914,332,33,1,9,5,1,20,401
064413001,262,10,4,4,3,0,13,296
064413002,338,37,12,4,1,0,9,401
064413003,276,22,8,1,0,1,10,318
064413004,357,29,8,5,2,5,12,418
064413005,225,24,17,3,4,1,10,284
064413006,348,16,4,2,3,1,14,388
064413007,187,13,10,3,3,0,12,228
064413008,211,8,10,1,1,0,9,240
064413009,297,16,6,5,1,1,22,348
064413101,350,30,5,2,2,2,13,404
064413102,220,8,4,3,1,0,7,243
064413103,215,10,6,4,1,0,6,242
064413104,162,7,1,1,3,0,3,177
064413105,202,21,4,5,3,0,11,246
064413106,265,16,6,3,1,0,6,297
064413107,229,20,8,1,3,0,9,270
064413108,204,18,8,0,6,1,3,240
064413109,228,16,2,5,9,1,16,277
064413110,212,21,4,2,1,0,3,243
064413111,390,29,9,10,3,3,9,453
064413112,290,18,9,2,3,2,6,330
064413113,206,12,13,4,1,2,4,242
064413114,254,12,5,1,2,0,22,296
064413115,226,16,2,3,0,0,7,254
064413116,198,16,7,3,1,1,10,236
064413201,199,6,4,1,3,0,19,232
064413202,178,16,6,4,0,0,10,214
064413203,381,25,12,6,5,0,19,448
064413204,395,9,9,12,1,0,17,443
064413205,376,28,12,9,5,1,8,439
064413206,301,20,4,5,1,0,5,336
064413207,316,17,2,6,1,2,8,352
064413208,298,17,2,1,0,0,10,328
064413209,234,16,2,13,6,3,13,287
064413210,265,24,5,5,4,0,7,310
064413211,348,31,4,11,9,0,8,411
064413301,329,41,9,0,2,0,9,390
064413302,169,14,5,2,2,0,9,201
064413303,265,29,2,2,0,0,14,312
064413304,213,11,10,1,4,1,12,252
064413305,261,13,2,4,2,0,9,291
064413306,394,32,10,3,1,0,22,462
064413307,235,13,3,7,1,1,8,268
064413308,212,22,7,3,2,0,12,258
064413309,375,20,3,1,0,1,14,414
064413310,305,45,9,3,8,0,10,380
064413311,390,30,6,6,3,1,12,448
064413401,209,26,7,5,4,0,4,255
064413402,239,25,6,3,1,0,9,283
064413403,354,23,4,7,1,0,12,401
064413404,242,15,3,2,0,0,8,270
064413405,309,28,4,1,0,0,8,350
064413406,242,17,1,1,0,1,4,266
064413407,239,13,2,14,0,0,6,274
064413408,347,21,2,0,0,0,7,377
064413409,219,13,1,0,0,0,0,233
064413410,232,18,3,4,0,0,5,262
064413411,210,15,0,2,0,0,2,229
064413412,162,13,2,0,0,0,13,190
064413413,289,14,1,7,0,1,0,312
064413414,272,17,1,0,2,0,2,294
064413415,390,23,1,12,0,0,7,433
064413501,362,7,5,7,1,0,14,396
064413502,378,9,13,7,1,0,13,421
064413503,204,0,4,0,2,0,7,217
064413504,196,5,3,1,2,0,6,213
064413505,358,8,6,9,9,0,6,396
064413506,233,1,3,5,1,0,16,259
064413507,272,3,2,1,1,0,10,289
064413508,355,2,6,11,1,0,9,384
064413509,354,8,2,1,0,0,23,388
064413510,326,5,5,11,0,0,6,353
064413511,421,0,0,0,0,0,10,431
064413512,336,10,4,4,2,0,17,373
064413513,353,14,5,0,1,0,25,398
064413514,281,3,7,0,1,0,9,301
064413515,400,2,2,6,1,1,11,423
064413516,603,6,0,15,1,0,35,660
064413601,279,7,3,3,0,0,7,299
064413602,257,9,2,1,0,0,15,284
064413603,217,6,8,4,0,0,8,243
064413604,203,6,0,1,1,0,4,215
064413605,343,23,2,4,1,0,8,381
064413606,332,17,2,7,1,2,3,364
064413607,258,6,3,2,0,0,9,278
064413608,260,26,7,3,0,0,4,300
064413609,290,6,3,3,1,5,7,315
064413610,356,10,13,5,2,0,6,392
064413611,297,15,0,6,0,0,16,334
064413612,313,8,2,6,1,6,6,342
064413701,309,11,3,6,1,1,17,348
064413702,348,9,4,10,1,0,11,383
064413703,188,6,0,1,0,0,0,195
064413704,198,13,0,1,0,1,2,215
064413705,325,15,0,7,0,0,9,356
064413706,339,14,0,11,0,1,6,371
064413707,243,10,6,0,0,0,4,263
064413708,279,15,4,2,1,0,7,308
064413709,350,26,4,0,0,3,3,386
064413710,404,31,3,6,0,0,7,451
064413711,359,16,1,3,0,1,13,393
064413712,379,17,2,7,2,0,8,415
064413713,243,8,34,10,0,0,6,301
064413714,341,13,3,13,1,1,9,381
064413801,465,12,4,4,2,0,18,505
064413802,223,7,0,3,0,0,4,237
064413803,239,8,1,3,5,1,11,268
064413804,190,10,6,5,0,1,11,223
064413805,272,19,0,1,1,0,8,301
064413806,294,17,9,2,0,1,10,333
064413807,314,12,5,4,2,0,6,343
064413808,198,12,0,24,0,4,7,245
064413809,249,15,0,9,1,0,8,282
064413810,280,4,0,3,0,0,6,293
064413901,303,9,5,3,1,0,16,337
064413902,226,13,12,2,1,0,8,262
064413903,219,2,1,3,1,0,3,229
064413904,249,5,14,7,5,1,0,281
064413905,269,7,9,5,0,0,7,297
064413906,285,7,3,2,4,0,9,310
064413907,215,2,3,0,0,0,7,227
064413908,270,1,2,5,0,0,10,288
064413909,251,1,3,3,10,0,7,275
064413910,401,4,4,6,2,0,5,422
064414001,265,3,4,14,2,0,17,305
064414002,263,0,0,2,1,0,6,272
064414003,235,13,5,0,0,1,8,262
064414004,227,24,3,8,0,0,9,271
064414005,169,9,3,0,0,0,5,186
064414006,338,2,8,4,2,1,24,379
064414007,274,0,6,2,0,2,3,287
064414008,251,4,1,3,0,2,12,273
064414009,272,4,4,1,0,0,3,284
064414010,342,1,0,3,3,0,8,357
064414011,357,2,2,5,0,1,5,372
064414012,314,1,2,7,0,0,3,327
064414013,401,3,3,10,1,0,6,424
064414101,545,1,1,7,0,2,19,575
064414102,330,3,1,10,0,4,13,361
064414103,343,0,3,5,0,0,6,357
064414104,395,19,3,8,1,2,12,440
064414105,377,13,2,11,1,3,12,419
064414106,265,27,1,1,0,0,0,294
064414107,271,17,1,5,0,0,6,300
064414108,415,10,1,5,2,1,20,454
064414109,311,12,4,5,0,1,4,337
064414110,274,12,1,0,2,1,2,292
064414111,95,14,4,4,0,3,8,128
064414112,165,7,1,21,1,4,2,201
064414201,488,17,3,5,0,2,12,527
064414202,195,9,1,6,0,0,12,223
064414203,350,10,3,1,0,2,14,380
064414204,305,10,1,0,2,0,3,321
064414205,323,12,0,4,0,0,8,347
064414206,431,13,3,8,2,4,10,471
064414207,364,21,4,17,1,3,19,429
064414208,225,17,1,3,1,3,8,258
064414209,273,20,2,11,1,1,5,313
064414210,444,23,3,8,8,4,8,498
064414211,286,8,1,5,1,0,3,304
064414212,274,11,4,7,1,5,13,315
064414213,128,0,0,2,0,0,1,131
064414214,97,32,0,4,0,2,0,135
064414215,406,10,2,19,1,0,8,446
064414216,333,14,3,4,6,1,5,366
064414217,388,29,4,9,0,0,14,444
064414218,382,18,5,10,6,3,7,431
064414219,345,25,2,7,0,0,4,383
064414301,250,16,8,10,0,3,11,298
064414302,274,23,8,2,1,1,6,315
064414303,227,10,7,6,1,2,14,267
064414304,328,22,7,12,1,0,3,373
064414305,206,13,5,3,0,2,12,241
064414306,289,31,6,7,0,1,8,342
064414307,213,12,5,1,0,1,8,240
064414308,238,1,6,5,3,0,15,268
064414309,354,26,11,17,7,1,29,445
064414310,393,22,1,8,1,1,1,427
064414311,210,10,0,7,1,4,5,237
064414312,196,17,6,12,1,2,7,241
064414313,227,37,5,6,1,0,7,283
064414314,315,11,3,4,0,1,30,364
064414315,434,35,5,29,5,6,11,525
064414401,275,14,0,1,1,2,7,300
064414402,239,24,1,4,0,1,7,276
064414403,360,15,4,5,0,0,2,386
064414404,245,19,1,7,2,0,9,283
064414405,293,22,6,9,0,0,9,339
064414406,277,19,2,4,0,1,3,306
064414407,370,26,0,9,0,1,9,415
064414408,209,14,0,4,0,0,1,228
064414409,233,5,3,0,0,0,2,243
064414410,552,23,1,4,0,0,13,593
064414501,217,16,3,4,2,7,8,257
064414502,249,23,8,7,0,2,5,294
064414503,282,12,3,11,5,0,5,318
064414504,321,9,0,3,1,2,3,339
064414505,242,9,0,6,0,1,3,261
064414506,296,36,5,5,0,0,12,354
064414507,279,14,5,6,0,2,7,313
064414508,284,2,5,22,7,5,8,333
064414509,330,2,1,1,0,0,47,381
064414510,294,18,0,7,2,1,7,329
064414511,356,10,1,5,0,0,17,389
064414601,275,15,1,2,0,1,9,303
064414602,331,8,2,3,2,1,5,352
064414603,273,15,2,2,1,1,6,300
064414604,262,15,2,3,0,1,3,286
064414605,238,23,0,3,0,1,0,265
064414606,211,21,5,8,4,0,12,261
064414607,292,26,2,17,3,0,12,352
064414608,315,9,2,5,0,0,9,340
064414609,301,16,2,8,2,0,12,341
064414701,281,27,4,7,11,0,12,342
064414702,317,17,3,2,1,0,9,349
064414703,252,17,1,1,1,0,3,275
064414704,441,27,13,8,1,1,8,499
064414705,287,16,6,15,3,1,11,339
064414706,266,32,1,4,2,1,7,313
064414707,454,54,26,5,0,3,25,567
064414708,279,4,4,8,0,1,2,298
064414709,519,16,1,1,2,1,15,555
064414710,245,25,0,18,0,0,2,290
064414801,320,12,10,2,1,2,20,367
064414802,166,9,1,4,0,0,1,181
064414803,239,7,0,2,0,0,15,263
064414804,391,16,5,1,0,1,16,430
064414805,189,14,5,1,0,0,9,218
064414806,275,17,9,3,0,0,10,314
064414807,315,22,6,1,1,1,3,349
064414808,195,6,0,0,0,1,1,203
064414809,213,21,3,0,6,3,9,255
064414901,304,24,8,3,1,0,2,342
064414902,242,44,8,4,0,0,5,303
064414903,286,31,10,6,5,0,18,356
064414904,207,13,14,2,5,0,5,246
064414905,181,19,3,1,2,1,10,217
064414906,246,22,4,7,5,1,8,293
064414907,265,34,7,10,1,0,11,328
064414908,189,13,4,2,5,1,9,223
064414909,245,35,6,2,0,2,6,296
064414910,194,22,15,0,0,0,5,236
064415001,187,16,5,0,0,0,8,216
064415002,186,9,8,2,1,0,18,224
064415003,389,31,4,7,3,3,6,443
064415004,201,10,0,4,0,0,4,219
064415005,194,19,6,1,1,0,6,227
064415006,229,27,1,6,1,1,16,281
064415007,176,28,3,2,0,0,4,213
064415008,226,20,1,0,1,1,11,260
064415009,248,17,6,2,2,0,7,282
064415010,259,10,7,2,1,1,14,294
064415101,416,19,3,0,0,1,1,440
064415102,257,11,1,2,1,0,3,275
064415103,206,2,7,4,2,2,5,228
064415104,261,24,6,3,0,0,12,306
064415105,391,10,17,2,0,0,21,441
064415106,166,1,0,0,0,0,2,169
064415107,212,14,4,1,3,0,4,238
064415108,268,16,9,4,2,0,20,319
064415109,207,16,4,2,2,1,8,240
064415110,163,5,6,2,0,0,10,186
064415111,242,19,11,4,10,0,31,317
064415112,170,16,5,5,4,1,9,210
064415113,204,27,4,2,3,0,11,251
064415114,224,36,4,2,1,0,5,272
064415115,191,20,6,1,1,0,4,223
064415116,145,11,2,2,3,0,9,172
064415117,410,53,9,2,5,0,12,491
064415118,322,31,7,9,5,0,7,381
064415201,271,7,0,32,0,0,2,312
064415202,243,11,1,2,0,0,3,260
064415203,197,8,16,2,0,0,5,228
064415204,327,14,7,4,2,1,8,363
064415205,243,12,1,4,0,0,0,260
064415206,160,19,0,3,0,1,31,214
064415207,309,8,5,2,0,0,4,328
064415208,267,17,1,3,3,1,13,305
064415209,179,18,5,2,0,3,5,212
064415210,245,31,8,1,1,1,14,301
064415301,208,7,4,2,1,5,7,234
064415302,368,17,2,5,0,3,18,413
064415303,182,10,2,0,0,0,11,205
064415304,292,22,5,2,0,0,9,330
064415305,365,22,0,3,0,1,8,399
064415306,225,16,2,5,0,1,9,258
064415307,199,14,8,4,6,1,5,237
064415308,259,18,3,7,1,0,9,297
064415309,354,22,7,6,1,3,6,399
064415310,359,19,0,1,1,2,6,388
064415401,290,6,3,11,0,0,9,319
064415402,256,15,2,8,2,0,3,286
064415403,276,19,2,1,0,1,6,305
064415404,242,24,1,7,2,0,8,284
064415405,380,35,9,4,1,5,13,447
064415406,153,4,5,5,0,4,3,174
064415407,233,21,4,3,3,2,5,271
064415408,166,16,3,4,1,8,2,200
064415409,207,18,4,0,0,2,7,238
064415410,283,26,4,9,0,0,14,336
064415411,189,15,3,3,0,5,6,221
064415412,301,22,1,9,0,3,4,340
064415413,123,11,10,16,2,2,7,171
064415414,239,9,6,16,4,1,2,277
064415415,190,4,0,0,0,1,5,200
064415416,214,14,2,2,0,3,2,237
064415417,336,35,3,8,2,1,12,397
064415418,295,14,5,1,1,13,11,340
064415501,436,18,9,5,1,5,9,483
064415502,473,23,5,8,1,9,14,533
064415503,207,18,0,7,1,7,17,257
064415504,217,4,1,2,2,1,2,229
064415505,306,24,1,10,1,1,5,348
064415506,329,30,4,7,3,5,6,384
064415507,229,19,4,8,2,5,9,276
064415508,323,49,8,14,1,4,18,417
064415509,220,9,1,24,0,0,21,275
064415510,119,5,0,0,0,0,2,126
064415511,199,14,5,9,3,0,5,235
064415601,268,25,2,11,1,9,12,328
064415602,366,31,4,9,1,16,5,432
064415603,183,21,2,8,0,8,2,224
064415604,260,25,2,3,1,6,15,312
064415605,391,38,8,4,7,15,8,471
064415606,382,27,9,15,2,6,13,454
064415607,287,15,5,8,0,16,14,345
064415608,412,46,7,7,0,7,9,488
064415701,38,3,2,1,1,0,3,48
064415702,244,9,4,7,2,6,7,279
064415703,188,9,0,8,1,2,1,209
064415704,239,14,1,1,0,5,3,263
064415705,349,12,3,22,0,5,19,410
064415706,354,38,3,13,0,0,13,421
064415707,401,21,7,17,1,1,15,463
064415708,235,20,5,8,0,1,15,284
064415709,242,8,2,8,0,3,7,270
064415710,234,17,2,17,0,1,10,281
064415711,333,33,4,11,1,2,7,391
064415712,340,27,0,14,1,4,11,397
064415713,230,25,3,2,0,0,9,269
064415801,240,22,5,3,3,1,16,290
064415802,238,15,9,8,4,3,7,284
064415803,276,26,2,4,3,7,3,321
064415804,175,4,6,0,12,5,14,216
064415805,162,18,3,3,8,0,7,201
064415806,191,16,0,5,3,4,2,221
064415807,228,8,6,4,1,3,6,256
064415808,190,18,6,1,1,2,12,230
064415901,219,2,2,4,4,6,5,242
064415902,227,5,2,1,2,12,12,261
064415903,192,0,3,3,0,1,2,201
064415904,280,0,2,4,2,6,10,304
064415905,240,2,4,6,4,2,7,265
064415906,212,0,9,2,2,8,9,242
064415907,288,2,1,8,0,5,6,310
064415908,321,0,5,13,0,11,13,363
064415909,259,1,5,3,0,4,7,279
064415910,361,4,7,15,1,15,8,411
064416001,338,8,9,10,5,17,23,410
064416002,221,22,6,12,5,8,13,287
064416003,250,12,0,2,0,4,14,282
064416004,355,25,4,4,1,4,5,398
064416005,347,8,4,7,0,1,10,377
064416006,237,15,2,7,0,1,17,279
064416007,272,25,4,6,0,3,3,313
064416008,212,17,6,7,0,17,12,271
064416009,335,15,2,17,0,14,3,386
064416010,280,18,4,4,0,14,21,341
064416101,252,29,11,0,1,1,20,314
064416102,198,14,4,0,1,0,14,231
064416103,218,15,0,6,1,2,6,248
064416104,222,7,10,4,3,3,1,250
064416105,281,18,3,2,1,3,13,321
064416106,364,31,4,14,2,4,7,426
064416107,258,7,2,8,3,35,23,336
064416108,88,7,2,4,1,4,2,108
064416109,220,4,8,16,2,23,10,283
064416110,215,20,7,10,0,4,21,277
064416111,260,26,9,4,1,24,8,332
064416112,239,26,6,15,1,10,5,302
064416201,107,2,5,6,4,20,5,149
064416202,250,8,2,5,0,2,3,270
064416203,215,24,6,10,0,2,14,271
064416204,264,25,8,5,0,4,8,314
064416205,60,5,2,0,1,1,3,72
064416206,269,31,3,0,0,0,18,321
064416207,193,15,8,6,3,0,11,236
064416208,321,18,4,9,4,5,22,383
064416209,185,22,4,3,0,3,5,222
064416210,172,12,10,7,0,0,5,206
064416211,416,16,4,6,3,12,4,461
064416212,174,22,7,0,0,10,8,221
064416213,338,29,3,13,0,4,5,392
064416301,209,41,2,7,0,9,3,271
064416302,215,37,3,2,1,14,16,288
064416303,268,23,4,11,4,35,21,366
064416304,284,32,6,18,0,6,12,358
064416305,172,29,4,11,0,32,12,260
064416306,243,32,2,6,0,35,11,329
064416307,216,7,6,5,1,51,20,306
064416308,176,11,1,6,1,19,8,222
064416309,135,43,2,7,0,14,9,210
064416310,217,13,1,22,0,13,14,280
064416311,138,9,3,9,0,15,60,234
064416401,391,13,4,15,4,27,14,468
064416402,136,12,1,3,2,11,1,166
064416403,133,11,1,2,0,6,6,159
064416404,146,22,2,3,0,7,10,190
064416405,130,9,0,7,0,0,5,151
064416406,151,7,1,3,0,10,15,187
064416407,108,6,3,7,7,10,3,144
064416408,34,0,0,0,0,0,2,36
064416409,223,33,5,20,2,6,22,311
064416410,31,4,1,0,0,4,2,42
064416411,176,28,0,7,0,1,6,218
064416412,113,12,2,1,0,5,13,146
064416413,90,4,2,10,0,9,9,124
064416414,160,19,5,9,0,20,7,220
064416415,309,25,3,16,1,22,21,397
064416416,144,9,5,5,1,7,5,176
064416417,187,11,1,2,0,1,1,203
064416418,177,18,0,33,0,8,15,251
064416419,197,19,4,6,2,10,24,262
064416501,167,31,0,3,1,58,14,274
064416502,177,5,1,2,1,12,11,209
064416503,160,9,8,3,1,14,27,222
064416504,38,0,1,5,0,17,1,62
064416505,24,2,0,2,0,5,7,40
064416506,45,12,2,12,0,6,3,80
064416507,61,5,1,23,0,25,2,117
064416508,43,4,9,2,1,22,5,86
064416509,277,6,0,1,4,19,10,317
064416510,414,16,2,6,2,7,13,460
064416511,299,11,4,8,1,17,14,354
064416512,97,7,2,7,1,73,10,197
064416513,145,11,5,15,1,33,10,220
064416514,199,8,10,4,0,100,11,332
064416515,300,13,4,12,1,6,11,347
064416516,239,12,0,10,1,0,10,272
064416517,306,13,1,4,1,0,7,332
064416518,149,9,1,9,0,0,7,175
064416519,339,44,3,7,1,9,20,423
064416520,165,16,3,17,5,26,17,249
064416521,111,16,5,29,1,172,49,383
064416601,229,20,1,18,0,1,9,278
064416602,239,12,3,11,1,1,5,272
064416603,361,41,2,13,0,4,9,430
064416604,294,13,2,7,1,2,2,321
064416605,12,0,0,0,0,0,1,13
064416606,243,10,2,13,0,0,4,272
064416607,370,30,4,7,0,0,23,434
064416608,274,23,7,6,0,1,5,316
064416609,286,20,4,15,1,1,7,334
064416610,210,24,4,6,1,0,7,252
064416611,355,21,12,17,33,5,7,450
064416612,328,18,3,10,2,0,8,369
064416613,198,26,2,4,0,0,11,241
064416614,201,6,0,3,0,10,25,245
064416615,380,13,2,5,0,6,10,416
064416616,257,53,2,6,1,4,5,328
064416617,332,30,3,6,1,11,27,410
064416618,276,14,5,22,0,23,16,356
064416701,119,9,2,1,0,11,24,166
064416702,42,5,0,0,0,2,5,54
064416703,87,68,0,32,0,25,9,221
064416704,102,5,1,1,1,17,7,134
064416801,217,11,0,4,0,5,2,239
064416802,428,28,3,24,0,1,18,502
064416803,221,9,2,10,0,1,5,248
064416804,229,18,4,8,3,9,5,276
064416805,344,38,7,2,0,0,14,405
064416806,154,13,0,6,0,8,5,186
064416807,163,6,1,8,0,55,22,255
064416808,145,15,6,19,0,57,33,275
064416809,140,0,6,20,0,80,8,254
064416810,72,1,6,18,2,65,4,168
064416811,110,3,1,11,1,74,4,204
064416812,94,20,4,15,0,34,6,173
064416813,36,0,1,6,2,47,2,94
064416814,176,4,1,5,1,32,7,226
064416815,142,18,1,2,0,12,18,193
064416816,166,13,1,2,0,9,10,201
064416817,34,2,0,0,0,1,2,39
064416901,326,15,1,4,0,2,1,349
064416902,324,24,4,5,2,3,16,378
064416903,302,36,7,6,0,0,25,376
064416904,380,17,1,4,0,0,14,416
064416905,291,11,1,4,0,0,2,309
064416906,390,47,5,14,1,4,4,465
064416907,211,32,0,5,0,6,7,261
064416908,330,15,2,2,0,1,11,361
064416909,328,28,5,14,0,4,15,394
064416910,230,24,8,1,0,0,9,272
064416911,308,32,2,6,0,4,5,357
064416912,108,21,0,2,0,6,5,142
064417001,407,34,4,10,0,0,13,468
064417002,255,17,2,5,0,1,5,285
064417003,204,10,1,4,1,0,4,224
064417004,411,17,2,2,0,2,7,441
064417005,338,7,0,14,0,0,8,367
064417006,287,10,0,16,1,0,11,325
064417007,223,50,3,21,0,46,29,372
064417101,45,5,0,2,1,3,9,65
064480101,110,16,2,0,1,1,29,159
064480102,8,3,0,0,0,0,3,14
064480103,14,3,0,0,0,3,4,24
064480201,10,0,0,0,0,4,2,16
064480202,6,6,0,0,0,0,2,14
064480203,15,2,0,1,0,0,1,19
064480301,7,5,0,0,0,0,1,13
064480302,5,5,0,0,0,0,0,10
064480303,5,5,0,0,0,0,2,12
064480401,7,0,0,0,0,0,0,7
064480402,4,0,0,0,0,0,1,5
064480403,0,1,0,0,0,0,17,18
064480501,10,4,0,0,0,0,0,14
064480502,8,3,0,0,0,0,0,11
064480503,4,10,0,0,0,0,0,14
064480601,457,53,1,3,5,0,35,554
064480602,350,32,3,3,2,0,12,402
064480603,224,20,3,8,0,0,6,261
064480604,249,40,2,1,2,1,4,299
064480605,200,11,5,9,3,1,10,239
064480606,325,40,3,11,0,2,20,401
064480607,281,29,6,7,2,1,14,340
064480608,371,42,2,5,2,3,16,441
064480609,227,29,2,2,0,2,16,278
064480610,51,9,1,2,0,4,22,89
064480611,6,1,0,0,4,1,8,20
064480612,32,1,0,0,0,1,4,38
064480613,2,8,0,0,0,0,0,10
064480614,242,23,0,4,0,0,5,274
064480701,10,0,0,1,0,1,3,15
064480702,1,6,0,0,0,5,1,13
064480703,5,0,0,0,0,6,2,13
064480801,5,0,0,0,0,0,10,15
064480802,8,0,0,0,0,0,4,12
064480803,8,1,0,0,0,0,15,24
064480901,5,1,0,0,0,0,0,6
064480902,8,1,0,0,0,0,0,9
064480903,3,1,0,0,0,0,1,5
064480904,6,2,0,0,0,0,1,9
064481001,6,3,0,0,0,0,0,9
064481002,7,1,0,0,0,2,0,10
064481003,3,8,0,0,0,0,2,13
064481004,3,4,0,0,0,0,3,10
064481101,5,0,0,0,0,0,15,20
064481102,10,1,0,0,0,0,2,13
064481103,6,6,0,0,0,0,1,13
064481201,7,2,0,0,0,4,0,13
064481202,5,8,0,0,0,0,3,16
064481203,8,12,0,0,0,0,0,20
064481204,4,6,0,0,0,0,1,11
064481205,16,0,0,0,0,0,12,28
064481206,4,9,0,0,0,0,0,13
064550101,308,20,0,7,0,3,10,348
064550102,262,10,0,0,2,0,13,287
064550103,247,25,15,3,11,3,19,323
064550104,223,29,4,4,7,5,16,288
064550105,257,20,4,1,0,3,1,286
064550106,269,14,2,1,2,1,7,296
064550107,180,27,1,2,0,1,2,213
064550108,261,11,2,5,0,0,11,290
064550109,259,44,3,6,1,0,1,314
064550110,266,44,13,6,1,1,14,345
064550111,140,11,5,3,0,0,11,170
064550112,176,20,2,6,0,5,9,218
064550113,207,27,1,0,0,0,1,236
064550114,209,32,4,14,2,8,21,290
064550115,151,17,3,1,0,1,8,181
064550201,30,10,0,0,0,11,1,52
064550301,46,15,0,0,0,12,30,103
064550401,80,1,0,1,0,25,47,154
064550501,27,5,0,0,0,2,8,42
064550601,58,10,3,5,0,7,6,89
064550602,18,6,0,0,0,5,4,33
064550603,38,16,0,2,0,3,7,66
064550604,55,13,1,4,0,26,19,118
064550605,19,8,0,0,0,0,0,27
064550606,15,0,0,0,0,4,3,22
064550607,51,5,0,1,0,14,10,81
064550701,66,27,0,0,0,1,13,107
064550801,17,1,0,0,0,7,2,27
064550802,26,28,0,3,0,7,21,85
064550901,36,14,0,1,0,10,11,72
064551001,25,8,0,0,0,0,4,37
064551101,58,26,0,0,0,16,24,124
064551201,62,19,1,0,0,28,13,123
064551301,147,84,2,0,0,12,15,260
064551401,271,17,2,1,0,0,10,301
064551402,422,18,4,10,0,9,9,472
064551403,143,17,1,61,0,3,6,231
064551404,156,16,0,1,0,1,3,177
064551405,276,22,4,4,0,3,17,326
064551406,303,14,5,3,3,5,26,359
064551407,289,36,3,2,1,0,13,344
064551408,306,23,1,1,1,4,10,346
064551409,75,5,1,0,2,2,2,87
064551410,282,21,5,8,1,3,6,326
064551411,214,8,6,1,0,6,5,240
064551412,350,23,11,7,0,4,8,403
064551413,309,22,8,1,6,2,22,370
064551414,239,32,8,9,21,5,26,340
064620101,12,7,0,0,0,2,17,38
064620201,33,3,1,0,2,0,7,46
064620202,12,0,0,0,0,1,3,16
064620203,7,9,0,0,0,1,6,23
064620301,9,8,0,0,0,0,12,29
064620401,111,12,1,5,0,0,2,131
064620402,269,21,7,4,0,1,11,313
064620403,386,31,8,5,2,2,10,444
064620404,38,13,0,0,0,5,1,57
064620405,36,15,0,0,0,3,6,60
064620406,110,10,1,2,0,4,2,129
064620501,6,0,0,0,0,6,20,32
064620502,11,1,0,0,0,0,12,24
064620601,104,8,0,2,0,2,19,135
064620602,8,0,0,0,0,4,21,33
064620603,18,0,0,0,0,2,16,36
064620604,11,0,0,0,0,0,20,31
064620605,15,4,0,0,0,0,13,32
064620701,305,17,2,3,2,3,10,342
064620702,284,32,5,0,8,3,24,356
064620703,391,26,4,10,8,2,11,452
064620704,298,17,4,12,1,0,7,339
064620705,304,32,6,7,3,1,5,358
064620706,439,29,4,10,2,4,16,504
064620707,388,28,6,11,1,0,21,455
064620708,277,14,6,3,0,1,8,309
064620709,9,2,0,1,0,1,0,13
064620710,38,3,0,1,0,1,8,51
064620711,8,3,0,2,0,2,1,16
064620712,3,0,0,0,0,0,3,6
064620801,29,0,0,0,0,2,21,52
064620802,322,26,2,4,0,5,24,383
064620901,13,0,0,1,0,0,9,23
064621001,20,11,0,0,0,0,1,32
064621002,340,39,13,6,3,1,19,421
064621101,16,14,0,0,0,0,1,31
064621102,8,1,0,0,0,0,6,15
064621201,109,16,1,0,1,1,8,136
064621202,425,29,7,2,7,2,13,485
064621203,297,30,5,5,3,3,17,360
064621204,8,10,0,0,0,0,1,19
064621205,91,20,2,0,0,3,13,129
064621206,13,3,0,0,0,3,3,22
064621207,22,10,0,0,0,0,0,32
064690101,245,19,5,10,1,0,8,288
064690102,340,28,4,7,6,1,25,411
064690103,232,10,3,1,1,2,8,257
064690104,451,40,6,5,6,1,17,526
064690105,241,20,7,4,3,0,6,281
064690106,342,43,2,7,13,2,11,420
064690107,260,44,12,1,7,1,13,338
064690108,347,37,7,4,8,0,24,427
064690109,401,23,7,9,1,1,19,461
064690110,228,20,6,8,1,2,5,270
064690111,287,20,5,3,0,0,8,323
064690112,212,18,5,1,2,0,14,252
064690113,254,23,4,6,0,1,5,293
064690114,250,32,4,5,3,0,2,296
064690201,278,27,15,6,11,0,16,353
064690202,337,26,13,3,1,3,19,402
064690203,315,15,6,10,0,0,8,354
064690204,384,28,6,6,2,2,17,445
064690205,271,36,6,2,1,0,15,331
064690206,215,29,7,5,6,1,6,269
064690207,313,45,14,3,8,5,14,402
064690208,388,41,8,6,2,2,11,458
064690209,203,23,8,5,0,2,9,250
064690210,269,30,6,6,1,1,3,316
064690211,252,25,1,8,0,0,4,290
064690212,247,23,1,5,0,0,3,279
064690213,176,16,4,2,0,2,5,205
064690214,262,15,4,4,1,0,5,291
064690301,38,9,0,0,0,0,5,52
064690302,12,1,0,0,0,0,0,13
064690303,10,0,0,0,0,0,3,13
064690304,27,7,0,0,0,0,15,49
064690305,10,0,0,0,1,1,1,13
064690306,16,10,0,0,0,1,0,27
064690401,196,3,0,0,0,1,34,234
064690402,20,6,0,0,0,4,14,44
064690403,9,18,0,0,0,0,0,27
064690404,14,0,0,0,0,5,13,32
064690405,12,1,0,0,0,4,5,22
064690406,15,4,0,0,0,5,11,35
064690501,11,6,0,0,0,1,1,19
064690502,3,2,0,0,0,0,0,5
064690503,8,1,0,0,0,6,0,15
064690504,6,0,0,0,0,6,0,12
064690601,240,19,1,10,0,0,7,277
064690602,400,19,2,0,0,0,6,427
064690603,239,10,1,4,0,0,3,257
064690604,147,10,1,5,0,0,7,170
064690605,337,36,4,3,0,4,45,429
064690606,329,39,0,5,1,2,35,411
064690701,10,2,0,0,0,0,0,12
064690702,7,3,0,0,0,0,4,14
064690703,15,0,0,1,0,2,2,20
064690801,226,18,0,11,1,1,19,276
064690802,48,10,0,0,1,2,13,74
064690803,23,8,0,0,0,0,1,32
064690804,38,8,1,0,0,0,26,73
064690805,23,2,0,0,0,1,12,38
064690806,32,9,0,0,0,0,1,42
064690807,188,21,3,9,1,0,20,242
064690901,240,26,3,5,1,6,14,295
064690902,10,5,0,0,0,2,10,27
064690903,113,29,0,0,0,0,11,153
064690904,11,3,0,0,0,0,3,17
064690905,6,0,0,0,0,0,24,30
064690906,15,4,0,0,0,0,10,29
064690907,14,0,0,0,0,3,8,25
064690908,18,15,0,0,0,1,1,35
064690909,246,22,3,2,7,6,17,303
064691001,123,8,4,5,0,3,6,149
064691002,81,7,0,0,0,0,14,102
064691003,26,1,0,0,0,0,21,48
064691004,21,3,0,1,0,0,11,36
064691005,3,3,0,0,0,1,17,24
064691006,4,0,0,0,0,0,8,12
064691007,169,20,4,6,1,4,3,207
064691101,93,12,2,0,1,0,18,126
064691102,10,3,0,0,0,0,0,13
064691103,5,0,0,1,0,4,6,16
064691104,13,3,0,0,0,0,12,28
064691105,10,2,0,0,0,6,5,23
064691106,183,27,4,3,1,7,15,240
064691107,24,21,0,0,1,2,7,55
064691201,8,3,0,0,0,0,0,11
064691202,9,0,0,0,0,3,0,12
064691203,12,0,0,0,0,0,0,12
064691204,10,3,2,0,0,0,1,16
064691301,264,18,1,8,2,0,11,304
064691302,420,44,9,7,1,3,14,498
064691303,31,15,0,0,0,0,12,58
064691304,11,1,0,0,0,3,11,26
064691305,115,38,6,1,0,1,26,187
064691306,17,2,0,0,0,2,0,21
064691307,256,36,1,3,1,0,7,304
064691401,17,5,0,0,0,0,11,33
064691402,10,7,0,0,0,0,3,20
064691403,24,12,0,0,0,1,8,45
064691404,12,15,0,0,0,0,4,31
064691501,322,22,5,6,0,6,29,390
064691502,13,5,0,0,0,2,5,25
064691503,4,1,0,0,0,2,12,19
064691504,2,1,0,0,0,0,7,10
064691505,4,1,0,0,0,1,6,12
064691506,16,4,0,1,0,2,13,36
064691507,68,6,0,0,0,1,1,76
064691508,271,40,1,4,0,3,20,339
064760101,224,0,1,1,0,0,9,235
064760102,276,11,0,2,3,0,8,300
064760103,183,21,2,1,7,4,7,225
064760104,185,13,4,3,5,0,5,215
064760105,207,15,5,1,2,0,8,238
064760106,256,15,1,6,0,0,8,286
064760107,255,17,6,3,2,1,14,298
064760108,291,14,0,2,2,2,2,313
064760201,406,35,4,12,0,7,21,485
064760202,54,16,0,0,0,1,5,76
064760203,42,16,0,0,0,1,10,69
064760204,25,3,0,0,0,5,10,43
064760205,36,5,0,1,0,0,3,45
064760206,23,6,0,0,0,0,7,36
064760207,25,2,0,0,0,0,9,36
064760208,20,0,0,0,0,2,14,36
064760301,29,11,0,1,0,3,7,51
064760302,15,1,0,0,0,5,13,34
064760303,10,2,0,0,0,0,7,19
064760401,7,2,0,0,0,0,0,9
064760402,8,3,0,0,0,1,8,20
064760403,7,3,0,0,0,0,6,16
064760404,15,9,0,0,0,0,4,28
064760501,21,6,0,1,5,0,1,34
064760502,24,7,0,0,0,5,2,38
064760503,15,14,0,1,0,0,2,32
064760504,15,8,0,0,0,2,1,26
064760505,11,10,0,0,0,0,4,25
064760601,9,1,0,0,0,0,5,15
064760602,12,12,0,0,0,0,12,36
064760603,37,0,0,0,0,12,32,81
064760604,7,10,0,0,0,1,10,28
064760701,96,5,0,1,0,0,5,107
064760702,47,7,1,1,0,3,5,64
064760703,78,10,1,2,4,6,5,106
064760704,46,1,0,0,0,4,17,68
064760705,51,4,0,0,0,1,9,65
064760706,6,0,0,0,0,1,5,12
064760707,129,12,0,3,3,1,18,166
064760708,178,11,0,1,0,0,16,206
064760709,15,5,0,0,0,0,5,25
064760801,19,12,0,0,0,0,2,33
064760802,16,6,0,0,0,2,1,25
064760803,13,3,0,0,0,4,8,28
064760804,17,13,0,0,0,0,2,32
064760901,18,6,0,0,0,2,2,28
064760902,16,16,0,0,0,3,10,45
064760903,16,2,0,0,0,1,4,23
064760904,8,1,0,1,0,5,13,28
064760905,7,1,0,0,0,0,1,9
064761001,30,12,0,0,0,0,5,47
064761002,8,11,0,0,0,0,0,19
064761003,9,3,0,0,0,1,4,17
064761101,10,0,0,0,0,2,2,14
064761102,24,17,0,0,0,0,0,41
064761103,20,4,0,0,0,2,9,35
064761104,8,1,0,0,0,3,11,23
064761105,19,18,0,0,0,0,3,40
064761201,3,0,0,4,0,9,1,17
064761202,26,12,0,0,0,2,3,43
064761203,25,7,0,0,0,0,0,32
064761204,21,0,0,0,0,22,0,43
064761205,26,16,0,0,0,0,2,44
064761206,27,2,0,0,0,2,14,45
064761301,38,6,0,0,0,0,0,44
064761401,230,7,1,2,1,0,7,248
064761402,275,13,0,0,0,0,1,289
064761403,305,28,0,1,0,3,8,345
064761404,255,22,5,5,0,1,3,291
064761405,214,13,3,5,4,0,15,254
064761406,206,18,1,1,6,0,9,241
064761407,144,29,6,1,0,0,9,189
064761408,301,12,4,4,2,2,5,330
064830101,437,12,3,15,10,6,16,499
064830102,353,29,4,19,4,2,8,419
064830103,384,15,5,4,4,11,11,434
064830104,249,15,7,4,6,2,8,291
064830105,272,14,9,5,8,2,21,331
064830106,294,30,7,11,9,3,17,371
064830107,214,39,22,6,26,3,23,333
064830108,235,27,6,3,15,1,20,307
064830109,272,30,5,1,2,4,16,330
064830110,291,28,4,2,3,1,12,341
064830111,243,11,9,4,1,1,16,285
064830112,202,7,2,4,0,0,5,220
064830113,232,13,2,10,2,2,6,267
064830114,287,7,3,12,0,4,7,320
064830115,212,5,6,7,1,1,11,243
064830116,212,5,8,12,1,3,6,247
064830117,273,16,8,8,0,4,3,312
064830118,235,15,4,3,0,0,6,263
064830201,13,5,0,0,0,7,1,26
064830202,33,0,0,2,0,4,0,39
064830203,20,1,2,0,0,5,1,29
064830301,72,1,4,2,0,1,2,82
064830302,87,5,0,2,0,17,13,124
064830303,69,1,1,0,0,7,9,87
064830304,52,21,0,0,0,1,2,76
064830401,177,30,3,13,0,10,24,257
064830402,176,18,2,4,0,2,2,204
064830403,149,6,4,2,0,1,5,167
064830404,347,8,5,7,1,5,6,379
064830405,263,30,1,6,0,4,4,308
064830406,100,6,1,7,0,3,1,118
064830407,364,13,4,4,0,6,1,392
064830408,250,8,3,2,1,3,11,278
064830409,284,15,2,6,0,6,9,322
064830410,174,11,1,4,0,6,7,203
064830411,193,6,2,2,0,1,9,213
064830412,259,20,9,8,0,4,8,308
064830413,368,28,5,7,1,10,12,431
064830414,264,19,2,6,0,1,4,296
064830415,310,9,2,10,0,5,5,341
064830416,216,7,1,7,0,6,14,251
064830417,114,16,1,10,2,7,8,158
064830501,319,22,4,8,0,4,9,366
064830502,37,3,1,0,1,20,2,64
064830503,57,7,0,1,0,2,9,76
064830504,66,10,0,2,0,10,7,95
064830505,41,1,0,0,0,20,6,68
064830506,9,3,1,0,0,0,3,16
064830601,31,4,0,0,0,0,0,35
064830602,119,27,1,17,1,46,11,222
064830701,110,7,0,0,0,1,6,124
064830702,50,9,0,1,2,4,11,77
064830703,30,0,2,0,0,8,16,56
064830704,8,3,0,0,0,0,0,11
064830705,17,5,0,0,0,1,4,27
064830706,28,8,0,0,0,0,1,37
064830801,106,7,1,2,0,3,2,121
064830802,43,5,0,0,0,6,8,62
064830803,29,2,0,0,0,0,2,33
064830804,35,27,0,0,0,2,2,66
064830805,16,8,0,0,0,9,2,35
064830806,133,23,4,1,0,3,6,170
064830901,84,12,8,8,0,96,36,244
064830902,39,6,1,0,0,5,7,58
064830903,73,12,1,4,0,10,20,120
064830904,33,3,3,6,0,58,0,103
064830905,37,2,0,0,0,8,8,55
064830906,28,5,0,1,0,10,3,47
064830907,27,0,1,0,0,15,13,56
064830908,83,20,8,1,1,117,12,242
064831001,29,8,0,1,0,8,8,54
064831002,39,12,0,0,0,7,0,58
064970101,376,22,13,4,11,2,17,445
064970102,196,15,10,3,10,1,5,240
064970103,199,23,2,1,1,0,5,231
064970104,304,13,15,3,20,1,18,374
064970105,290,25,20,3,17,0,22,377
064970106,316,33,15,4,8,1,36,413
064970107,208,10,2,6,13,0,4,243
064970108,189,16,1,4,0,1,8,219
064970109,191,7,2,5,0,0,7,212
064970110,243,15,12,2,0,0,13,285
064970111,272,12,3,4,0,0,2,293
064970112,244,10,2,3,0,0,0,259
064970201,163,14,2,27,12,14,13,245
064970202,20,0,0,0,0,22,4,46
064970203,41,4,0,3,0,18,7,73
064970204,20,5,0,0,0,6,1,32
064970205,8,0,0,1,0,7,1,17
064970206,16,1,0,1,0,3,10,31
064970207,47,7,0,1,1,32,6,94
064970301,9,4,0,0,0,3,9,25
064970302,364,25,12,13,1,10,21,446
064970303,220,24,3,10,1,6,17,281
064970304,23,3,0,0,0,9,3,38
064970305,204,295,8,4,0,12,11,534
064970306,192,2,4,4,0,3,4,209
064970307,404,18,2,12,0,5,5,446
064970308,337,9,3,3,1,0,13,366
064970309,160,11,0,5,0,0,5,181
064970310,114,5,2,2,1,0,1,125
064970311,276,9,8,10,0,0,16,319
064970312,333,23,2,13,2,3,21,397
064970401,28,0,0,1,0,4,0,33
064970402,59,1,0,6,0,37,2,105
064970403,109,0,3,6,0,13,0,131
064970404,166,3,1,1,1,10,4,186
064970405,164,10,2,1,0,1,6,184
064970406,173,17,4,6,0,3,3,206
064970407,174,31,1,4,0,1,9,220
064970408,94,11,0,10,0,40,2,157
064970409,210,17,1,7,0,2,8,245
064970410,225,40,1,4,0,3,7,280
064970501,229,9,10,6,1,3,4,262
064970502,215,16,7,4,0,0,4,246
064970503,315,10,5,1,1,0,8,340
064970504,308,17,3,14,0,2,8,352
064970505,387,23,4,12,1,0,9,436
064970506,366,9,2,13,0,1,17,408
064970507,337,21,6,10,0,0,2,376
064970508,317,26,7,23,1,0,6,380
064970509,396,25,8,9,1,1,8,448
064970510,401,21,7,9,1,1,6,446
064970511,346,12,4,4,0,3,14,383
064970512,311,6,3,6,2,1,11,340
064970513,350,30,5,7,2,1,14,409
064970601,292,13,8,10,0,3,9,335
064970602,320,14,15,9,1,1,7,367
064970603,156,13,2,9,0,1,1,182
064970604,282,22,5,7,0,0,14,330
064970605,290,9,7,10,0,4,8,328
064970606,98,4,4,2,0,1,4,113
064970607,354,11,4,18,1,11,7,406
064970608,26,3,0,0,0,5,0,34
064970609,182,14,6,24,0,25,19,270
064970610,201,14,2,22,1,7,12,259
064970611,187,0,7,21,2,114,11,342
064970612,64,0,0,6,0,9,8,87
064970613,186,10,2,6,2,3,15,224
064970614,131,25,0,2,0,14,37,209
064970701,288,22,4,5,7,0,20,346
064970702,123,10,2,1,19,2,22,179
064970703,146,25,19,4,14,0,10,218
064970704,138,19,2,1,18,3,11,192
064970705,301,27,16,8,23,7,23,405
064970706,289,64,22,3,39,2,18,437
064970707,144,25,21,5,37,0,26,258
064970708,280,44,29,4,54,1,22,434
064970709,194,11,10,0,5,1,19,240
064970710,211,23,12,2,9,1,5,263
064970801,210,3,2,3,0,0,1,219
064970802,256,11,1,1,0,6,3,278
064970803,222,25,1,5,1,19,2,275
064970804,61,2,2,2,0,2,11,80
064970805,48,6,2,2,0,4,9,71
064970806,209,11,1,8,1,2,8,240
064970807,224,8,2,2,0,2,6,244
064970808,79,1,1,26,0,1,3,111
064970809,276,13,5,14,0,3,9,320
064970810,291,15,5,3,0,1,2,317
064970811,392,19,3,5,1,2,13,435
064970812,480,9,3,4,0,2,12,510
064970813,200,4,0,1,0,1,5,211
064970814,210,7,1,0,0,4,8,230
064970815,230,27,6,16,3,27,12,321
064970901,29,13,0,0,0,7,5,54
064971001,204,13,0,3,7,18,17,262
064971002,49,1,0,0,0,9,4,63
064971003,17,0,0,0,0,0,4,21
064971004,30,3,0,0,0,1,16,50
064971005,11,11,0,0,0,1,11,34
064971006,22,1,1,0,0,39,5,68
064971007,11,0,0,0,0,0,2,13
064971008,309,13,1,4,0,8,11,346
064971101,344,23,10,2,3,0,28,410
064971102,356,25,3,2,5,1,17,409
064971103,302,26,18,5,4,0,7,362
064971104,395,25,11,2,7,4,16,460
064971105,329,35,10,7,7,1,8,397
064971106,359,34,12,4,3,1,12,425
064971107,301,20,5,2,1,4,7,340
064971108,261,17,6,3,2,1,2,292
064971201,261,23,6,18,1,0,4,313
064971202,404,18,0,8,1,0,5,436
064971203,277,9,4,4,2,0,9,305
064971204,254,5,8,5,0,1,3,276
064971205,347,16,4,11,2,1,10,391
064971206,287,14,5,5,5,0,10,326
064971207,308,14,1,13,4,2,10,352
064971208,118,24,3,14,1,28,4,192
064971209,45,13,0,1,0,0,5,64
064971210,125,47,2,12,0,30,13,229
064971211,123,19,5,5,1,12,43,208
064971212,87,0,0,14,0,58,9,168
064971301,431,16,0,14,0,1,4,466
064971302,348,6,4,7,1,1,4,371
064971303,164,1,4,6,0,4,59,238
064971304,135,19,3,14,4,49,2,226
064971305,76,1,0,11,0,16,8,112
064971306,309,18,1,2,3,6,14,353
064971307,261,10,7,2,1,2,7,290
064971308,264,18,1,3,0,0,13,299
064971309,144,4,1,3,0,0,4,156
064971310,29,0,0,0,1,0,4,34
064971311,4,2,0,0,0,1,8,15
064971401,395,20,3,8,1,5,13,445
064971402,357,13,8,4,4,0,2,388
064971403,486,14,2,21,1,2,10,536
064971404,24,0,0,0,0,3,3,30
064971405,312,8,4,7,1,7,7,346
064971406,369,16,10,6,2,1,11,415
064971407,159,19,20,5,5,1,18,227
064971408,236,7,11,2,6,0,11,273
064971409,298,20,1,4,1,0,13,337
064971410,282,17,7,2,1,0,6,315
065050101,19,0,0,0,0,10,1,30
065050102,33,5,0,1,0,1,7,47
065050103,57,22,0,0,0,10,0,89
065050104,8,1,0,0,0,2,2,13
065050105,33,0,0,0,0,11,8,52
065050106,15,1,0,0,0,3,3,22
065050201,145,5,5,5,0,8,9,177
065050202,24,10,0,1,0,12,3,50
065050203,11,5,0,0,0,6,4,26
065050204,105,5,0,2,0,63,12,187
065050205,92,18,1,0,0,48,8,167
065050206,44,18,0,0,0,17,6,85
065050207,13,0,0,0,0,7,7,27
065050208,24,3,0,1,0,2,8,38
065050209,34,8,0,1,0,3,3,49
065050210,181,8,5,9,1,6,15,225
065050211,176,18,0,1,11,4,4,214
065050212,134,13,3,8,3,1,8,170
065050301,47,3,3,0,0,55,8,116
065050302,60,2,0,3,2,85,10,162
065050303,60,10,3,6,0,70,4,153
065050304,65,5,0,4,0,48,8,130
065050305,48,27,8,4,0,27,10,124
065050306,329,38,5,10,2,11,17,412
065050307,164,14,0,7,1,2,11,199
065050308,257,12,8,7,0,2,3,289
065050309,229,19,5,3,0,2,11,269
065050310,158,9,1,1,0,3,12,184
065050311,254,46,2,3,9,1,12,327
065050312,239,13,8,5,2,4,4,275
065050313,160,6,1,1,0,2,2,172
065050314,244,18,1,13,1,2,3,282
065050315,264,11,4,5,0,1,17,302
065050316,88,13,0,4,0,5,9,119
065050317,88,5,2,6,0,10,5,116
065050318,77,9,3,2,0,0,1,92
065050319,298,21,6,13,4,10,11,363
065050320,179,10,4,3,0,0,6,202
065050321,157,11,3,4,0,3,10,188
065050322,184,4,1,3,0,8,31,231
065050401,95,18,0,4,2,9,17,145
065050402,96,17,0,2,0,40,5,160
065050403,30,3,0,1,0,10,5,49
065050404,32,0,0,0,0,0,0,32
065050405,19,5,0,0,0,1,1,26
065050406,33,20,0,0,0,0,0,53
065050407,43,7,0,0,0,1,1,52
065110101,18,0,2,0,0,1,2,23
065110102,10,6,0,0,0,0,1,17
065110201,16,14,0,0,0,0,0,30
065110202,25,13,0,0,0,0,3,41
065110301,33,8,0,1,0,2,6,50
065110302,14,1,0,0,0,2,4,21
065110303,22,3,0,0,0,3,11,39
065110304,41,10,0,0,0,1,10,62
065110401,30,5,0,0,1,5,2,43
065110402,6,1,0,0,0,9,2,18
065110501,100,20,0,3,0,2,4,129
065110502,293,53,5,4,0,0,10,365
065110503,375,41,8,8,1,1,17,451
065110504,276,36,3,4,1,1,9,330
065110505,298,33,1,6,3,3,12,356
065110506,236,19,6,3,10,4,52,330
065110507,293,35,6,4,8,4,13,363
065110508,312,35,1,4,2,1,19,374
065110509,176,19,0,2,0,4,14,215
065110510,7,0,0,0,0,1,1,9
065110511,16,7,1,0,0,3,4,31
065110512,357,16,2,11,0,0,3,389
065110513,193,34,2,31,1,4,20,285
065110601,130,29,2,8,0,0,8,177
065110602,27,2,0,0,0,6,16,51
065110603,24,11,0,2,0,5,20,62
065110701,24,6,0,0,0,3,8,41
065110702,17,10,0,0,0,0,3,30
065180101,182,10,2,3,0,0,15,212
065180102,121,12,1,7,0,0,0,141
065180103,181,17,1,4,0,2,5,210
065180104,55,3,0,0,0,16,3,77
065180105,7,4,0,0,0,0,5,16
065180106,3,4,0,0,0,0,1,8
065180107,11,1,0,0,0,1,6,19
065180108,6,9,0,0,0,0,0,15
065180109,9,0,0,0,0,1,2,12
065180110,3,2,0,0,0,0,0,5
065180111,50,5,0,0,0,0,1,56
065180112,25,1,0,0,0,0,11,37
065180113,16,11,0,1,0,0,4,32
065180114,142,22,1,2,0,0,3,170
065180115,190,22,0,4,0,1,4,221
065180201,96,4,0,0,0,0,1,101
065180202,188,9,0,2,0,0,4,203
065180203,241,22,4,2,5,4,6,284
065180204,321,20,1,7,2,1,7,359
065180205,351,16,1,1,0,4,12,385
065180206,187,17,1,2,0,3,6,216
065180207,16,1,0,1,0,2,9,29
065180208,35,0,0,0,0,2,18,55
065180209,76,7,0,1,1,0,2,87
065180210,0,0,0,0,0,0,1,1
065180211,205,8,0,8,0,1,4,226
065180212,159,11,1,43,1,0,5,220
065180301,71,9,0,0,0,0,3,83
065180302,110,18,0,3,0,0,5,136
065180303,66,19,0,2,0,7,19,113
065180304,41,8,0,0,0,2,4,55
065180305,27,12,0,0,0,2,8,49
065180401,12,3,0,0,0,5,0,20
065180402,20,8,0,0,0,10,6,44
065180403,6,9,0,0,0,0,8,23
065180404,20,10,0,0,0,2,3,35
065180405,14,4,0,0,0,5,8,31
065180406,5,0,0,0,0,0,11,16
065180407,6,6,0,0,0,0,0,12
065180408,10,6,0,0,0,0,0,16
065180409,5,0,0,0,0,0,3,8
065180410,6,0,0,0,0,2,0,8
065180411,3,0,0,0,0,0,1,4
065180412,12,0,0,0,0,0,3,15
065180501,11,0,0,0,0,3,6,20
065180502,10,1,0,0,0,6,3,20
065180503,18,4,0,0,0,5,1,28
065180504,228,29,3,5,1,2,5,273
065180505,7,0,0,0,0,0,2,9
065180506,67,12,0,3,0,1,3,86
065180507,8,2,0,1,0,0,5,16
065180508,6,0,0,0,0,7,2,15
065180509,3,0,0,0,0,3,2,8
065180510,20,8,0,0,0,0,1,29
065180511,34,30,0,3,0,50,3,120
065180601,53,33,27,7,14,82,30,246
065180602,75,19,123,17,2,124,28,388
065180603,76,37,24,10,2,85,27,261
065180604,176,43,14,11,0,197,31,472
065180605,74,12,10,4,0,51,9,160
065180606,79,15,10,5,0,62,3,174
065180607,62,22,5,3,0,31,2,125
065180608,4,1,0,0,0,1,5,11
065180609,61,19,4,4,0,77,2,167
065180610,37,30,1,3,0,19,3,93
065180611,51,16,2,6,0,101,2,178
065180612,67,1,7,7,2,95,5,184
065180613,58,0,18,14,0,76,24,190
065180614,93,13,0,10,0,65,18,199
065180615,9,0,0,0,0,5,2,16
065180701,27,0,0,0,0,0,1,28
065180702,41,0,0,24,1,48,2,116
065180703,67,0,5,24,1,89,2,188
065180704,76,74,81,16,1,124,35,407
065180705,100,64,68,16,1,161,22,432
065180706,47,19,28,4,0,93,52,243
065180707,53,2,11,8,0,143,34,251
065180708,125,42,16,16,0,188,40,427
065180709,103,20,3,5,0,91,7,229
065180710,102,24,1,10,1,126,11,275
065180711,188,41,5,15,0,66,15,330
065180712,180,38,8,11,1,34,8,280
065180713,127,19,5,12,4,60,18,245
065180714,114,8,20,8,2,81,2,235
065180715,114,46,9,6,4,75,22,276
065180716,98,27,44,14,0,186,16,385
065180717,100,41,42,11,3,172,8,377
065180801,3,0,0,0,0,0,3,6
065180802,42,6,8,5,0,41,15,117
065180803,74,2,29,8,0,199,19,331
065180804,47,81,13,4,0,66,9,220
065180805,4,0,0,0,0,0,0,4
065180806,8,3,0,0,0,0,5,16
065180807,33,21,9,16,0,105,10,194
065180808,82,33,17,28,3,215,12,390
065180809,110,18,3,27,1,160,14,333
065180810,53,22,3,33,0,43,16,170
065180811,15,0,0,0,0,0,0,15
065180812,65,39,6,7,0,53,5,175
065180813,7,8,0,0,0,0,0,15
065180814,3,0,0,0,0,0,0,3
065250101,148,21,3,3,0,2,3,180
065250102,153,5,1,5,0,0,3,167
065250103,124,0,4,4,0,1,5,138
065250104,173,8,1,4,0,1,3,190
065250105,270,21,1,15,0,2,2,311
065250106,295,20,2,12,2,7,13,351
065250107,317,7,7,6,3,5,35,380
065250108,328,20,10,5,10,1,7,381
065250109,337,27,2,7,4,8,4,389
065250110,253,11,5,5,4,1,10,289
065250111,382,26,9,9,3,5,15,449
065250112,171,8,0,1,0,0,1,181
065250113,157,22,1,7,0,4,8,199
065250114,247,21,6,7,1,14,9,305
065250201,21,4,0,0,0,1,4,30
065250202,40,1,0,0,0,3,7,51
065250203,302,24,3,16,1,37,26,409
065250204,146,41,9,20,0,262,24,502
065250301,33,8,0,0,0,2,0,43
065250302,34,0,0,0,0,5,0,39
065250303,390,7,2,15,0,3,6,423
065250304,245,15,4,5,1,5,8,283
065250401,393,19,2,10,3,1,13,441
065250402,405,19,1,15,0,0,6,446
065250403,219,6,3,7,0,0,0,235
065250404,330,12,0,4,0,1,2,349
065250405,406,15,0,11,1,0,13,446
065250406,447,22,4,4,0,9,10,496
065250407,260,11,0,9,1,1,9,291
065250408,395,20,5,2,0,9,12,443
065250409,329,23,4,2,0,4,9,371
065250410,13,0,0,0,0,0,14,27
065250411,77,6,0,1,0,6,4,94
065250412,78,11,1,3,1,5,6,105
065250413,70,0,0,107,0,7,12,196
065250414,361,24,9,13,0,1,11,419
065250415,260,19,0,5,0,1,5,290
065250416,135,7,0,3,0,9,13,167
065250417,423,31,1,7,0,0,2,464
065250418,384,15,1,6,0,6,10,422
065250501,498,31,3,10,1,37,18,598
065250502,33,1,1,0,0,3,1,39
065250503,19,3,0,0,0,1,5,28
065250504,116,17,0,4,0,25,13,175
065250601,123,4,1,0,0,7,8,143
065250602,110,8,0,3,0,13,8,142
065250603,138,9,0,9,1,4,3,164
065250604,185,8,5,8,0,7,1,214
065250605,183,2,3,8,3,7,1,207
065250606,482,11,10,10,3,6,21,543
065250607,534,14,9,24,1,10,14,606
065250608,223,12,1,7,1,5,13,262
065250609,263,13,0,2,0,2,5,285
065250610,344,22,6,18,3,5,12,410
065250611,471,26,10,9,11,5,21,553
065250612,293,18,1,9,1,1,7,330
065250613,299,19,3,4,4,0,14,343
065250614,164,9,3,4,0,0,7,187
065320101,534,1,6,13,0,1,11,566
065320102,362,0,6,4,2,5,29,408
065320103,288,2,7,4,8,4,13,326
065320104,321,18,7,4,2,1,8,361
065320105,286,19,8,5,5,0,14,337
065320106,306,10,7,1,8,0,16,348
065320107,243,20,7,4,14,1,18,307
065320108,261,44,9,3,35,0,23,375
065320109,227,25,15,6,9,0,20,302
065320110,282,22,15,4,6,1,15,345
065320111,326,10,4,2,0,3,12,357
065320112,302,19,1,3,5,10,22,362
065320201,233,54,19,4,36,1,29,376
065320202,289,14,6,2,14,0,27,352
065320203,276,6,20,7,2,1,35,347
065320204,270,7,12,2,3,1,23,318
065320205,199,5,8,2,1,0,19,234
065320206,234,20,8,5,21,2,1,291
065320207,331,26,6,11,5,1,9,389
065320208,253,28,8,3,17,0,24,333
065320301,298,7,3,7,0,2,6,323
065320302,492,17,6,12,0,0,10,537
065320303,278,14,0,5,3,4,5,309
065320304,219,13,7,4,1,10,3,257
065320305,294,6,5,8,0,2,7,322
065320306,285,16,3,8,1,1,13,327
065320307,259,7,5,3,0,1,8,283
065320308,331,8,3,6,1,0,6,355
065320309,399,19,5,8,11,4,16,462
065320310,257,8,0,2,1,2,3,273
065320311,250,9,2,5,0,2,8,276
065320312,217,21,1,2,1,1,6,249
065320313,180,3,4,6,0,4,3,200
065320401,79,8,2,7,0,15,11,122
065320402,24,1,1,0,0,13,18,57
065320403,88,11,0,1,1,11,5,117
065320501,11,0,1,0,0,3,1,16
065320502,30,2,0,0,0,0,0,32
065320503,49,0,0,0,0,17,0,66
065320504,49,0,0,0,0,3,9,61
065320601,7,9,0,0,0,0,0,16
065320602,8,2,0,0,0,1,6,17
065320603,13,0,1,0,0,6,8,28
065320604,10,1,0,0,0,6,2,19
065320701,42,2,0,0,0,22,7,73
065320801,22,0,0,1,0,13,3,39
065320802,29,8,0,1,0,5,0,43
065320803,13,0,0,1,0,11,9,34
065320804,34,8,0,0,0,1,3,46
065320805,43,8,0,1,0,21,4,77
065320901,448,8,5,52,2,20,22,557
065320902,210,23,2,24,0,19,34,312
065320903,119,8,2,9,0,7,17,162
065320904,189,7,3,5,0,57,8,269
065320905,178,24,3,17,0,25,1,248
065320906,89,14,1,2,0,18,6,130
065320907,112,8,2,4,0,56,10,192
065320908,125,15,2,14,0,20,6,182
065320909,157,0,4,10,2,112,4,289
065320910,782,22,4,13,0,18,14,853
065320911,225,9,3,8,0,27,20,292
065320912,104,3,2,9,7,89,8,222
065321001,319,29,4,12,1,20,6,391
065321002,21,0,0,0,0,4,2,27
065321003,32,3,1,5,1,8,4,54
065321004,18,2,1,0,0,8,7,36
065321005,23,2,0,0,0,3,9,37
065321101,62,2,2,3,5,25,2,101
065321102,64,16,1,0,0,5,22,108
065321103,25,5,5,2,0,12,5,54
065321104,11,3,0,0,0,0,0,14
065321201,16,0,0,0,0,12,7,35
065321202,9,0,1,0,0,8,0,18
065321203,15,0,0,0,0,7,3,25
065321301,10,0,0,1,0,1,0,12
065321302,11,0,0,0,0,1,0,12
065321303,4,1,0,0,0,0,1,6
065321401,266,16,8,1,0,1,39,331
065321402,276,13,7,7,0,0,19,322
065321403,343,25,6,2,0,0,35,411
065321404,306,24,8,5,0,2,21,366
065321405,286,27,13,4,9,1,23,363
065321406,273,50,17,10,0,3,31,384
065321407,194,26,7,3,2,3,21,256
065321408,274,27,8,4,3,1,19,336
065321501,249,9,5,4,1,1,3,272
065321502,302,15,8,22,0,7,6,360
065321503,241,21,3,8,1,4,2,280
065321504,296,10,5,6,2,3,3,325
065321505,287,11,8,2,0,0,5,313
065321506,319,13,0,3,3,1,8,347
065321507,255,20,4,3,2,7,4,295
065321508,276,3,3,0,1,2,11,296
065321509,325,17,2,21,5,6,14,390
065321510,239,6,4,2,17,0,3,271
065321511,403,32,10,1,3,0,13,462
065321512,422,23,6,4,0,8,13,476
065470101,33,19,0,1,1,7,13,74
065470102,22,0,0,0,0,3,13,38
065470201,194,8,3,8,4,19,11,247
065470202,20,1,0,0,0,7,13,41
065470203,43,9,0,0,1,2,7,62
065470301,32,2,0,1,0,10,2,47
065470302,43,16,0,0,0,7,4,70
065470303,25,5,0,0,0,3,8,41
065470304,33,11,0,0,0,15,7,66
065470305,234,18,0,5,0,2,13,272
065470306,395,35,3,11,2,12,6,464
065470307,382,22,2,5,0,3,12,426
065470308,110,13,2,2,1,2,5,135
065470309,257,15,3,5,0,44,16,340
065470310,121,6,1,11,0,112,12,263
065470311,116,13,11,7,0,85,13,245
065470312,391,34,4,10,6,32,5,482
065470313,57,10,1,2,0,9,8,87
065470401,11,7,0,0,0,5,4,27
065470402,56,35,0,0,0,4,5,100
065470501,27,0,0,0,0,3,6,36
065470502,32,5,0,1,0,3,7,48
065470503,22,7,2,0,1,3,13,48
065470601,73,1,0,0,0,31,30,135
065470602,27,0,0,1,0,12,13,53
065470603,80,27,5,8,0,19,17,156
065470701,16,0,0,0,0,6,0,22
065470702,20,0,0,0,0,0,3,23
065470703,37,0,0,11,0,112,1,161
065470801,71,31,0,0,0,6,20,128
065470802,41,4,0,1,0,25,18,89
065470901,208,21,1,6,3,126,30,395
065470902,307,25,5,16,0,9,9,371
065470903,295,12,2,8,0,5,10,332
065470904,438,31,7,13,3,3,9,504
065470905,414,20,8,10,1,8,10,471
065470906,345,28,9,4,2,4,26,418
065470907,410,43,9,8,6,7,10,493
065470908,364,20,6,7,4,4,18,423
065470909,293,33,5,2,1,3,14,351
065470910,281,41,1,2,6,6,21,358
065530101,242,20,4,4,1,107,6,384
065530102,143,50,8,5,1,117,20,344
065530103,147,47,28,5,6,262,10,505
065530104,47,47,4,2,0,60,5,165
065530105,75,2,21,4,1,195,15,313
065530106,88,95,1,4,2,61,16,267
065530107,58,42,18,1,1,313,6,439
065530108,85,0,29,0,5,291,17,427
065530109,51,7,16,0,0,254,7,335
065530110,37,19,5,4,0,341,5,411
065530111,17,102,1,0,0,265,10,395
065530201,5,0,0,0,0,1,1,7
065530202,34,15,25,24,0,176,23,297
065530203,60,1,31,20,0,179,23,314
065530204,367,37,11,41,0,277,19,752
065530205,52,106,7,5,1,212,46,429
065530301,67,1,6,8,0,155,21,258
065530302,86,23,3,3,1,125,17,258
065530303,60,45,13,7,0,58,58,241
065530304,70,33,20,8,1,109,1,242
065530305,99,5,10,5,0,141,3,263
065530306,78,7,16,6,0,249,35,391
065530307,70,67,11,1,1,198,16,364
065530308,37,4,1,2,0,239,9,292
065530309,42,59,19,0,1,198,26,345
065530310,20,13,8,1,2,194,40,278
065530311,18,30,15,2,2,274,37,378
065530312,32,123,11,0,1,148,21,336
065530313,39,87,2,20,0,209,6,363
065530314,44,43,11,4,3,176,31,312
065740101,21,0,0,0,0,9,10,40
065740102,28,0,0,0,0,1,18,47
065740201,14,1,0,0,0,2,10,27
065740202,54,9,0,0,0,3,11,77
065740301,10,2,0,0,0,1,0,13
065740302,32,14,0,0,0,4,0,50
065740303,55,29,0,0,0,3,5,92
065740401,69,6,0,6,0,8,5,94
065740402,367,19,5,48,0,4,22,465
065740403,347,6,7,14,7,8,5,394
065740404,285,8,0,3,0,3,8,307
065740405,245,21,5,9,0,1,11,292
065740406,228,11,1,6,4,2,8,260
065740407,290,17,5,13,4,5,19,353
065740408,306,17,10,2,8,3,20,366
065740409,258,23,7,7,8,10,9,322
065740410,365,21,2,7,1,11,14,421
065740411,250,15,6,7,1,6,6,291
065740412,269,19,3,13,0,5,7,316
065740413,8,0,0,0,0,3,4,15
065740414,311,22,2,20,1,15,11,382
065740415,269,19,1,22,6,14,12,343
065740416,225,23,4,13,0,24,10,299
065740501,25,0,0,0,0,4,11,40
065740502,39,7,0,2,1,7,6,62
065740503,41,10,0,0,0,2,2,55
065740601,41,7,0,1,0,2,23,74
065740602,25,18,0,1,0,1,7,52
065740701,168,11,3,0,0,22,17,221
065740702,65,27,1,1,0,3,5,102
065740703,27,17,0,0,0,0,0,44
065740704,14,7,0,0,0,0,5,26
065740705,32,0,0,0,0,6,12,50
065740706,29,23,4,1,0,2,2,61
065740707,22,0,0,0,0,9,20,51
065740708,24,3,0,0,0,4,14,45
065740801,102,14,0,2,1,7,12,138
065740802,28,8,0,0,0,3,4,43
065740803,27,0,0,0,0,4,33,64
065740804,23,5,0,1,0,2,17,48
065740805,93,11,6,1,6,3,12,132
065740901,15,6,0,0,0,3,1,25
065740902,25,2,0,0,0,2,16,45
065740903,39,4,0,0,0,2,2,47
065810101,335,28,5,3,1,5,9,386
065810102,369,19,1,4,0,1,7,401
065810103,391,18,3,2,0,3,5,422
065810104,363,11,2,3,0,3,5,387
065810105,399,31,5,9,0,6,10,460
065810106,228,30,4,6,2,2,11,283
065810107,268,25,8,0,4,1,30,336
065810108,255,14,0,1,0,1,6,277
065810109,272,14,0,2,0,1,4,293
065810110,251,25,0,1,0,0,3,280
065810111,234,8,0,0,0,0,10,252
065810201,275,25,7,4,8,5,19,343
065810202,231,32,11,3,26,8,27,338
065810203,140,20,3,1,11,16,22,213
065810204,242,27,5,2,32,5,26,339
065810205,162,21,13,2,28,3,40,269
065810206,297,29,16,1,13,7,26,389
065810207,289,19,10,7,9,2,14,350
065810208,277,25,7,1,4,6,18,338
065810209,255,14,13,5,17,5,19,328
065810210,232,18,1,0,0,5,3,259
065810211,260,4,2,3,0,2,9,280
065810212,231,22,2,4,9,3,6,277
065810301,299,22,4,2,5,3,14,349
065810302,310,29,7,3,3,4,20,376
065810303,293,20,13,0,2,9,18,355
065810304,196,28,2,1,4,1,11,243
065810305,189,25,13,3,11,2,15,258
065810306,205,36,11,1,2,1,21,277
065810307,261,40,15,3,9,1,23,352
065810308,205,18,5,3,1,4,22,258
065810401,332,17,6,2,1,10,23,391
065810402,207,27,12,2,0,10,10,268
065810403,186,34,1,4,0,6,11,242
065810404,230,18,5,3,1,14,6,277
065810405,360,22,2,3,0,8,14,409
065810406,150,11,2,3,5,22,21,214
065810407,208,27,1,5,1,20,7,269
065810408,254,41,17,2,5,15,12,346
065810409,225,31,14,6,0,43,13,332
065810410,178,11,3,1,3,55,21,272
065810411,210,27,30,3,4,30,12,316
065810501,75,9,15,0,4,48,43,194
065810502,52,14,0,0,0,71,2,139
065810503,122,8,8,1,2,306,8,455
065810504,83,5,33,0,0,279,3,403
065810505,73,5,63,0,1,384,0,526
065810506,143,4,14,0,5,164,11,341
065810507,94,65,15,0,2,229,53,458
065810508,102,2,30,1,2,273,9,419
065810601,11,7,0,0,0,0,7,25
065810602,36,0,0,0,0,15,15,66
065810603,31,0,0,0,0,2,9,42
065810604,11,0,0,0,0,8,14,33
065810701,183,38,0,4,0,0,7,232
065810702,7,4,0,0,0,0,1,12
065810703,24,10,0,0,0,0,0,34
065810704,17,6,0,0,0,0,2,25
065810705,14,4,0,1,0,1,3,23
065810706,22,0,0,0,0,0,26,48
065810707,38,8,0,1,0,0,3,50
065810708,183,23,1,6,0,1,6,220
065810709,207,20,3,4,8,1,15,258
065810710,168,15,6,9,1,0,10,209
065810711,169,11,1,4,9,1,6,201
065810712,151,33,1,3,0,2,13,203
065810801,188,14,0,2,4,1,16,225
065810802,190,18,2,0,1,2,6,219
065810803,27,25,0,0,0,4,36,92
065810804,28,8,0,0,0,3,1,40
065810805,17,17,0,0,0,6,5,45
065810806,14,2,0,0,0,0,9,25
065810807,2,8,0,0,0,0,1,11
065810808,18,6,0,0,0,2,4,30
065810809,176,5,2,1,0,0,12,196
065810810,168,19,2,0,2,7,4,202
065810901,7,0,0,0,0,3,1,11
065810902,10,7,0,0,0,4,2,23
065810903,6,1,0,0,0,2,8,17
065810904,7,0,0,0,0,6,0,13
065810905,3,1,0,0,0,5,1,10
065810906,8,0,0,0,0,1,2,11
065810907,3,0,0,0,0,0,1,4
065810908,2,2,0,0,0,1,1,6
065810909,3,2,0,0,0,0,0,5
065810910,4,6,0,0,0,0,0,10
065810911,2,0,0,0,0,1,0,3
065810912,9,1,0,0,0,1,4,15
065810913,10,1,0,0,0,0,0,11
065811001,140,31,0,2,1,2,35,211
065811002,22,1,0,1,0,4,22,50
065811003,14,0,0,0,0,4,6,24
065811004,7,1,0,0,0,3,7,18
065811005,9,1,0,1,0,1,1,13
065811006,13,0,0,0,0,12,3,28
065811101,2,7,0,0,0,2,3,14
065811102,7,4,1,0,0,0,1,13
065811103,16,12,0,0,0,0,1,29
065811104,8,2,0,0,0,1,5,16
065811105,27,12,0,0,0,0,10,49
065811106,4,6,0,0,0,0,4,14
065811107,19,14,0,0,0,60,7,100
065811108,11,5,0,1,0,0,0,17
065811109,5,7,0,0,0,0,2,14
065811201,12,15,0,0,0,0,0,27
065811202,8,7,0,0,0,1,3,19
065811203,14,1,0,0,0,13,3,31
065811204,21,8,0,0,0,0,0,29
065811205,29,2,0,0,0,0,0,31
065811206,42,16,0,2,0,2,0,62
065811207,17,1,0,0,0,0,8,26
065811301,243,19,2,1,0,48,2,315
065811302,221,9,0,0,0,0,1,231
065811303,280,18,0,0,0,2,3,303
065811304,269,18,0,0,1,0,4,292
065811305,276,15,1,0,0,2,5,299
065811306,493,46,5,0,1,3,9,557
065811307,86,0,1,1,0,34,16,138
065811308,186,26,3,36,0,93,7,351
065811309,180,30,7,25,2,20,15,279
065811310,203,33,20,17,0,11,2,286
065811311,277,34,23,12,1,51,17,415
065811401,92,13,1,0,0,1,15,122
065811402,265,18,2,2,1,0,3,291
065811403,317,24,0,2,0,0,7,350
065811404,146,17,0,1,0,0,4,168
065811405,152,11,0,2,1,0,8,174
065811406,141,16,0,0,0,0,5,162
065811407,220,19,0,0,0,1,14,254
065811408,263,10,0,4,3,1,5,286
065811409,247,21,7,1,4,2,13,295
065811410,250,6,1,1,0,3,7,268
065811411,213,12,1,7,0,3,7,243
065811412,374,27,2,5,1,5,11,425
065811501,116,2,0,0,0,3,0,121
065811502,318,1,3,3,0,0,10,335
065811503,187,1,0,2,0,1,7,198
065811504,340,0,8,1,0,2,8,359
065811505,293,13,2,3,0,0,13,324
065811506,231,8,1,3,2,0,4,249
065811507,379,11,0,1,1,0,6,398
065811508,266,20,3,2,2,2,6,301
065811509,319,20,3,2,0,1,3,348
065811510,294,11,4,1,4,5,6,325
065811511,266,22,5,5,11,2,30,341
065811601,284,29,5,3,5,5,29,360
065811602,328,36,9,2,8,1,10,394
065811603,306,31,4,4,2,11,10,368
065811604,275,9,7,5,1,3,10,310
065811605,210,33,7,1,0,7,15,273
065811606,397,30,10,12,0,14,13,476
065811607,253,14,7,1,1,4,9,289
065811608,259,15,0,3,0,12,0,289
065811701,196,26,4,3,1,2,10,242
065811702,232,18,17,3,4,11,4,289
065811703,248,21,18,2,2,59,7,357
065811704,187,20,8,1,0,2,11,229
065811705,274,26,12,11,2,39,7,371
065811706,210,29,3,4,0,17,9,272
065811707,214,59,11,1,0,45,9,339
065811708,141,25,6,1,0,18,3,194
065811709,81,33,2,0,1,31,16,164
065811710,176,44,24,1,1,40,17,303
065811711,262,28,12,5,1,28,14,350
065811801,280,27,0,0,0,3,19,329
065811802,103,25,5,3,1,35,6,178
065811803,107,29,33,3,2,29,2,205
065811804,89,10,1,1,1,153,7,262
065811805,111,51,8,0,1,223,9,403
065811806,94,14,5,0,1,181,11,306
065811807,174,41,11,3,5,131,11,376
065811808,143,41,30,1,2,151,12,380
065811809,102,137,86,0,0,106,26,457
065811901,81,2,2,0,2,211,68,366
065811902,40,0,13,5,0,82,2,142
065811903,124,26,33,13,0,211,11,418
065811904,138,3,4,5,0,148,6,304
065811905,262,24,0,14,1,9,15,325
065811906,122,5,0,3,0,6,9,145
065811907,132,6,0,4,0,0,7,149
065811908,338,19,5,7,4,9,7,389
065811909,201,14,3,2,3,2,4,229
065811910,159,7,5,2,1,5,7,186
065811911,182,8,9,5,0,21,5,230
065811912,248,22,18,4,4,37,15,348
065880101,349,8,10,5,9,1,29,411
065880102,289,43,19,5,14,0,12,382
065880103,371,28,14,24,3,1,24,465
065880104,328,49,12,3,3,1,15,411
065880105,301,46,38,5,10,5,12,417
065880106,297,36,2,6,8,2,20,371
065880107,228,13,3,7,4,1,20,276
065880108,218,16,2,1,0,1,11,249
065880109,226,15,4,7,0,1,18,271
065880110,192,13,10,3,2,2,19,241
065880111,409,36,10,5,2,1,17,480
065880112,194,9,1,8,1,1,13,227
065880113,247,15,14,6,1,1,11,295
065880114,232,15,5,3,3,1,11,270
065880115,210,23,11,4,1,2,11,262
065880116,237,16,8,8,1,1,16,287
065880117,232,20,5,11,1,3,4,276
065880201,340,16,5,10,5,0,17,393
065880202,327,19,8,5,4,0,15,378
065880203,241,13,4,7,0,1,6,272
065880204,313,15,9,4,1,0,11,353
065880205,94,3,0,5,1,0,7,110
065880206,195,21,10,4,5,0,24,259
065880207,225,31,10,2,8,1,17,294
065880208,256,21,28,0,9,2,20,336
065880301,150,17,0,2,1,0,17,187
065880302,186,15,2,3,1,1,19,227
065880303,217,24,5,4,0,1,16,267
065880304,87,8,0,3,0,1,11,110
065880305,16,1,0,0,0,0,25,42
065880306,17,0,0,0,0,3,12,32
065880307,12,1,0,0,0,1,5,19
065880308,17,2,0,0,0,0,8,27
065880309,39,11,0,0,0,3,16,69
065880401,22,2,0,0,0,7,9,40
065880501,174,22,1,4,0,3,8,212
065880502,17,6,0,0,0,5,20,48
065880503,12,4,0,0,0,9,3,28
065880504,8,0,0,0,0,0,2,10
065880505,48,0,0,0,0,6,24,78
065880601,58,16,0,1,0,12,38,125
065880701,42,18,1,0,0,10,8,79
065880702,89,13,3,4,0,3,13,125
065880703,94,6,3,2,0,2,13,120
065880801,58,31,0,0,0,1,44,134
065880802,29,11,0,0,1,0,0,41
065880901,262,22,6,21,1,2,14,328
065880902,333,17,3,18,0,1,5,377
065880903,147,15,9,32,1,28,21,253
065880904,124,26,3,9,1,27,36,226
065880905,103,26,16,14,0,26,18,203
065880906,122,23,3,14,1,8,21,192
065880907,180,12,2,12,1,1,11,219
065880908,306,17,2,5,0,1,9,340
065880909,282,16,10,10,0,2,24,344
065880910,275,17,1,6,1,1,14,315
065880911,362,33,1,34,0,26,12,468
065880912,334,21,3,9,0,0,9,376
065880913,323,13,2,0,0,0,9,347
065880914,173,18,0,1,0,0,2,194
065880915,218,19,3,26,0,28,17,311
065881001,129,6,1,3,1,0,11,151
065881002,76,28,1,1,0,0,12,118
065881003,15,1,0,0,0,5,3,24
065881004,5,4,0,1,0,0,10,20
065881005,39,8,0,0,0,1,7,55
065881006,19,6,0,1,0,0,29,55
065881007,29,4,0,0,0,2,7,42
065881008,20,5,0,0,0,0,15,40
065881009,4,4,0,0,0,0,0,8
065881010,8,3,0,0,0,0,17,28
065881011,9,3,0,0,0,0,6,18
065881012,136,14,2,3,1,2,25,183
065881101,10,0,0,0,0,0,0,10
065881102,14,3,0,0,0,4,4,25
065881201,35,22,0,0,0,5,24,86
065881202,8,4,0,0,0,0,4,16
065881203,34,3,0,0,0,0,0,37
065881301,181,11,1,2,1,6,5,207
065881302,21,1,0,0,0,0,0,22
065881303,23,11,0,0,0,8,4,46
065881304,23,11,0,0,0,16,10,60
065881305,26,14,0,0,0,7,4,51
065881401,100,18,1,3,1,16,30,169
065881402,131,21,1,3,0,6,29,191
065881403,6,7,0,0,0,1,5,19
065881404,19,4,0,0,0,3,19,45
065881501,113,18,0,0,4,1,22,158
065881502,11,14,0,0,0,0,0,25
065881503,7,5,0,0,0,0,0,12
065881504,17,1,0,0,0,6,26,50
065881601,278,16,6,3,2,0,18,323
065881602,331,25,7,8,1,3,16,391
065881603,241,21,1,2,0,0,5,270
065881604,11,9,0,1,0,2,8,31
065881605,5,1,0,0,0,5,9,20
065881606,12,0,0,0,0,1,14,27
065881607,0,0,0,0,0,0,1,1
065881608,10,10,0,0,0,0,3,23
065881609,3,0,0,0,0,8,3,14
065881701,292,24,5,5,6,2,18,352
065881702,283,19,1,1,0,2,1,307
065881703,235,15,13,3,3,1,4,274
065881704,305,25,5,3,4,2,5,349
065881705,311,30,15,8,1,0,12,377
065881706,321,42,12,5,6,3,12,401
065881707,231,37,3,3,3,2,13,292
065881708,209,38,6,4,13,1,11,282
065950101,277,15,1,9,3,0,5,310
065950102,236,18,1,2,0,4,0,261
065950103,387,20,2,5,3,1,4,422
065950104,352,20,7,5,0,0,6,390
065950105,352,33,8,2,8,0,28,431
065950106,266,12,2,5,0,0,5,290
065950107,275,19,4,16,4,0,8,326
065950108,366,14,2,5,0,2,8,397
065950109,258,10,2,4,0,0,5,279
065950110,366,30,15,4,9,0,19,443
065950201,274,40,8,4,20,3,11,360
065950202,313,14,7,14,5,3,15,371
065950203,283,29,13,1,6,2,16,350
065950204,312,51,8,3,41,4,25,444
065950205,180,41,4,3,21,1,14,264
065950206,279,57,14,8,27,10,15,410
065950207,295,17,4,2,6,2,20,346
065950208,356,33,15,13,6,2,20,445
065950209,210,17,1,5,0,0,8,241
065950210,414,29,4,7,11,5,15,485
065950211,210,29,5,4,5,1,6,260
065950212,248,28,32,6,18,2,14,348
065950213,190,8,10,3,12,0,5,228
065950214,189,2,7,0,1,1,16,216
065950215,198,0,3,2,0,5,9,217
065950301,216,1,3,9,5,3,11,248
065950302,300,13,9,3,6,2,7,340
065950303,299,69,7,1,27,5,12,420
065950304,314,41,10,1,19,0,38,423
065950305,259,27,13,8,7,3,5,322
065950306,285,15,17,4,15,2,18,356
065950307,255,66,10,4,45,8,19,407
065950308,247,45,9,4,27,2,8,342
065950309,230,14,7,11,6,3,11,282
065950310,381,46,9,6,1,0,8,451
065950311,331,27,15,13,4,1,3,394
065950312,252,2,10,9,21,2,43,339
065950313,216,14,8,2,5,1,1,247
065950401,222,24,4,1,0,0,1,252
065950402,398,50,33,0,0,2,10,493
065950403,296,17,5,2,2,0,6,328
065950404,330,20,14,5,1,3,4,377
065950405,340,28,3,3,0,0,10,384
065950406,213,10,13,6,1,2,2,247
065950407,255,29,7,5,0,0,9,305
065950408,241,18,0,3,0,4,9,275
065950409,326,9,4,8,2,0,7,356
065950410,266,15,1,3,0,0,1,286
065950411,235,21,1,4,0,0,12,273
065950412,356,37,3,9,0,2,6,413
065950413,329,20,6,2,0,5,6,368
065950501,59,0,1,0,0,10,32,102
065950601,75,30,0,0,0,8,1,114
065950602,10,1,0,0,0,0,12,23
065950603,81,14,4,8,5,18,17,147
065950701,63,21,0,0,0,4,14,102
065950801,170,23,2,5,0,6,13,219
065950802,58,1,1,1,1,15,34,111
065950901,63,0,0,1,0,6,24,94
065951001,54,25,0,0,0,4,4,87
065951101,42,20,0,0,0,7,5,74
065951201,34,13,0,1,0,9,5,62
065951301,53,17,0,0,0,0,16,86
065951401,99,49,0,0,0,0,9,157
065951501,50,22,0,0,0,0,17,89
065951601,254,9,1,4,4,13,8,293
065951602,350,11,3,14,1,4,2,385
065951603,385,13,1,15,0,0,5,419
065951604,89,2,1,3,0,6,13,114
065951605,38,5,3,18,0,58,0,122
065951606,236,20,2,0,0,0,6,264
065951607,260,18,1,4,0,4,5,292
065951608,458,14,2,1,0,2,13,490
065951609,235,19,0,2,0,0,1,257
065951610,192,8,2,1,1,0,5,209
065951611,205,6,0,0,0,1,2,214
065951612,222,18,2,0,3,0,2,247
065951613,187,13,7,1,0,0,3,211
065951701,46,12,0,0,0,1,3,62
065951801,6,0,0,0,4,8,8,26
065951802,8,0,0,0,0,5,3,16
065951803,21,0,0,1,0,3,10,35
065951804,3,1,0,0,0,0,5,9
065951901,156,10,3,1,0,8,30,208
065951902,190,13,8,3,1,10,13,238
065951903,311,25,2,2,0,1,1,342
065951904,130,11,4,5,3,2,7,162
065951905,95,8,1,3,6,0,7,120
065951906,93,6,1,0,0,0,2,102
065951907,105,13,4,7,0,1,8,138
065951908,204,3,0,9,0,4,10,230
065951909,129,5,8,0,5,2,6,155
065951910,187,2,0,0,0,0,3,192
065951911,308,30,1,17,2,2,11,371
065951912,174,16,0,1,1,4,24,220
065951913,46,1,0,0,0,4,22,73
065951914,337,17,3,8,0,2,14,381
065952001,249,7,1,5,1,0,17,280
065952002,12,0,0,0,0,2,6,20
065952101,168,9,0,0,0,1,11,189
065952102,208,12,4,9,0,0,16,249
065952103,156,11,3,2,1,2,5,180
065952104,221,15,1,5,0,0,9,251
065952105,276,10,6,1,3,2,18,316
065952106,1,0,0,0,0,0,1,2
065952107,58,24,0,0,0,6,10,98
065952201,71,11,0,3,0,12,4,101
065952301,96,4,1,0,0,1,61,163
065952401,277,26,17,2,5,0,13,340
065952402,294,20,21,1,8,0,28,372
065952403,287,26,3,4,11,1,18,350
065952404,281,31,8,7,5,0,8,340
065952405,276,29,18,9,2,2,11,347
065952406,270,25,17,6,2,2,9,331
065952407,338,18,10,9,2,0,21,398
065952408,413,28,4,16,9,1,16,487
065952409,286,21,1,6,1,3,6,324
065952410,247,13,4,3,1,0,10,278
065952411,220,7,10,0,0,1,1,239
065952412,269,32,3,1,1,0,9,315
065952501,340,23,2,0,3,0,9,377
065952502,241,16,18,2,8,3,9,297
065952503,360,22,14,16,11,4,28,455
065952504,370,20,16,5,3,0,8,422
065952505,283,40,8,8,0,2,11,352
065952506,265,11,5,6,0,0,12,299
065952507,246,20,6,3,0,0,0,275
065952508,296,21,5,5,1,0,9,337
065952509,249,29,5,9,1,0,9,302
065952510,262,23,12,9,4,1,1,312
065952511,296,17,3,6,0,1,8,331
065952512,210,16,6,10,0,1,3,246
065952513,206,8,1,7,0,2,1,225
065952601,105,27,0,1,1,6,28,168
065952602,413,21,0,3,0,2,5,444
065952603,231,22,0,12,0,7,19,291
065952604,225,11,2,2,1,2,3,246
065952605,349,14,5,19,1,3,18,409
065952606,168,14,0,149,0,0,4,335
065952607,321,20,6,7,2,7,9,372
065952608,303,6,7,4,0,0,7,327
065952609,232,10,4,4,0,1,7,258
065952610,319,23,1,4,1,4,4,356
065952611,363,21,2,13,2,1,13,415
065952612,362,28,10,15,7,1,15,438
065952613,227,12,5,7,0,0,4,255
065952614,173,15,1,6,0,14,9,218
065952701,332,12,1,15,0,1,3,364
065952702,434,30,6,5,1,2,7,485
065952703,194,15,4,12,2,35,31,293
065952704,231,18,2,10,3,48,7,319
065952705,13,0,0,4,0,9,8,34
065952706,57,8,2,1,2,0,5,75
065952707,205,15,0,3,2,10,27,262
065952708,92,2,0,15,0,16,11,136
065952709,240,10,0,4,0,0,7,261
065952710,188,9,2,3,0,1,6,209
065952711,235,18,7,3,4,2,11,280
065952712,184,6,7,3,2,0,16,218
066020101,84,11,6,0,0,0,10,111
066020201,149,27,3,37,4,2,11,233
066020202,51,11,0,0,0,10,7,79
066020203,71,3,0,1,1,3,42,121
066020204,23,0,0,0,0,0,7,30
066020205,38,1,0,0,1,16,12,68
066020206,19,13,0,0,0,0,2,34
066020207,33,12,0,0,0,6,18,69
066020301,408,18,6,7,1,1,8,449
066020302,199,8,3,3,0,0,2,215
066020303,14,4,0,0,0,0,0,18
066020304,175,11,1,107,0,5,28,327
066020305,12,0,0,0,0,0,45,57
066020306,31,8,0,0,0,1,28,68
066020307,8,3,0,0,0,0,3,14
066020308,422,37,7,5,1,0,6,478
066020309,246,14,5,5,4,0,8,282
066020401,20,6,0,0,0,3,43,72
066020501,10,10,0,0,0,0,1,21
066020601,11,2,0,0,0,0,31,44
066020701,9,0,0,0,0,1,59,69
066020801,238,29,2,3,0,1,20,293
066020802,265,39,1,2,0,2,9,318
066020803,115,15,3,0,6,0,13,152
066020804,124,24,3,0,1,1,1,154
066020805,92,40,0,0,0,31,76,239
066020806,15,14,2,0,0,2,4,37
066020901,34,0,0,0,2,0,31,67
066020902,27,38,0,0,0,0,24,89
066020903,11,0,0,0,0,0,28,39
066021001,13,0,0,0,0,0,34,47
066021002,6,0,0,0,0,0,10,16
066021101,286,5,1,4,0,0,16,312
066021102,194,20,25,10,2,29,10,290
066021103,359,26,8,4,0,4,17,418
066021104,317,7,1,0,0,0,4,329
066021105,218,21,3,3,7,1,14,267
066021106,239,32,3,1,6,0,10,291
066021107,245,15,9,3,2,0,17,291
066021108,419,35,9,5,0,1,13,482
066021109,426,35,2,3,0,0,5,471
066021110,10,0,0,0,0,0,0,10
066021111,346,66,6,4,4,0,12,438
066021112,271,41,12,14,9,0,17,364
066021113,282,29,0,12,3,1,14,341
066021201,43,16,5,2,1,3,14,84
066021301,69,28,1,3,0,0,57,158
066021401,37,60,0,0,0,1,16,114
066021402,39,29,28,2,0,27,22,147
066021403,50,24,73,1,0,10,3,161
066021404,38,1,67,14,0,63,12,195
066021405,43,13,12,12,2,56,5,143
066021406,44,24,5,3,0,33,11,120
066021501,1,1,0,0,0,0,1,3
066021601,192,10,2,119,1,0,4,328
066021602,166,15,0,9,0,0,7,197
066021603,396,30,2,6,0,0,28,462
066021604,227,9,0,3,2,0,36,277
066021605,244,31,3,0,1,1,9,289
066021606,278,34,2,1,0,0,6,321
066021607,254,25,3,0,2,0,14,298
066021608,243,39,4,1,2,0,12,301
066021609,306,38,1,4,2,1,14,366
066021610,297,37,4,4,7,3,15,367
066021611,233,20,2,3,2,0,6,266
066021612,16,2,1,2,1,0,1,23
066090101,399,1,0,4,0,1,2,407
066090102,388,24,5,4,3,1,9,434
066090103,327,43,5,2,0,1,17,395
066090104,265,51,7,4,7,0,14,348
066090105,282,58,21,11,18,2,12,404
066090106,214,18,20,0,0,0,7,259
066090107,296,23,2,2,2,1,8,334
066090108,212,5,1,4,0,1,16,239
066090109,290,19,0,11,0,0,5,325
066090110,312,24,2,1,0,1,5,345
066090201,339,42,6,9,6,2,15,419
066090202,271,49,15,0,24,6,16,381
066090203,198,39,7,3,9,0,14,270
066090204,269,49,3,5,6,0,10,342
066090205,324,27,13,10,4,3,10,391
066090206,411,36,4,10,3,1,19,484
066090207,209,12,3,4,0,1,5,234
066090208,438,36,8,5,0,0,9,496
066090209,383,32,9,1,1,2,15,443
066090210,248,25,9,6,11,0,12,311
066090211,331,31,4,9,8,0,11,394
066090212,316,17,1,9,0,2,8,353
066090213,407,30,3,5,1,1,11,458
066090214,249,21,2,8,0,0,9,289
066090215,216,20,1,6,0,1,10,254
066090301,5,17,0,0,0,0,1,23
066090302,4,14,0,0,0,0,0,18
066090303,5,5,0,0,0,2,5,17
066090304,15,1,0,0,0,4,2,22
066090401,90,17,3,1,1,0,8,120
066090402,10,0,0,0,0,2,6,18
066090403,14,15,0,0,0,2,0,31
066090404,44,11,0,1,0,6,23,85
066090501,10,0,0,0,0,5,6,21
066090502,29,7,0,0,0,0,5,41
066090503,35,3,0,0,1,8,9,56
066090601,28,1,0,0,0,1,6,36
066090602,6,0,0,0,0,0,15,21
066090603,14,0,0,0,0,2,20,36
066090604,6,1,0,0,0,2,4,13
066090605,24,0,0,0,0,4,18,46
066090606,24,13,0,2,0,4,11,54
066090607,86,9,6,7,0,79,1,188
066090608,66,11,0,0,0,7,13,97
066090609,17,2,0,0,0,1,21,41
066090610,55,1,0,0,0,0,1,57
066090611,12,0,0,1,0,18,0,31
066090612,2,0,0,0,0,7,2,11
066090613,69,15,1,3,6,104,2,200
066090701,4,0,0,0,0,0,7,11
066090702,4,0,0,0,0,0,11,15
066090703,5,0,0,0,0,0,7,12
066090704,5,0,0,0,0,2,1,8
066090705,20,2,0,0,0,7,10,39
066090801,2,3,0,0,0,0,5,10
066090802,3,0,0,0,1,2,11,17
066090803,1,0,0,0,0,1,13,15
066090804,5,3,0,0,0,0,0,8
066090901,23,23,0,0,0,0,11,57
066090902,242,23,4,4,2,1,13,289
066090903,218,27,4,3,0,1,21,274
066090904,176,18,3,2,2,1,16,218
066090905,149,18,1,1,0,0,21,190
066090906,17,9,0,1,0,2,6,35
066091001,177,19,3,1,2,1,27,230
066091002,136,21,1,3,1,0,6,168
066091003,10,0,0,0,0,2,16,28
066091004,11,0,0,0,0,0,14,25
066091005,29,3,0,0,0,4,14,50
066091006,5,2,0,0,0,0,7,14
066091007,138,15,0,2,1,0,16,172
066091101,13,2,0,0,0,0,0,15
066091102,18,5,0,0,0,0,1,24
066091201,14,1,0,0,0,15,5,35
066091202,15,8,0,0,0,0,0,23
066091301,73,8,0,1,1,2,18,103
066091302,11,1,0,0,0,0,21,33
066091303,4,0,1,0,0,2,8,15
066091304,25,1,0,0,0,0,13,39
066091305,9,4,0,0,0,2,1,16
066091306,24,0,0,0,0,0,25,49
066091401,13,4,0,0,0,0,0,17
066091402,20,8,0,0,0,3,5,36
066091501,73,0,2,2,3,7,38,125
066091502,7,1,0,0,0,0,2,10
066091503,3,2,0,1,0,0,17,23
066091601,7,2,0,0,0,4,10,23
066091602,10,3,0,0,0,3,5,21
066091603,16,13,0,0,0,0,8,37
066091604,0,1,0,0,0,0,0,1
066091701,320,22,5,9,3,9,13,381
066091702,281,32,6,6,0,3,12,340
066091703,25,3,0,0,0,3,14,45
066091704,13,1,0,0,0,2,10,26
066091705,2,0,0,0,0,0,5,7
066091706,4,0,0,0,0,3,1,8
066091707,22,5,1,0,0,2,1,31
066091708,13,0,0,0,0,0,14,27
066091709,8,0,3,0,0,2,8,21
066091801,12,5,0,0,0,3,2,22
066091802,3,5,0,4,0,3,9,24
066091901,413,38,3,5,0,1,3,463
066091902,208,20,1,3,0,0,8,240
066091903,397,36,10,3,4,0,13,463
066091904,246,29,5,2,7,0,26,315
066091905,197,24,5,4,14,1,11,256
066091906,333,59,13,3,6,0,23,437
066091907,359,23,2,4,0,0,7,395
066091908,388,34,6,7,0,1,3,439
066091909,252,25,0,0,0,0,2,279
066160101,24,0,0,0,0,0,7,31
066160102,17,5,0,2,0,6,10,40
066160103,33,7,0,0,0,0,4,44
066160104,49,19,0,0,0,0,3,71
066160105,25,7,1,2,0,0,2,37
066160106,1,0,0,0,0,0,4,5
066160107,39,2,0,0,0,21,20,82
066160108,19,3,0,0,0,4,14,40
066160109,11,5,0,0,0,0,11,27
066160110,28,13,1,0,0,0,2,44
066160201,10,20,0,0,0,0,0,30
066160202,3,0,0,0,0,3,8,14
066160301,220,22,0,4,1,1,5,253
066160302,281,26,1,4,1,1,12,326
066160303,233,28,2,1,3,0,10,277
066160304,237,9,3,3,1,0,13,266
066160305,226,24,3,5,4,4,11,277
066160306,173,18,2,4,5,2,18,222
066160307,186,15,2,3,0,1,9,216
066160308,42,7,0,14,0,1,2,66
066160309,149,19,1,4,1,0,3,177
066230101,244,10,0,13,1,0,4,272
066230102,355,23,6,4,6,0,9,403
066230103,385,33,6,7,3,0,8,442
066230104,360,29,4,2,2,0,27,424
066230105,324,22,4,10,5,1,18,384
066230106,355,27,12,3,3,2,17,419
066230107,340,17,5,2,4,0,18,386
066230108,366,22,10,9,1,0,12,420
066230109,270,9,1,1,1,1,5,288
066230110,157,7,0,1,0,0,1,166
066230111,245,14,0,2,1,0,10,272
066230112,233,9,2,6,2,2,7,261
066230201,245,20,6,1,1,1,10,284
066230202,238,25,18,6,19,0,14,320
066230203,305,32,12,0,30,2,10,391
066230204,304,48,2,3,16,0,29,402
066230205,228,40,10,0,13,2,21,314
066230206,289,13,6,8,21,1,37,375
066230207,262,12,13,3,7,1,23,321
066230208,283,8,12,1,1,3,5,313
066230209,321,18,4,11,2,1,10,367
066230301,184,16,9,2,21,0,6,238
066230302,377,11,7,4,3,4,13,419
066230303,225,24,18,4,30,1,15,317
066230304,212,34,4,2,14,0,9,275
066230305,251,7,3,5,39,2,37,344
066230306,284,58,6,1,44,2,33,428
066230307,251,48,25,12,22,0,14,372
066230308,230,28,11,3,19,2,24,317
066230309,215,13,8,18,20,1,31,306
066230310,290,51,18,2,8,0,24,393
066230311,228,27,4,2,4,1,4,270
066230401,339,38,14,3,5,2,10,411
066230402,313,38,7,6,7,3,6,380
066230403,293,25,14,5,6,0,3,346
066230404,255,10,14,2,6,0,11,298
066230405,317,20,7,5,0,1,10,360
066230406,393,22,1,2,0,2,9,429
066230407,326,20,5,3,1,0,8,363
066230408,381,20,14,5,3,1,13,437
066230409,285,20,2,4,3,0,11,325
066230410,273,11,3,2,1,0,3,293
066230501,332,13,9,4,1,0,4,363
066230502,248,13,6,5,1,0,4,277
066230503,335,12,8,1,0,0,2,358
066230504,308,9,5,1,0,0,4,327
066230505,410,12,8,0,0,0,3,433
066230506,395,21,7,1,0,0,3,427
066230507,373,5,2,0,0,0,7,387
066230508,309,14,2,3,0,0,4,332
066230509,257,16,4,3,0,1,7,288
066230510,362,20,9,6,1,0,4,402
066230601,4,1,0,0,0,0,20,25
066230602,9,3,0,0,0,3,18,33
066230603,0,14,0,0,0,0,0,14
066230701,179,9,6,4,0,2,24,224
066230702,204,9,3,2,1,2,24,245
066230703,22,16,0,0,0,0,19,57
066230704,15,4,0,0,0,3,15,37
066230705,9,9,0,0,0,0,5,23
066230801,57,27,1,0,0,10,5,100
066230802,9,0,0,0,0,3,2,14
066230803,9,0,0,0,0,0,3,12
066230901,20,0,0,0,0,5,3,28
066230902,165,11,1,2,0,0,4,183
066230903,94,5,2,1,0,0,3,105
066230904,27,9,0,0,0,2,7,45
066231001,7,0,0,0,0,0,12,19
066231002,15,1,0,0,0,2,10,28
066231003,6,5,0,0,0,4,3,18
066231101,21,8,0,0,0,4,1,34
066231102,28,1,0,0,0,1,6,36
066231103,159,14,1,0,0,1,5,180
066231104,177,12,3,3,0,1,15,211
066231201,12,0,0,0,0,3,9,24
066231202,9,0,0,0,0,2,23,34
066231301,3,1,0,0,0,1,3,8
066231302,8,0,0,0,0,0,3,11
066231401,273,7,3,5,2,3,22,315
066231402,257,14,5,3,6,2,4,291
066231403,25,7,0,0,0,13,6,51
066231404,64,4,0,0,1,5,3,77
066231501,72,19,2,0,0,3,0,96
066231502,16,5,0,0,0,3,2,26
066231503,13,4,0,1,0,6,1,25
066231601,127,17,0,0,0,3,12,159
066231602,15,3,0,0,0,2,4,24
066231603,15,0,0,0,0,0,10,25
066231604,22,6,0,0,0,1,9,38
066231605,225,19,1,2,1,1,7,256
066231701,19,6,0,1,0,4,9,39
066231702,6,6,0,0,0,2,10,24
066231703,12,0,0,1,0,9,0,22
066231801,18,0,0,0,0,11,4,33
066231802,121,11,3,3,0,0,0,138
066231803,208,10,4,9,2,2,18,253
066231804,14,5,0,0,1,3,5,28
066231901,6,1,0,0,0,7,3,17
066231902,20,5,0,0,1,4,1,31
066232001,225,15,11,11,7,46,52,367
066232002,394,12,3,18,0,3,12,442
066232003,294,15,1,3,0,2,2,317
066232004,104,11,0,14,0,0,2,131
066232005,281,6,1,0,0,0,9,297
066232006,254,12,0,6,0,0,0,272
066232007,426,18,1,2,1,1,9,458
066232008,388,16,3,1,1,2,23,434
066232009,339,9,6,6,2,0,7,369
066232010,252,13,0,3,1,0,5,274
066232011,510,8,5,6,2,1,19,551
066232012,153,3,2,6,0,3,5,172
066232101,129,7,0,2,0,1,6,145
066232102,77,5,5,7,0,105,3,202
066232103,4,0,0,0,0,1,1,6
066232104,239,22,4,22,0,9,9,305
066232105,21,1,0,0,0,0,3,25
066232106,67,0,0,0,0,1,9,77
066232107,142,6,5,2,5,0,2,162
066232201,262,12,6,1,1,0,4,286
066232202,239,13,5,3,1,0,2,263
066232203,259,12,7,2,1,0,1,282
066232204,280,9,4,1,1,0,5,300
066232205,313,11,7,0,2,0,4,337
066232206,288,8,5,0,1,0,6,308
066232207,318,14,6,3,3,1,8,353
066232208,368,4,3,1,0,1,7,384
066232209,81,7,1,1,0,1,6,97
066232210,159,8,0,1,1,1,16,186
066232211,9,3,0,1,0,0,0,13
066232212,17,5,0,1,0,1,7,31
066232213,191,12,3,1,4,0,5,216
066232214,51,14,0,4,1,0,1,71
066232301,180,12,3,5,5,4,18,227
066232302,12,1,0,1,0,1,6,21
066232303,12,4,0,0,0,0,0,16
066232304,117,1,4,11,3,39,6,181
066232305,25,9,0,3,0,9,21,67
066232306,159,9,2,1,0,2,9,182
066232401,19,0,0,0,0,0,14,33
066232402,5,2,0,0,0,3,9,19
066232403,16,1,0,0,0,0,9,26
066232404,8,0,0,0,0,0,2,10
066232501,114,7,2,4,0,10,12,149
066232502,17,9,0,0,0,3,1,30
066232503,11,0,0,0,0,3,7,21
066232504,75,5,0,0,0,0,18,98
066232505,13,0,0,0,0,2,2,17
066232506,99,23,1,3,1,6,6,139
066232601,25,2,0,0,1,4,10,42
066232602,25,0,0,0,0,3,7,35
066232701,143,26,1,2,1,18,8,199
066232702,4,4,0,0,0,0,7,15
066232703,9,0,0,0,0,6,13,28
066232704,9,15,0,0,0,0,2,26
066232801,386,8,3,9,3,1,8,418
066232802,366,21,3,4,1,7,17,419
066232803,171,31,0,8,0,1,2,213
066232804,317,19,1,2,0,0,5,344
066232805,328,17,7,3,8,2,16,381
066232806,402,18,3,5,6,2,8,444
066232807,325,17,6,3,1,0,5,357
066232808,346,17,3,2,0,2,6,376
066232809,346,22,10,6,1,0,8,393
066232810,263,17,14,11,4,4,1,314
066232811,178,17,2,8,1,22,7,235
066232812,355,25,10,10,5,1,8,414
066232813,430,9,1,7,0,5,7,459
066232901,365,12,6,3,0,0,6,392
066232902,376,20,1,7,0,1,9,414
066232903,276,13,2,7,1,2,9,310
066232904,177,3,2,0,1,0,1,184
066232905,244,12,3,3,2,1,6,271
066232906,317,6,7,2,0,0,12,344
066232907,310,5,2,8,0,0,16,341
066232908,138,8,0,1,0,1,4,152
066232909,247,6,1,0,0,0,2,256
066232910,221,9,0,0,0,0,6,236
066232911,220,13,3,2,2,2,7,249
066300101,110,47,0,1,1,33,27,219
066300201,11,2,0,0,0,2,4,19
066300202,275,40,5,6,4,2,14,346
066300203,171,11,4,0,0,0,34,220
066300204,160,13,2,4,1,6,13,199
066300205,183,21,1,3,3,3,9,223
066300301,42,4,0,1,0,8,16,71
066300401,47,4,0,0,0,8,14,73
066300501,65,8,0,1,1,12,5,92
066300601,133,11,1,0,0,32,37,214
066380101,43,8,0,1,0,16,3,71
066380102,456,24,5,7,0,4,13,509
066380103,268,23,6,11,2,6,8,324
066380104,101,50,0,1,0,3,6,161
066380105,180,5,12,19,0,140,10,366
066380106,312,10,0,3,0,6,7,338
066380107,343,8,7,10,0,4,13,385
066380108,437,7,7,6,0,6,11,474
066380109,383,16,2,12,4,0,15,432
066380110,416,15,1,5,0,1,7,445
066380111,575,97,7,20,0,18,18,735
066380112,716,56,11,46,0,63,45,937
066380113,655,82,5,20,1,26,32,821
066380114,301,89,6,14,0,202,18,630
066380201,335,35,8,22,0,27,8,435
066380202,373,33,36,39,5,74,10,570
066380203,222,4,0,1,0,4,2,233
066380204,357,14,9,9,0,5,9,403
066380205,336,11,2,3,0,3,8,363
066380206,232,3,2,2,1,0,4,244
066380207,253,8,2,3,0,1,5,272
066380208,236,16,2,6,0,7,2,269
066380209,283,4,4,1,1,1,4,298
066380210,298,12,2,4,1,1,7,325
066380211,422,8,4,5,1,3,34,477
066380212,244,27,8,1,4,1,16,301
066380213,269,9,6,8,1,3,3,299
066380214,247,10,1,4,0,6,3,271
066380301,344,3,2,7,0,2,7,365
066380302,369,13,2,8,0,0,6,398
066380303,341,12,0,2,1,0,7,363
066380304,477,3,4,10,0,0,9,503
066380305,218,5,13,23,1,28,5,293
066380306,219,17,18,29,0,24,12,319
066380307,159,69,3,13,1,93,45,383
066380308,141,76,5,21,0,64,11,318
066380309,813,87,37,32,3,176,17,1165
066380310,240,34,9,7,0,7,14,311
066380311,431,28,1,6,0,7,7,480
066380312,470,21,7,9,2,4,9,522
066380313,390,18,1,12,2,14,19,456
066380401,333,11,0,2,5,0,4,355
066380402,362,7,1,1,2,0,12,385
066380403,248,11,2,2,0,3,4,270
066380404,229,18,12,6,1,32,5,303
066380405,540,8,0,5,0,2,5,560
066380406,281,9,2,4,0,16,19,331
066380407,302,21,5,6,1,17,6,358
066380408,265,14,13,14,0,1,17,324
066380409,239,43,5,7,3,19,33,349
066380410,281,8,6,16,0,68,8,387
066380411,240,27,19,13,5,30,18,352
066380412,266,15,18,37,0,5,23,364
066380501,88,15,5,1,0,9,4,122
066380502,65,25,0,0,2,5,11,108
066380503,82,18,1,4,0,22,5,132
066380504,56,29,0,2,0,15,13,115
066380505,183,4,8,7,0,62,27,291
066380506,147,1,6,1,0,56,18,229
066380507,204,26,8,2,0,36,6,282
066380508,248,2,1,0,0,2,5,258
066380509,243,9,6,5,1,0,2,266
066380510,345,14,13,13,5,0,15,405
066380511,280,13,0,2,0,1,4,300
066380512,264,4,2,2,2,4,8,286
066380513,282,20,2,8,0,0,4,316
066380514,346,4,0,3,0,2,6,361
066380601,341,30,2,2,1,3,7,386
066380602,281,23,2,3,0,5,9,323
066380603,394,15,6,3,0,10,9,437
066380604,368,4,4,6,0,11,16,409
066380605,370,13,5,2,1,3,6,400
066380606,323,6,0,6,0,2,9,346
066380607,351,18,3,5,1,7,3,388
066380608,224,24,10,8,0,36,13,315
066380609,142,40,4,5,0,14,11,216
066380610,405,12,3,9,1,0,8,438
066380611,269,0,2,4,0,0,2,277
066380612,297,22,0,7,0,0,5,331
066380613,300,7,0,1,1,0,3,312
066380614,396,10,6,2,0,0,12,426
066380615,332,9,1,6,0,0,7,355
066380701,390,17,2,11,0,1,5,426
066380702,265,4,1,6,0,2,6,284
066380703,275,23,0,2,0,1,3,304
066380704,301,20,1,4,1,3,6,336
066380705,248,15,10,5,0,38,10,326
066380706,148,24,0,4,2,37,14,229
066380707,371,39,16,8,3,9,23,469
066380708,208,28,1,6,1,41,47,332
066380709,211,11,3,6,0,20,21,272
066380710,309,10,2,2,1,11,11,346
066380711,227,19,0,4,0,17,11,278
066380712,292,18,2,4,0,29,9,354
066380713,279,8,0,9,1,16,3,316
066380801,225,24,70,10,1,9,10,349
066380802,218,94,25,51,2,6,3,399
066380803,293,26,8,2,0,12,7,348
066380804,159,61,2,3,1,120,24,370
066380805,149,44,0,4,0,138,23,358
066380806,188,9,0,4,7,2,5,215
066380807,161,26,5,8,1,14,5,220
066380808,447,15,6,3,0,4,16,491
066380809,135,23,8,6,1,17,10,200
066380810,190,18,4,20,3,70,18,323
066380811,187,17,4,13,0,52,9,282
066380812,156,0,3,4,0,66,15,244
066380813,122,29,0,20,0,9,8,188
066380814,139,2,0,0,0,0,4,145
066380815,45,3,0,1,0,120,8,177
066380816,188,21,1,11,0,71,4,296
066380901,179,25,14,21,0,39,10,288
066380902,164,13,9,24,0,47,9,266
066380903,251,15,0,2,1,0,4,273
066380904,178,2,3,7,3,0,4,197
066380905,306,8,3,11,0,11,7,346
066380906,389,33,4,5,0,2,14,447
066380907,515,14,2,6,0,1,4,542
066380908,337,5,0,5,0,0,2,349
066380909,327,2,0,10,0,0,3,342
066380910,322,0,2,1,0,0,3,328
066380911,342,3,2,5,0,4,4,360
066380912,304,2,2,7,0,2,3,320
066380913,370,3,1,0,0,0,4,378
066381001,346,0,2,3,0,0,3,354
066381002,313,1,2,2,1,0,2,321
066381003,351,0,37,7,3,3,7,408
066381004,259,0,0,2,1,2,4,268
066381005,256,5,4,1,2,0,9,277
066381006,374,2,5,8,0,3,4,396
066381007,416,1,1,4,0,9,12,443
066381008,490,4,0,8,0,0,16,518
066381009,300,0,4,1,0,0,6,311
066381010,392,4,1,1,0,0,7,405
066381011,281,2,1,2,3,2,17,308
066381101,142,10,0,4,0,0,13,169
066381102,126,11,0,3,0,1,4,145
066381103,529,12,1,5,0,0,6,553
066381104,403,14,1,7,0,2,7,434
066381105,314,26,12,1,3,1,18,375
066381106,267,17,3,2,3,2,10,304
066381107,328,18,5,2,5,1,11,370
066381108,376,4,7,4,0,5,16,412
066381109,311,20,2,6,1,0,10,350
066381110,440,8,4,10,0,8,3,473
066381111,213,21,0,6,0,3,5,248
066381112,183,11,0,4,1,0,6,205
066381201,110,15,5,4,0,2,7,143
066381202,52,29,15,2,70,1,112,281
066381203,350,32,3,5,4,6,2,402
066381204,91,10,1,1,0,15,9,127
066381205,483,57,6,17,0,68,64,695
066381206,305,44,12,9,18,12,19,419
066381207,11,0,0,1,0,264,7,283
066381208,15,18,12,5,0,277,25,352
066381209,136,35,3,3,0,90,33,300
066381210,91,9,0,5,0,10,4,119
066381211,150,5,0,4,0,0,1,160
066381301,341,42,5,29,0,31,13,461
066381302,282,6,4,4,2,2,4,304
066381303,249,23,3,14,0,1,4,294
066381304,233,27,4,5,0,16,11,296
066381305,364,12,1,7,7,3,19,413
066381306,497,14,2,8,2,7,9,539
066381307,405,15,1,7,4,3,11,446
066381308,252,2,8,7,0,4,1,274
066381309,272,13,1,3,0,0,4,293
066381310,317,14,1,18,0,1,3,354
066381311,307,11,2,3,0,0,5,328
066381312,237,24,11,8,0,12,26,318
066381313,381,13,15,23,4,218,22,676
066381314,100,16,10,0,0,27,11,164
066381315,115,18,1,5,2,4,3,148
066381316,176,7,1,1,0,0,7,192
066381317,109,1,6,15,1,37,5,174
066381318,395,27,3,6,4,2,10,447
066381319,192,0,3,8,1,30,23,257
066381401,164,6,0,6,0,5,9,190
066381402,230,13,1,2,0,0,2,248
066381403,398,11,0,6,2,0,14,431
066381404,248,13,2,5,0,0,11,279
066381405,299,17,2,5,0,0,8,331
066381406,321,18,4,5,0,3,6,357
066381407,357,24,7,7,1,0,5,401
066381408,321,6,5,4,0,3,3,342
066381409,336,14,1,4,0,0,8,363
066381501,126,11,0,0,0,2,3,142
066381502,143,10,3,1,1,1,2,161
066381503,332,20,4,9,1,0,8,374
066381504,341,14,6,7,1,1,5,375
066381505,174,7,0,4,1,16,9,211
066381506,302,37,9,14,3,27,4,396
066381507,424,14,8,3,2,5,14,470
066381508,388,43,9,4,5,1,4,454
066381509,352,11,1,5,0,1,5,375
066381510,388,31,2,32,0,7,3,463
066381511,270,23,3,1,0,71,50,418
066381512,410,15,10,9,1,0,13,458
066381513,438,7,5,5,8,1,3,467
066381514,318,16,1,7,2,0,13,357
066381601,329,23,16,0,1,1,14,384
066381602,198,25,7,3,8,2,13,256
066381603,368,41,32,2,11,3,22,479
066381604,228,20,27,1,7,1,7,291
066381605,182,25,14,2,11,2,5,241
066381606,315,18,12,4,1,0,5,355
066381607,340,37,21,1,4,0,9,412
066381608,282,5,13,3,1,0,1,305
066381609,263,17,17,7,1,1,10,316
066381610,309,12,2,8,0,2,10,343
066381611,349,18,10,2,2,2,11,394
066381701,227,28,31,9,2,4,10,311
066381702,161,20,43,0,1,16,14,255
066381703,308,84,25,5,0,7,21,450
066381704,256,17,5,6,0,2,2,288
066381705,240,20,8,4,1,3,13,289
066381706,190,16,10,0,3,0,11,230
066381707,258,28,19,1,8,2,18,334
066381708,337,54,27,1,45,11,15,490
066381709,161,37,41,0,26,1,34,300
066381710,192,24,21,5,19,1,10,272
066381711,188,85,58,1,10,0,6,348
066381712,343,32,31,3,2,1,14,426
066381713,403,48,30,11,6,2,22,522
066381714,329,74,29,10,75,5,5,527
066381801,378,28,4,22,2,2,27,463
066381802,421,2,5,13,1,1,6,449
066381803,360,1,0,2,0,0,3,366
066381804,399,3,22,41,1,74,8,548
066381805,141,1,5,7,0,4,6,164
066381806,319,4,2,10,0,2,16,353
066381807,330,5,3,12,3,0,17,370
066381808,338,2,1,8,0,0,5,354
066381809,291,2,5,3,1,0,6,308
066381810,179,1,0,9,0,3,2,194
066381901,298,81,1,7,0,127,8,522
066381902,439,53,21,10,2,26,13,564
066381903,317,14,2,6,0,39,1,379
066381904,142,6,2,2,1,3,13,169
066381905,346,143,23,6,2,248,16,784
066381906,127,25,7,11,1,68,13,252
066382001,20,4,0,0,0,1,0,25
066382002,256,13,7,14,0,61,13,364
066382003,296,7,20,23,1,53,18,418
066382004,22,5,0,0,0,0,5,32
066382005,212,24,7,7,0,4,2,256
066382006,168,5,0,20,1,1,15,210
066382007,223,9,7,9,0,9,11,268
066382008,155,13,0,9,0,3,6,186
066382009,216,40,1,14,2,15,22,310
066382101,114,12,1,2,0,9,4,142
066382102,55,5,1,0,0,20,3,84
066382103,65,7,0,0,0,5,5,82
066382104,283,68,13,10,0,142,36,552
066382105,60,7,2,0,0,44,9,122
066382106,16,4,0,2,1,7,0,30
066382107,259,29,4,21,0,114,30,457
066382108,3,0,0,0,0,0,0,3
066382201,521,21,4,4,0,1,3,554
066382202,249,21,4,3,5,0,4,286
066382203,237,2,0,1,0,0,3,243
066382204,338,4,1,9,0,0,4,356
066382205,283,9,0,0,1,0,8,301
066382206,549,49,1,7,0,0,19,625
066382207,218,15,4,1,0,1,3,242
066382208,288,11,0,4,0,0,7,310
066382209,242,4,3,8,0,0,8,265
066382210,161,25,0,2,1,17,1,207
066382211,125,21,5,9,1,1,7,169
066382212,128,44,1,2,0,2,2,179
066382213,217,17,2,7,0,4,10,257
066382214,387,21,1,5,1,0,9,424
066382301,201,9,0,3,0,3,4,220
066382302,168,32,1,13,0,8,15,237
066382303,68,4,2,8,0,16,5,103
066382304,202,25,10,4,0,54,13,308
066382305,6,0,2,2,0,11,4,25
066382306,30,0,0,0,0,2,2,34
066382307,59,14,1,0,0,0,0,74
066440101,64,63,47,0,0,102,10,286
066440102,57,67,24,11,0,101,7,267
066440103,109,42,39,4,3,169,27,393
066440104,43,93,63,2,0,114,10,325
066440105,32,71,27,2,0,209,34,375
066440106,52,8,32,1,0,165,10,268
066440107,47,65,18,0,0,136,8,274
066440108,20,38,0,0,0,67,5,130
066440109,12,0,0,0,0,134,4,150
066440110,34,0,0,0,1,399,10,444
066440111,26,36,60,0,0,136,7,265
066440201,195,4,49,7,0,91,14,360
066440202,93,1,12,2,2,176,5,291
066440203,48,3,2,0,0,249,5,307
066440204,33,0,33,0,1,253,1,321
066440205,36,27,0,0,0,209,14,286
066440206,71,10,15,15,4,412,12,539
066440207,90,4,39,7,2,305,2,449
066440208,79,74,99,1,0,98,39,390
066440301,226,31,20,5,0,6,4,292
066440302,146,20,16,3,2,23,9,219
066440303,5,2,0,0,0,4,8,19
066440304,169,27,51,10,0,133,5,395
066440305,83,33,27,11,1,32,10,197
066440306,49,2,4,10,1,126,6,198
066440307,89,100,78,5,0,97,70,439
066440308,34,10,103,0,2,210,6,365
066440309,39,1,15,8,0,250,5,318
066440310,30,0,3,5,0,219,35,292
066440311,57,6,1,16,0,280,3,363
066440312,27,53,4,11,0,156,5,256
066440313,76,1,1,4,0,39,10,131
066440314,21,103,0,5,0,128,35,292
066440315,18,11,4,8,1,87,7,136
066440316,10,57,0,5,0,92,25,189
066440401,77,53,39,6,6,264,47,492
066440402,64,48,16,6,1,248,9,392
066440403,55,63,43,6,1,171,6,345
066440404,46,88,19,1,0,95,95,344
066440405,58,1,37,7,1,288,2,394
066440406,26,38,60,4,2,252,7,389
066440407,47,53,14,4,1,301,33,453
066440408,35,3,46,0,0,264,5,353
066440501,41,0,76,37,1,388,5,548
066440502,82,70,22,25,1,129,48,377
066440503,202,27,2,4,0,2,2,239
066440504,137,9,6,1,0,4,0,157
066440505,423,64,30,6,6,12,11,552
066440506,379,80,5,2,11,11,38,526
066440507,216,28,15,0,2,48,5,314
066440508,101,13,40,1,3,189,11,358
066440509,99,97,61,2,1,137,30,427
066440510,46,40,38,15,2,151,18,310
066440511,53,1,197,2,0,64,26,343
066440512,79,25,60,0,1,218,29,412
066440513,35,5,36,0,1,276,4,357
066440601,252,16,3,1,2,4,1,279
066440602,137,17,2,4,0,2,3,165
066440603,125,19,9,12,0,3,7,175
066440604,120,16,64,6,0,98,9,313
066440605,84,22,77,11,6,89,2,291
066440606,117,42,45,8,1,108,10,331
066440607,152,22,13,8,1,2,3,201
066440608,280,28,18,5,2,25,9,367
066440609,220,16,1,2,0,2,1,242
066440610,185,14,5,0,0,4,4,212
066440611,68,11,1,0,0,0,0,80
066440612,274,39,0,1,0,2,1,317
066440613,191,42,5,9,1,122,1,371
066440614,136,30,20,4,0,23,3,216
066440615,221,29,7,7,3,22,6,295
066440616,117,9,31,11,1,127,1,297
066440617,55,3,76,5,0,81,2,222
066440618,69,67,74,6,5,70,28,319
066440619,84,36,99,11,0,165,12,407
066440620,103,20,112,14,0,194,17,460
066440621,93,36,56,4,0,41,4,234
066440622,140,9,28,8,3,59,25,272
066480101,338,13,0,4,0,2,1,358
066480102,305,5,3,3,1,1,9,327
066480103,409,15,13,9,0,1,11,458
066480104,329,13,5,9,3,6,13,378
066480105,359,20,7,1,6,1,7,401
066480106,366,26,6,0,2,5,11,416
066480107,251,12,5,5,2,2,3,280
066480108,253,9,2,3,1,0,3,271
066480109,251,5,2,4,0,0,4,266
066480110,433,15,2,3,0,6,5,464
066480111,327,11,1,8,0,1,5,353
066480112,349,4,0,5,0,0,3,361
066480113,316,3,6,2,0,0,3,330
066480114,433,22,2,10,0,0,6,473
066480115,248,7,1,4,0,2,1,263
066480116,240,8,0,20,1,0,5,274
066480117,260,18,0,4,1,1,9,293
066480118,256,11,1,12,0,1,7,288
066480119,289,8,0,4,0,0,6,307
066480201,373,2,0,4,0,0,4,383
066480202,244,2,2,8,0,6,8,270
066480203,156,21,2,5,0,144,5,333
066480204,301,6,2,28,0,2,5,344
066480205,262,2,3,27,0,0,9,303
066480206,272,5,3,30,0,0,19,329
066480207,364,19,6,11,0,3,5,408
066480208,355,7,1,4,0,1,5,373
066480209,320,11,8,6,0,0,3,348
066480210,385,4,7,2,1,3,10,412
066480211,225,11,0,3,0,3,11,253
066480212,352,25,4,5,1,0,10,397
066480213,379,18,7,4,1,1,7,417
066480301,287,8,8,7,6,2,6,324
066480302,339,15,1,7,1,2,8,373
066480303,58,0,2,2,0,1,6,69
066480304,302,5,0,7,0,0,6,320
066480305,221,3,0,5,0,2,5,236
066480306,271,5,2,15,0,2,10,305
066480307,219,7,3,2,0,0,10,241
066480308,412,10,4,13,0,0,6,445
066480309,377,8,7,12,3,3,12,422
066480310,404,9,2,10,0,6,13,444
066480311,247,8,0,10,0,2,8,275
066480312,317,1,2,13,1,0,9,343
066480313,176,20,1,21,3,85,12,318
066480314,110,8,7,24,1,45,35,230
066480315,320,4,1,20,0,2,23,370
066480316,110,12,0,3,0,0,10,135
066480401,277,2,0,2,0,0,1,282
066480402,228,5,3,2,0,0,3,241
066480403,294,1,4,14,1,2,12,328
066480404,308,11,0,16,1,1,10,347
066480405,19,4,1,0,0,0,0,24
066480406,227,10,1,4,0,1,6,249
066480407,35,0,0,8,1,14,1,59
066480408,7,0,0,1,0,3,0,11
066480409,37,4,0,1,1,17,30,90
066480410,43,15,0,7,0,3,4,72
066480411,46,10,0,11,0,20,2,89
066480501,220,5,0,4,0,1,10,240
066480502,365,7,3,12,0,0,4,391
066480503,249,8,1,1,0,0,2,261
066480504,298,9,0,6,0,2,4,319
066480505,257,2,0,10,0,1,12,282
066480506,454,4,1,13,0,2,9,483
066480507,430,10,0,6,1,1,6,454
066480508,256,6,0,2,0,0,5,269
066480509,380,2,11,7,3,5,4,412
066480510,229,13,4,4,1,0,9,260
066480511,329,7,0,1,0,0,4,341
066480512,256,5,0,2,0,0,2,265
066480513,417,2,22,0,0,0,2,443
066480514,291,0,13,2,0,0,0,306
066510101,7,0,0,0,0,1,10,18
066510102,8,1,0,0,0,0,3,12
066510103,27,4,0,10,0,0,5,46
066510104,200,19,3,16,0,1,11,250
066510105,269,26,3,1,3,0,2,304
066510106,192,18,4,4,1,1,11,231
066510107,180,18,3,1,3,2,4,211
066510108,332,21,3,2,4,0,14,376
066510109,225,11,3,7,1,4,6,257
066510110,273,35,3,8,6,1,23,349
066510111,181,13,6,3,7,3,10,223
066510112,6,0,2,1,0,1,2,12
066510201,13,15,0,7,0,9,10,54
066510301,11,1,0,0,0,5,1,18
066510302,9,2,0,0,0,6,5,22
066510303,6,6,0,0,0,6,3,21
066510304,7,0,0,0,1,14,6,28
066510401,11,3,0,0,0,1,4,19
066510402,9,21,1,0,0,0,0,31
066510403,15,4,0,0,0,8,0,27
066510404,10,3,0,0,0,0,4,17
066510405,6,8,0,0,0,0,1,15
066510406,3,1,0,0,0,1,3,8
066510407,12,13,0,0,0,0,1,26
066510501,3,0,0,0,0,0,0,3
066510502,3,0,0,0,0,7,0,10
066510503,10,0,0,0,0,2,4,16
066510504,210,7,0,12,0,2,26,257
066510505,189,13,0,4,0,2,12,220
066510506,325,25,4,7,7,4,20,392
066510507,236,35,5,2,1,1,12,292
066510508,354,49,12,7,9,1,19,451
066510509,310,31,5,3,0,2,23,374
066510510,268,39,4,10,1,0,24,346
066510511,318,26,2,1,1,2,4,354
066510601,8,1,5,0,0,0,3,17
066510602,7,11,0,0,0,0,11,29
066510603,8,3,0,0,0,0,8,19
066510604,10,2,0,0,0,3,5,20
066510605,3,3,0,0,0,0,0,6
066510606,9,1,0,1,0,2,5,18
066510607,12,1,1,0,0,1,1,16
066510608,4,0,0,0,0,0,1,5
066510609,7,0,0,0,0,0,0,7
066510610,6,5,0,0,0,1,3,15
066510701,140,10,3,0,0,1,15,169
066510702,12,2,0,0,0,6,1,21
066510703,8,3,0,0,0,0,3,14
066510704,5,0,0,0,0,0,8,13
066510705,4,0,0,0,0,0,12,16
066510706,8,0,1,0,0,6,14,29
066510707,11,2,0,0,0,8,9,30
066510708,4,8,0,0,0,0,7,19
066510709,3,0,0,0,0,0,11,14
066510710,5,7,0,0,0,0,0,12
066510711,5,12,0,0,0,0,0,17
066510712,6,0,0,0,0,2,12,20
066510713,11,9,0,0,0,3,2,25
066510714,252,31,13,2,19,4,39,360
066510715,254,43,8,1,0,1,30,337
066510716,116,8,4,2,0,3,27,160
066510801,90,22,1,0,1,1,11,126
066510802,136,21,3,3,1,0,10,174
066510803,1,0,0,0,0,0,7,8
066510804,7,3,0,0,0,0,4,14
066510805,2,0,0,0,0,7,1,10
066510806,2,1,1,0,0,0,5,9
066510807,2,4,0,0,0,1,4,11
066510808,11,4,0,0,0,0,3,18
066510809,8,0,0,0,0,0,0,8
066510810,10,2,0,0,0,1,6,19
066510811,4,4,0,0,0,0,3,11
066510812,3,0,0,0,0,7,1,11
066510813,8,0,0,0,0,0,0,8
066510814,4,0,0,0,0,0,0,4
066510815,5,0,0,0,0,0,8,13
066510816,3,0,0,0,0,7,4,14
066510817,15,2,0,0,0,0,2,19
066510818,155,38,0,2,1,2,23,221
066510901,7,0,0,0,0,1,4,12
066510902,16,9,0,0,0,0,1,26
066511001,52,20,0,1,0,0,9,82
066511002,4,0,0,0,0,0,14,18
066511003,11,12,0,0,0,0,5,28
066511004,4,3,0,0,0,0,8,15
066511005,3,4,0,0,0,2,1,10
066511101,9,10,0,0,0,0,8,27
066511102,7,16,0,0,0,0,0,23
066511103,7,2,0,0,0,0,1,10
066511104,10,7,0,0,0,0,0,17
066511201,7,9,0,0,0,0,0,16
066511202,9,0,0,0,0,0,0,9
066511203,15,2,0,0,0,0,8,25
066511301,3,11,0,0,0,0,0,14
066511302,35,15,2,1,0,5,10,68
066511303,15,24,0,0,0,0,0,39
066511304,11,1,0,1,0,0,6,19
066511305,9,5,7,0,0,2,6,29
066511306,15,1,0,0,0,5,4,25
066511307,18,1,0,0,0,0,16,35
066511308,122,15,0,0,0,1,19,157
066511309,140,12,0,2,0,2,28,184
066511310,70,6,4,0,1,1,16,98
066511311,13,2,0,0,0,0,6,21
066511312,9,1,0,0,0,1,3,14
066550101,21,0,0,0,0,5,4,30
066550102,17,4,0,0,0,7,7,35
066550103,39,22,0,3,0,22,5,91
066550104,29,5,1,1,1,2,6,45
066550105,50,16,0,0,0,14,14,94
066550106,19,8,2,0,0,5,8,42
066550201,36,23,0,0,0,20,3,82
066550202,221,26,1,5,0,0,7,260
066550203,218,21,5,26,1,4,7,282
066550204,305,22,38,7,1,6,10,389
066550205,230,18,1,8,1,6,12,276
066550206,162,16,2,6,1,6,9,202
066550207,29,14,2,2,0,7,2,56
066550208,25,16,0,0,0,6,17,64
066550209,60,13,0,2,0,1,21,97
066550210,154,24,1,3,2,7,23,214
066550211,172,16,0,2,0,3,28,221
066550301,38,112,3,4,1,6,8,172
066550302,33,15,1,8,0,79,15,151
066550303,43,4,1,1,0,92,2,143
066550304,40,33,8,2,1,76,11,171
066550305,65,21,11,7,4,141,18,267
066550306,50,0,0,1,3,34,11,99
066550307,45,11,0,0,0,8,38,102
066550308,118,14,2,5,0,36,17,192
066550309,268,23,1,5,0,6,10,313
066550310,265,24,8,4,0,4,11,316
066550311,402,60,11,8,0,6,26,513
066550312,207,18,6,2,4,1,6,244
066650101,230,10,1,13,2,3,11,270
066650102,191,10,3,5,0,2,3,214
066650103,7,0,0,0,0,7,0,14
066650104,13,3,0,0,0,87,2,105
066650105,66,32,0,0,0,21,4,123
066650201,22,0,0,0,1,0,0,23
066650202,299,15,2,7,3,4,11,341
066650203,398,20,4,2,6,3,9,442
066650204,330,18,12,2,3,1,10,376
066650205,434,17,1,3,3,2,7,467
066650206,227,6,0,1,0,0,4,238
066650207,337,19,10,4,0,5,4,379
066650208,273,29,0,0,0,18,4,324
066650209,27,3,0,0,0,3,4,37
066650301,18,1,0,1,0,1,1,22
066650302,277,7,1,12,0,1,9,307
066650303,225,10,5,2,2,10,28,282
066650304,17,0,0,3,0,2,1,23
066650305,142,3,3,0,0,4,0,152
066650306,166,6,3,6,0,0,7,188
066650307,129,3,4,2,0,0,1,139
066650308,95,4,1,1,0,1,2,104
066650309,273,12,9,4,1,2,7,308
066650310,443,15,11,8,4,1,5,487
066650311,32,1,0,0,0,0,0,33
066650401,121,18,2,2,2,1,4,150
066650402,44,5,1,2,1,54,2,109
066650403,26,1,0,0,0,2,9,38
066650404,18,27,0,0,0,0,0,45
066650501,11,0,0,0,0,0,7,18
066650502,25,2,0,2,0,13,5,47
066650503,32,4,0,0,0,4,13,53
066650601,13,2,0,0,0,0,16,31
066650701,36,1,0,0,2,4,1,44
066650801,13,7,0,4,0,3,0,27
066650901,26,5,0,0,0,18,2,51
066651001,299,27,7,5,0,1,6,345
066651002,333,18,3,5,1,0,2,362
066651003,14,9,0,0,0,4,2,29
066651004,23,3,0,0,0,2,6,34
066651005,7,14,0,0,0,0,0,21
066651006,8,2,0,0,0,3,0,13
066651007,317,12,6,5,1,1,8,350
066651008,366,19,6,5,2,2,4,404
066651101,21,0,0,0,0,15,9,45
066651201,0,1,0,0,0,3,0,4
066651202,2,0,0,2,1,65,0,70
066651301,8,3,0,0,0,0,0,11
066651302,0,0,0,0,0,0,1,1
066651303,306,12,7,13,0,5,9,352
066651304,298,12,3,3,0,1,5,322
066651305,390,18,11,6,1,5,10,441
066651306,396,31,3,8,3,3,11,455
066651307,262,10,4,6,3,1,2,288
066651308,240,11,3,12,0,2,2,270
066651309,361,14,3,14,0,2,12,406
066651310,303,21,4,1,1,0,10,340
066651311,369,21,7,6,1,2,9,415
066651312,483,15,7,9,0,0,12,526
066720101,10,8,0,0,0,0,1,19
066720102,21,4,0,0,0,2,4,31
066720103,8,0,0,0,0,0,1,9
066720104,14,3,0,0,0,1,0,18
066720201,11,4,0,0,0,2,4,21
066720202,15,3,0,0,0,3,1,22
066720301,3,1,0,1,0,1,2,8
066720302,15,2,0,0,0,0,1,18
066720303,11,3,0,0,0,0,7,21
066720401,14,0,0,1,0,9,1,25
066720402,19,3,1,0,0,0,6,29
066720403,39,10,3,0,1,7,22,82
066720404,15,14,0,0,0,2,3,34
066720501,14,0,0,0,0,0,5,19
066720502,6,9,0,0,0,0,2,17
066720503,8,11,0,0,0,2,1,22
066720504,6,3,0,0,0,0,0,9
066720601,7,0,0,0,0,0,4,11
066720602,9,2,0,0,0,7,1,19
066720603,4,7,0,0,0,0,4,15
066720604,6,0,0,0,0,1,7,14
066720701,32,13,0,0,0,6,3,54
066720702,28,1,0,0,0,6,11,46
066720801,12,0,0,0,0,0,1,13
066720802,14,12,0,0,0,0,0,26
066720901,18,15,2,0,0,0,1,36
066720902,13,6,0,0,0,10,7,36
066720903,15,6,0,0,0,2,2,25
066721001,17,2,0,0,2,9,9,39
066721002,20,1,0,1,0,14,8,44
066721101,7,0,0,0,0,4,11,22
066721102,16,0,0,1,0,7,5,29
066721103,15,6,0,0,0,1,0,22
066721104,15,7,0,0,0,3,1,26
066721201,465,27,0,2,0,2,7,503
066721202,262,35,3,0,0,0,12,312
066721203,323,27,5,2,2,2,2,363
066721204,368,23,4,4,10,5,19,433
066721205,344,36,6,1,2,3,21,413
066721206,339,34,5,1,3,8,31,421
066721207,370,24,5,6,5,0,8,418
066721208,376,34,6,6,5,1,19,447
066721209,284,28,2,6,1,1,6,328
066721210,627,54,6,7,0,3,15,712
066721211,20,2,0,0,0,0,18,40
066721212,43,20,0,1,0,0,15,79
066721213,13,6,2,0,0,3,0,24
066721214,165,11,0,37,0,4,21,238
066721215,286,23,3,5,0,2,7,326
066721216,278,14,1,4,0,1,6,304
066721301,13,5,0,0,0,3,3,24
066721302,10,2,0,0,0,0,8,20
066721303,19,0,0,0,0,4,19,42
066721401,9,6,0,0,0,0,3,18
066721402,49,25,0,0,0,5,10,89
066721403,60,2,0,0,1,7,16,86
066790101,78,5,1,7,0,0,17,108
066790102,21,3,0,0,1,1,21,47
066790103,17,1,0,0,0,2,1,21
066790104,11,0,0,0,0,0,31,42
066790105,91,2,3,2,1,1,12,112
066790201,18,0,0,0,0,0,0,18
066790202,12,2,1,0,0,2,12,29
066790301,21,0,0,0,0,1,3,25
066790302,147,25,0,5,0,1,3,181
066790303,159,20,2,1,0,4,10,196
066790304,111,4,3,0,0,3,7,128
066790305,106,10,0,2,0,0,11,129
066790306,14,0,1,0,0,8,3,26
066790401,6,0,0,0,0,2,9,17
066790402,12,0,0,0,0,1,5,18
066790403,10,3,0,0,0,0,1,14
066790404,8,1,0,0,0,0,3,12
066790405,6,0,0,0,0,9,6,21
066790501,4,8,0,0,0,2,1,15
066790502,26,5,0,0,0,1,2,34
066790503,10,0,0,1,0,5,8,24
066790601,349,17,9,10,0,1,4,390
066790602,258,22,1,0,2,0,12,295
066790603,231,16,23,0,0,0,0,270
066790604,258,22,16,0,0,0,2,298
066790605,379,34,9,9,0,0,5,436
066790606,261,12,2,10,0,0,5,290
066790607,261,32,2,2,5,3,9,314
066790608,183,25,2,5,2,15,10,242
066790609,244,50,3,0,13,0,0,310
066790610,290,28,3,4,4,1,8,338
066790611,263,16,9,6,2,3,20,319
066790612,216,5,3,2,0,1,12,239
066790613,235,44,13,7,4,0,6,309
066790701,12,4,0,0,0,2,5,23
066790702,13,2,0,0,0,5,4,24
066790801,21,10,0,0,0,1,0,32
066790802,31,2,0,0,0,3,2,38
066790901,162,15,2,6,1,2,7,195
066790902,30,4,0,1,0,1,0,36
066790903,13,5,0,0,0,0,3,21
066790904,78,5,1,2,0,9,20,115
066790905,158,7,3,3,0,2,9,182
066791001,109,27,1,9,1,9,9,165
066791002,10,9,0,0,0,0,7,26
066791003,22,15,0,0,0,0,0,37
066791101,18,3,0,0,0,3,8,32
066791102,41,0,0,0,1,5,9,56
066791103,16,10,0,0,0,2,3,31
066791201,92,17,0,4,1,0,10,124
066791202,16,2,0,0,2,1,1,22
066791203,20,18,0,0,0,0,2,40
066791204,31,3,0,0,0,4,20,58
066791205,2,1,0,0,0,0,15,18
066791206,28,12,1,0,0,0,7,48
066860101,191,3,2,4,0,3,5,208
066860102,378,21,0,3,0,3,5,410
066860103,325,39,5,7,2,0,9,387
066860104,334,33,1,3,0,2,11,384
066860105,276,20,12,3,4,3,14,332
066860106,259,33,5,8,2,0,12,319
066860107,234,23,7,4,8,4,17,297
066860108,248,31,7,4,7,3,25,325
066860109,251,20,5,7,9,4,41,337
066860110,341,30,0,3,1,3,8,386
066860201,243,24,3,2,3,6,13,294
066860202,128,13,5,10,3,3,12,174
066860203,28,0,0,0,0,2,23,53
066860204,2,0,0,0,0,0,15,17
066860205,3,7,0,3,0,3,1,17
066860206,3,0,0,0,0,0,11,14
066860207,2,0,0,0,0,0,10,12
066860208,5,0,0,0,0,0,12,17
066860209,10,0,0,0,1,3,8,22
066860210,1,10,0,0,0,0,0,11
066860301,14,5,0,0,0,6,10,35
066860302,24,0,0,0,0,2,15,41
066860303,12,1,0,0,0,9,8,30
066860304,21,0,0,0,0,13,7,41
066860401,4,6,0,0,1,0,3,14
066860402,7,7,0,0,0,4,2,20
066860403,4,2,0,0,0,0,11,17
066860501,10,0,0,0,0,3,1,14
066860502,13,0,0,0,0,9,36,58
066860601,173,10,1,3,0,3,4,194
066860602,55,22,1,1,5,6,21,111
066860603,24,0,1,4,0,60,16,105
066860604,24,0,0,3,2,41,11,81
066860605,19,0,0,0,0,0,7,26
066860606,18,1,0,6,0,5,5,35
066860607,8,10,0,0,0,0,0,18
066860608,133,17,1,3,0,17,11,182
066860609,185,6,3,10,0,13,4,221
066860701,21,5,0,1,0,8,14,49
066860702,10,2,0,0,0,4,6,22
066860703,15,7,0,0,0,0,0,22
066860704,1,0,0,0,0,0,5,6
066860705,7,0,0,0,0,0,8,15
066860706,7,0,0,0,0,5,3,15
066860707,16,19,0,0,0,0,2,37
066860801,7,8,0,0,0,1,2,18
066860802,5,4,0,0,0,0,5,14
066860803,9,8,0,0,0,0,4,21
066860804,8,0,0,0,0,0,38,46
066860805,32,15,0,0,0,2,2,51
066860901,7,7,0,0,0,0,7,21
066860902,6,0,0,0,0,0,17,23
066860903,9,20,0,0,0,0,0,29
066861001,4,0,0,0,0,1,37,42
066861002,31,5,0,0,0,1,0,37
066861003,15,0,0,0,0,0,8,23
066861101,320,15,2,0,1,1,38,377
066861102,10,0,0,0,1,2,20,33
066861103,13,0,0,0,0,1,27,41
066861201,10,0,0,0,0,5,9,24
066861202,4,1,0,0,0,3,9,17
066861203,15,0,0,0,0,1,5,21
066861204,7,4,0,0,0,2,0,13
066861301,133,12,2,9,0,4,9,169
066861302,194,9,2,1,0,10,8,224
066861303,164,16,0,2,0,3,5,190
066861304,258,13,1,5,1,2,6,286
066861305,255,21,0,7,0,3,4,290
066861306,181,15,0,4,0,1,9,210
066861307,226,27,0,5,0,2,6,266
066861308,145,24,0,3,0,5,2,179
066861309,290,23,9,3,0,2,9,336
066861310,291,27,7,4,1,1,16,347
066861311,262,25,6,3,4,0,19,319
066861312,252,25,3,0,14,1,18,313
066861313,279,32,5,4,8,2,10,340
066861314,188,10,1,0,0,0,4,203
066930101,47,0,0,0,0,1,20,68
066930102,23,7,0,0,0,1,3,34
066930201,32,4,0,0,0,7,16,59
066930202,40,7,0,0,0,11,6,64
066930203,16,16,0,0,0,0,2,34
066930301,49,12,0,0,0,13,19,93
066930302,32,1,0,0,0,22,12,67
066930303,55,1,1,0,0,9,18,84
066930304,54,5,0,2,1,18,10,90
066930305,151,15,2,8,0,6,1,183
066930306,180,10,5,10,0,4,14,223
066930307,420,16,2,8,2,18,13,479
066930308,233,8,4,3,5,5,13,271
066930309,177,8,7,1,2,2,10,207
066930310,173,5,9,2,1,2,6,198
066930311,390,12,2,14,1,0,3,422
066930312,239,12,9,3,18,9,27,317
066930313,265,10,5,7,1,5,9,302
066930314,185,6,5,10,1,7,13,227
066930315,4,0,0,0,0,0,0,4
066930316,305,7,0,2,0,2,5,321
066930317,252,10,6,1,5,15,13,302
066930318,238,12,4,6,0,0,3,263
066930319,279,19,1,5,0,0,2,306
066930401,63,7,0,0,0,11,20,101
066930402,46,13,0,0,0,7,10,76
066930501,16,0,0,0,0,9,5,30
066930502,20,1,0,0,0,4,11,36
066930601,15,3,0,0,0,7,3,28
066930602,15,1,0,0,0,5,9,30
066930603,11,0,0,0,0,4,5,20
066930604,19,0,0,1,0,10,15,45
066930701,18,2,0,3,0,2,10,35
066930702,16,0,0,1,0,3,13,33
066930703,87,4,0,1,4,16,20,132
066930704,51,10,0,2,0,17,16,96
067000101,115,10,6,0,0,2,11,144
067000102,174,26,2,0,1,0,19,222
067000103,7,2,0,0,0,0,2,11
067000104,5,0,0,0,0,11,2,18
067000105,6,5,1,0,0,0,3,15
067000106,6,5,0,0,0,0,0,11
067000107,11,1,0,0,0,1,3,16
067000108,4,5,0,0,0,0,8,17
067000109,2,0,0,0,0,9,0,11
067000110,190,13,5,1,0,1,21,231
067000201,14,2,3,0,0,3,0,22
067000202,10,6,0,0,0,5,2,23
067000203,5,3,0,0,0,0,5,13
067000204,78,7,1,1,0,2,4,93
067000205,193,10,3,11,2,9,20,248
067000206,222,10,5,2,1,0,14,254
067000207,150,28,9,0,0,2,6,195
067000208,188,25,4,1,9,1,9,237
067000209,356,51,9,9,6,6,21,458
067000210,213,15,6,13,1,0,16,264
067000211,235,28,3,9,2,0,6,283
067000212,231,16,3,7,3,0,3,263
067000213,295,14,11,7,3,0,18,348
067000214,302,24,4,7,0,0,7,344
067000215,305,23,0,8,1,3,4,344
067000216,279,14,4,3,0,0,3,303
067000301,7,13,0,0,0,0,9,29
067000302,10,13,0,0,0,3,4,30
067000303,6,8,0,0,0,0,0,14
067000401,15,0,0,0,0,0,3,18
067000402,14,8,0,0,0,0,0,22
067000501,66,16,3,2,1,6,9,103
067000502,6,6,0,0,0,0,19,31
067000503,8,3,0,0,0,0,0,11
067000504,6,0,0,0,0,2,4,12
067000505,19,11,0,0,0,1,1,32
067000601,3,9,0,0,0,0,2,14
067000602,12,15,0,0,0,0,9,36
067000603,151,8,1,0,1,1,13,175
067000604,246,26,6,0,1,3,11,293
067000605,234,21,6,1,0,0,14,276
067000606,183,15,5,3,0,0,20,226
067000701,197,32,7,0,1,0,25,262
067000702,7,0,0,0,0,4,7,18
067000703,7,0,0,0,0,6,0,13
067000704,7,5,0,0,0,0,1,13
067000705,14,14,0,0,0,3,5,36
067000706,8,9,0,1,0,0,0,18
067000707,10,0,0,0,0,13,2,25
067000801,8,5,4,0,0,0,0,17
067000802,6,7,0,0,0,0,1,14
067000803,4,8,0,1,0,0,8,21
067000804,7,0,0,0,0,0,6,13
067000805,6,0,0,0,0,0,10,16
067000806,3,2,0,0,0,4,8,17
067000807,7,0,0,0,0,9,10,26
067000808,0,10,0,0,0,0,2,12
067000809,5,7,0,0,0,0,0,12
067000901,6,9,0,0,0,0,0,15
067000902,5,12,0,0,0,0,0,17
067000903,4,4,0,0,0,0,0,8
067000904,7,8,0,0,0,0,2,17
067001001,5,3,0,0,0,0,3,11
067001002,8,2,0,0,0,0,3,13
067001003,52,24,1,0,0,9,13,99
067001004,3,41,0,0,0,0,32,76
067001101,14,6,1,0,0,7,2,30
067001102,5,8,0,0,0,2,0,15
067001201,8,0,0,0,0,8,3,19
067001202,15,9,0,0,0,0,0,24
067001203,8,4,0,0,1,0,1,14
067001204,217,16,2,0,1,0,12,248
067001205,181,19,1,0,0,0,5,206
067001206,148,20,6,1,0,2,4,181
067001207,301,28,10,1,4,1,9,354
067001208,2,6,2,0,0,1,9,20
067001209,172,10,1,1,0,0,6,190
067001210,260,28,6,4,0,2,7,307
067001211,326,22,5,10,1,0,10,374
067001212,367,28,4,16,3,0,15,433
067001213,195,14,7,5,0,1,11,233
067070101,327,2,7,9,0,2,6,353
067070102,447,32,1,13,0,4,9,506
067070103,218,20,2,7,0,2,7,256
067070104,213,14,3,6,0,0,3,239
067070105,389,32,8,9,4,8,20,470
067070106,387,36,12,4,4,1,20,464
067070107,272,35,5,3,8,1,17,341
067070108,221,31,6,4,15,3,14,294
067070109,300,32,7,1,8,5,17,370
067070110,234,26,0,1,0,2,10,273
067070111,142,6,4,0,0,2,2,156
067070112,223,14,8,17,1,7,4,274
067070113,238,25,1,4,0,1,6,275
067070114,148,8,2,4,2,1,8,173
067070115,246,23,5,5,1,3,7,290
067070116,174,12,0,2,1,3,2,194
067070117,279,22,7,7,0,4,19,338
067070201,25,12,0,0,0,4,12,53
067070202,31,14,0,0,0,1,6,52
067070301,87,1,0,0,1,22,57,168
067070401,132,22,2,9,0,32,26,223
067070402,99,24,0,0,0,26,9,158
067070403,266,51,5,31,0,36,18,407
067070404,51,1,2,2,0,8,30,94
067070405,266,24,0,5,1,1,4,301
067070501,77,17,1,3,2,3,8,111
067070502,31,0,0,0,0,14,10,55
067070503,34,26,0,0,0,9,7,76
067070504,44,1,0,0,0,11,23,79
067070601,8,0,0,0,1,1,3,13
067070602,43,7,0,2,2,26,19,99
067070603,130,13,1,4,0,16,5,169
067070604,155,1,1,4,0,22,22,205
067070605,142,11,0,4,0,14,9,180
067070606,56,13,0,1,0,25,26,121
067070607,156,15,2,3,2,7,24,209
067070608,31,6,0,1,0,10,26,74
067070701,1,4,0,0,0,0,0,5
067070702,45,8,0,1,0,0,25,79
067070801,80,5,0,4,0,11,24,124
067070802,61,6,0,0,0,5,13,85
067070803,45,3,0,0,1,14,24,87
067070901,56,14,0,0,0,8,20,98
067070902,65,8,1,1,0,17,18,110
067070903,29,8,1,0,0,7,14,59
067071001,23,13,0,0,0,0,4,40
067071002,33,3,0,0,0,1,9,46
067071101,326,20,8,7,0,4,9,374
067071102,335,27,5,9,0,6,18,400
067071103,243,23,5,15,0,2,10,298
067071104,367,14,7,20,0,10,14,432
067071105,270,21,6,8,0,0,5,310
067071106,274,31,10,6,7,2,8,338
067071107,300,34,8,2,9,3,9,365
067071108,295,34,7,7,9,3,14,369
067071109,217,9,11,10,8,5,19,279
067071110,361,35,5,7,1,1,16,426
067071111,229,40,3,6,1,1,3,283
067071112,199,6,9,12,0,9,6,241
067071113,336,21,5,15,2,2,10,391
067140101,397,33,8,14,2,4,10,468
067140102,354,37,5,6,2,0,16,420
067140103,298,28,8,7,11,1,10,363
067140104,317,21,10,6,8,2,3,367
067140105,351,27,4,4,3,0,4,393
067140106,304,26,4,4,5,1,6,350
067140107,332,24,4,4,0,0,13,377
067140108,312,51,3,46,9,0,32,453
067140109,292,38,9,3,10,3,10,365
067140110,368,40,8,6,6,1,7,436
067140111,225,20,3,5,3,0,13,269
067140112,294,24,5,10,4,3,11,351
067140113,190,15,1,0,0,0,6,212
067140114,290,9,1,5,0,1,13,319
067140115,208,11,2,0,1,0,3,225
067140201,6,2,0,0,1,0,6,15
067140202,14,9,0,0,0,7,4,34
067140203,11,2,0,0,0,5,7,25
067140204,7,8,0,0,0,0,0,15
067140205,7,2,0,0,0,2,6,17
067140206,10,0,0,0,0,0,2,12
067140207,12,1,0,0,0,1,2,16
067140301,610,30,8,14,9,10,16,697
067140302,8,3,0,0,0,3,16,30
067140303,3,0,0,0,0,3,1,7
067140304,6,4,0,0,0,0,2,12
067140305,9,0,0,0,0,0,19,28
067140306,4,0,0,0,0,2,12,18
067140401,12,2,0,1,0,2,6,23
067140402,17,1,0,0,0,5,10,33
067140403,20,2,0,1,0,6,18,47
067140404,9,0,0,0,0,8,5,22
067140501,216,14,2,12,1,6,6,257
067140502,13,2,0,0,0,3,6,24
067140503,19,7,0,0,0,4,1,31
067140504,58,2,1,0,0,12,12,85
067140505,29,12,0,0,0,0,4,45
067140601,313,21,1,3,0,2,3,343
067140602,328,9,2,2,0,1,0,342
067140603,124,8,2,2,0,0,6,142
067140604,242,12,0,5,0,0,2,261
067140605,273,19,1,13,1,0,6,313
067140606,236,17,4,4,0,0,10,271
067140607,249,16,3,10,1,0,10,289
067140608,257,6,2,1,0,1,10,277
067140609,250,16,1,10,1,2,4,284
067140610,160,12,3,12,1,5,4,197
067140611,319,16,2,4,4,5,8,358
067140612,276,20,0,5,4,0,5,310
067140613,445,30,4,5,1,2,13,500
067140614,7,1,0,0,0,2,2,12
067140615,121,7,1,4,1,5,5,144
067140616,193,8,2,2,0,0,6,211
067140617,275,14,8,4,2,11,7,321
067140701,6,4,0,0,0,0,0,10
067140702,57,10,0,0,0,2,12,81
067140703,10,2,0,0,0,3,3,18
067140801,138,17,0,1,0,2,3,161
067140802,5,1,0,0,0,4,14,24
067140803,8,8,0,0,0,0,0,16
067140804,41,2,0,0,0,9,13,65
067140805,19,0,0,1,0,1,8,29
067140806,64,2,0,1,0,15,29,111
067140807,8,26,0,0,0,1,0,35
067140808,14,8,0,0,0,0,0,22
067140809,193,16,5,7,0,5,19,245
067140901,50,1,1,0,0,3,28,83
067140902,13,5,0,0,0,0,4,22
067140903,12,1,0,0,0,10,7,30
067140904,18,5,0,0,0,1,4,28
067140905,5,0,0,0,0,0,5,10
067140906,11,0,0,0,0,3,2,16
067210101,205,28,9,2,0,4,16,264
067210102,23,1,0,0,0,5,16,45
067210103,17,19,0,0,0,4,0,40
067210104,32,11,0,0,0,0,9,52
067210201,228,26,3,0,4,0,7,268
067210202,108,10,1,2,10,0,20,151
067210203,220,23,11,3,6,4,8,275
067210204,405,52,7,10,6,5,6,491
067210205,358,33,10,11,4,1,14,431
067210206,235,24,5,0,0,1,3,268
067210207,271,19,2,2,0,0,9,303
067210208,7,5,0,0,0,1,3,16
067210209,18,1,0,0,0,1,11,31
067210210,4,2,0,0,0,0,0,6
067210211,12,0,0,0,0,2,14,28
067210212,12,29,0,0,0,3,1,45
067210213,13,0,0,0,0,3,10,26
067210214,237,28,3,4,0,1,6,279
067210215,233,25,6,7,2,9,5,287
067210216,217,27,5,3,0,0,10,262
067210217,243,27,2,3,7,0,9,291
067280101,293,31,2,3,1,7,7,344
067280102,57,1,0,0,0,18,3,79
067280201,95,6,5,1,0,12,4,123
067280202,74,8,0,3,2,22,4,113
067280203,22,1,0,0,0,9,0,32
067280204,15,5,1,1,0,6,1,29
067280301,14,1,0,0,0,3,1,19
067280302,15,4,0,0,1,7,3,30
067280303,27,2,0,0,0,8,4,41
067280304,10,0,0,0,0,1,1,12
067280401,16,0,0,0,0,3,0,19
067280402,5,0,0,0,0,3,3,11
067280403,4,0,0,0,0,1,5,10
067280501,16,0,0,0,0,4,7,27
067280502,9,2,0,0,0,5,1,17
067280503,15,1,0,0,1,4,6,27
067280601,9,0,0,0,0,2,3,14
067280602,14,0,0,0,0,4,0,18
067280603,4,0,0,0,0,5,0,9
067280701,11,0,0,0,1,5,2,19
067280702,8,3,0,0,0,4,4,19
067280703,28,10,0,0,0,0,0,38
067280801,38,4,0,0,0,13,8,63
067280802,23,1,0,1,0,3,4,32
067280803,18,3,1,0,0,3,3,28
067280901,108,0,0,1,0,8,3,120
067280902,90,5,2,1,0,0,2,100
067280903,125,20,4,9,2,19,4,183
067280904,215,7,0,14,0,14,2,252
067281001,204,11,0,1,0,1,2,219
067281002,158,8,2,1,7,5,2,183
067281003,272,16,3,5,3,0,12,311
067281004,156,10,4,5,3,2,8,188
067281005,156,9,1,3,9,2,5,185
067281006,138,9,2,1,1,1,11,163
067281007,153,13,2,4,1,1,1,175
067281008,180,4,3,3,2,0,6,198
067281009,177,13,6,0,1,4,2,203
067281010,262,14,3,3,4,3,0,289
067281011,222,10,4,5,1,0,6,248
067281012,160,13,3,2,3,0,8,189
067281013,196,16,13,0,2,0,4,231
067281014,167,9,3,1,2,0,5,187
067281015,189,20,1,1,3,0,8,222
067281016,202,5,12,4,3,4,10,240
067281017,181,13,4,4,3,2,3,210
067281018,243,13,1,3,0,2,4,266
067281019,292,14,5,5,1,2,5,324
067281020,253,13,0,2,0,0,8,276
067281021,254,17,4,6,0,12,6,299
067281022,271,23,3,16,0,3,2,318
067281023,54,3,0,1,0,8,0,66
067281024,249,13,4,2,1,2,5,276
067281025,38,7,0,0,0,2,0,47
067281026,13,0,0,4,0,21,0,38
067281101,6,1,0,0,0,1,0,8
067281102,30,6,0,0,0,0,2,38
067281103,25,0,0,0,0,1,7,33
067281201,21,8,0,1,0,5,9,44
067281202,21,0,0,0,0,6,8,35
067281301,154,11,2,14,5,22,16,224
067281302,32,1,0,3,3,16,8,63
067281303,21,3,0,0,0,32,3,59
067281401,39,13,0,1,0,0,0,53
067281402,155,5,2,7,2,3,2,176
067281403,39,3,0,0,0,0,3,45
067281404,21,0,0,0,0,5,0,26
067281405,35,3,0,0,0,10,9,57
067281406,54,11,6,0,0,6,5,82
067281407,18,0,0,0,0,0,4,22
067281408,28,2,0,1,0,0,1,32
067281501,48,16,0,0,0,0,0,64
067281502,20,0,1,0,0,3,1,25
067281503,22,8,0,0,1,3,2,36
067281601,10,6,0,0,0,1,1,18
067281602,8,0,0,1,0,2,2,13
067281603,18,8,0,0,0,4,3,33
067350101,152,10,1,5,0,7,3,178
067350102,163,20,0,2,3,1,3,192
067350103,242,12,2,2,16,3,5,282
067350104,236,23,5,6,18,5,11,304
067350105,365,34,5,3,5,10,5,427
067350106,351,18,6,6,5,6,17,409
067350107,324,21,5,4,19,3,15,391
067350108,226,9,7,5,7,6,19,279
067350109,356,27,1,3,1,3,7,398
067350110,379,13,1,6,4,3,14,420
067350201,183,20,2,11,0,18,15,249
067350202,22,0,1,0,0,2,0,25
067350203,4,1,0,0,0,2,3,10
067350204,46,1,0,1,1,22,1,72
067350205,42,11,0,2,0,3,3,61
067350206,31,0,3,1,0,6,5,46
067350207,21,6,0,1,0,4,6,38
067350208,14,2,0,0,2,5,5,28
067350301,144,11,8,55,2,12,21,253
067350302,24,2,0,0,1,19,3,49
067350303,15,9,0,0,0,0,11,35
067350304,16,1,0,1,0,5,2,25
067350305,21,2,0,1,0,14,6,44
067350306,38,0,0,0,0,60,20,118
067350307,27,1,0,0,0,5,9,42
067350308,173,21,1,9,1,13,17,235
067350401,12,0,0,1,1,3,2,19
067350402,45,2,2,0,0,5,10,64
067350403,22,6,0,0,0,0,0,28
067350404,112,16,0,4,0,0,17,149
067350501,8,1,0,0,0,1,3,13
067350502,4,1,0,0,0,1,0,6
067350503,14,0,0,1,0,8,3,26
067350504,2,5,0,0,0,0,0,7
067350601,14,1,0,0,0,2,6,23
067350602,9,0,0,0,0,1,4,14
067350603,2,1,0,1,0,0,4,8
067350701,226,17,4,3,0,4,6,260
067350702,333,8,2,28,4,6,18,399
067350703,342,16,4,2,0,1,7,372
067350704,140,11,1,3,0,1,1,157
067350705,350,10,1,2,1,1,2,367
067350706,383,13,2,4,2,2,10,416
067350707,334,12,1,4,0,1,6,358
067350708,333,30,4,5,1,1,8,382
067350709,309,21,3,5,3,4,5,350
067350710,236,16,0,8,0,0,6,266
067420101,19,0,0,0,0,0,0,19
067420201,57,36,0,0,0,1,3,97
067420301,27,32,0,0,0,10,4,73
067420401,329,29,3,7,2,0,12,382
067420402,304,23,5,4,2,2,9,349
067420403,235,27,4,0,3,0,6,275
067420404,244,22,1,3,0,1,15,286
067420405,227,18,4,7,3,1,0,260
067420406,183,19,0,9,0,1,9,221
067420407,246,25,3,2,0,2,4,282
067420408,191,20,1,0,0,6,7,225
067420409,33,4,0,0,0,0,3,40
067420410,103,8,0,1,0,1,7,120
067420411,1,0,0,0,0,0,5,6
067420412,3,0,0,0,0,1,1,5
067420413,256,21,2,8,1,1,6,295
067420414,191,15,3,1,4,6,5,225
067420501,29,41,0,0,2,1,25,98
067420601,9,14,0,0,0,1,2,26
067420701,18,1,0,0,0,0,8,27
067420702,55,17,0,1,0,8,28,109
067420801,29,0,0,0,0,0,0,29
067420901,38,20,0,0,0,4,2,64
067421001,16,1,7,6,2,133,5,170
067421002,61,11,0,0,0,7,21,100
067630101,340,33,4,4,2,0,5,388
067630102,312,18,6,6,0,0,11,353
067630103,361,18,4,3,2,0,13,401
067630104,350,24,9,4,7,0,7,401
067630105,297,14,6,7,1,0,7,332
067630106,198,24,4,6,16,3,63,314
067630107,209,40,23,2,23,1,15,313
067630108,316,54,22,2,25,3,27,449
067630109,381,47,17,4,20,3,41,513
067630110,286,16,3,3,1,0,6,315
067630111,350,16,5,3,9,0,23,406
067630112,226,15,13,2,2,0,7,265
067630113,275,23,8,3,6,1,12,328
067630114,266,12,2,6,1,0,8,295
067630115,385,25,4,7,7,0,18,446
067630201,117,15,22,0,0,0,2,156
067630202,69,0,1,1,1,1,1,74
067630203,237,13,7,1,8,1,19,286
067630204,300,12,2,8,4,1,3,330
067630205,407,4,3,3,6,0,13,436
067630206,358,12,27,6,18,0,11,432
067630207,313,16,33,4,13,2,34,415
067630208,156,0,6,1,16,3,20,202
067630209,314,10,24,4,3,2,13,370
067630210,308,16,7,5,6,0,16,358
067630211,345,29,13,2,13,3,20,425
067630212,168,24,36,0,0,0,16,244
067630213,99,10,6,0,4,0,18,137
067630301,335,1,22,9,41,6,30,444
067630302,350,35,18,2,6,5,24,440
067630303,226,15,15,3,13,1,7,280
067630304,336,33,12,0,20,2,29,432
067630305,233,13,11,1,36,1,13,308
067630306,301,34,6,1,16,0,20,378
067630307,346,12,12,0,6,0,17,393
067630308,363,29,13,7,8,0,29,449
067630309,396,17,9,7,8,0,25,462
067630310,256,9,5,3,5,0,24,302
067630311,276,4,8,11,5,0,11,315
067630401,311,17,8,1,2,0,15,354
067630402,343,13,8,8,6,3,35,416
067630403,289,11,6,0,0,0,5,311
067630404,223,5,2,1,0,0,8,239
067630405,309,9,6,3,0,0,6,333
067630406,272,0,4,1,2,0,4,283
067630407,191,1,0,1,0,0,1,194
067630408,314,7,1,0,1,1,2,326
067630409,268,9,2,2,1,0,4,286
067630410,194,8,6,0,1,1,5,215
067630501,214,5,2,3,2,1,7,234
067630502,259,3,1,3,1,0,6,273
067630503,247,9,1,11,0,2,2,272
067630504,163,6,2,0,2,1,5,179
067630505,229,10,1,5,0,0,2,247
067630506,340,16,5,7,1,1,13,383
067630507,324,11,5,11,1,1,7,360
067630508,203,7,0,6,1,1,1,219
067630509,242,13,2,1,1,2,7,268
067630510,219,3,2,0,0,0,4,228
067630511,405,12,6,6,1,0,9,439
067630512,89,3,3,0,1,0,0,96
067630513,300,7,2,2,1,0,7,319
067630514,320,0,6,9,1,1,4,341
067630515,261,6,2,6,0,1,3,279
067630516,223,27,1,0,1,0,4,256
067630517,239,9,2,2,0,0,4,256
067630518,285,9,1,4,0,1,5,305
067630601,410,20,3,0,0,0,8,441
067630602,260,9,2,6,4,0,7,288
067630603,282,6,1,1,0,0,2,292
067630604,340,11,6,6,0,0,9,372
067630605,299,11,4,13,1,0,9,337
067630606,329,9,1,2,0,0,4,345
067630607,363,1,1,2,0,0,16,383
067630608,372,11,0,6,0,0,1,390
067630609,248,3,0,20,0,1,7,279
067630610,257,4,0,6,1,0,5,273
067630611,254,3,0,0,1,0,4,262
067630612,240,6,1,5,1,0,1,254
067630613,288,6,1,5,0,0,9,309
067630614,334,6,1,1,0,0,3,345
067630615,409,4,2,3,0,0,8,426
067630701,24,0,0,0,0,0,0,24
067630702,241,11,0,1,1,0,6,260
067630703,335,2,5,4,0,1,0,347
067630704,290,10,2,3,1,0,5,311
067630705,302,11,21,5,0,3,8,350
067630706,421,12,16,12,3,1,7,472
067630707,302,15,4,4,0,0,4,329
067630708,267,13,1,4,3,1,2,291
067630709,214,13,0,6,0,0,6,239
067630710,376,5,0,4,0,0,3,388
067630711,444,9,1,5,1,0,6,466
067630712,148,9,2,2,0,0,1,162
067630801,219,3,1,5,0,0,8,236
067630802,302,9,0,5,0,0,11,327
067630803,233,14,2,8,1,0,7,265
067630804,394,4,1,7,0,0,9,415
067630805,295,3,1,5,0,0,10,314
067630806,294,11,0,5,4,1,2,317
067630807,280,3,4,5,1,1,6,300
067630808,367,10,5,14,0,6,4,406
067630809,338,17,1,1,0,3,10,370
067630810,237,7,1,2,0,0,5,252
067630811,281,2,0,1,0,1,1,286
067630812,129,8,0,0,0,0,3,140
067630813,267,7,1,1,0,2,3,281
067630901,242,16,7,6,2,5,6,284
067630902,179,10,1,1,0,0,2,193
067630903,96,1,0,1,0,0,1,99
067630904,100,14,5,4,0,73,54,250
067631001,17,10,0,0,0,0,0,27
067631002,3,0,0,0,0,3,5,11
067631101,360,22,3,3,1,1,11,401
067631102,383,17,3,4,0,0,16,423
067631103,17,0,0,0,0,3,6,26
067631201,148,11,1,10,1,1,4,176
067631202,18,1,0,0,0,9,2,30
067631203,22,10,0,0,0,2,8,42
067631301,6,0,0,0,0,1,3,10
067631302,17,0,0,0,0,2,9,28
067631401,288,8,6,10,1,0,4,317
067631402,11,17,0,0,0,0,4,32
067631403,18,7,0,0,0,3,8,36
067631501,24,7,0,0,2,3,7,43
067631601,187,19,6,7,0,2,7,228
067631602,243,11,1,3,4,3,9,274
067631603,16,0,0,0,0,0,23,39
067631701,363,30,9,7,1,0,8,418
067631702,285,6,5,1,2,0,3,302
067631703,267,11,2,10,0,0,5,295
067631704,363,18,4,6,11,0,11,413
067631705,266,14,1,4,1,0,7,293
067631706,314,3,4,1,7,0,5,334
067631707,414,12,3,9,2,0,7,447
067631708,229,11,1,3,0,0,5,249
067631709,228,7,5,5,1,0,5,251
067631801,337,14,1,6,1,0,7,366
067631802,251,3,0,0,0,1,4,259
067631803,321,14,0,1,1,3,10,350
067631804,222,11,0,3,1,3,8,248
067631805,207,8,1,12,0,18,6,252
067631806,117,5,0,5,0,6,7,140
067631807,180,7,0,0,2,0,1,190
067631808,166,8,1,1,0,0,2,178
067631809,211,10,2,1,0,5,5,234
067631810,361,14,2,2,1,4,7,391
067631811,299,3,4,0,1,0,6,313
067631812,158,19,1,0,0,5,5,188
067631813,11,1,0,0,0,7,4,23
067631814,293,15,2,2,2,0,10,324
067631815,166,7,2,9,0,2,12,198
067631816,214,21,2,9,4,4,2,256
067631901,12,1,1,0,0,1,4,19
067631902,7,3,0,0,0,1,0,11
067631903,65,16,1,1,0,4,3,90
067631904,21,2,0,0,0,0,0,23
067631905,343,13,2,13,1,0,11,383
067631906,180,12,1,2,6,0,7,208
067631907,17,0,0,0,0,8,0,25
067631908,42,2,0,0,0,0,2,46
067631909,275,8,2,2,0,0,14,301
067631910,278,12,3,3,3,2,13,314
067631911,185,17,2,2,1,1,7,215
067632001,99,10,1,14,0,25,4,153
067632002,85,4,2,3,1,9,2,106
067632003,225,20,3,13,1,9,12,283
067632004,40,2,1,2,0,18,1,64
067632005,83,3,1,2,0,2,2,93
067632006,332,11,2,5,3,0,18,371
067632007,152,4,0,1,0,1,0,158
067632008,334,12,4,5,2,1,4,362
067632009,297,16,5,2,7,0,8,335
067632010,226,8,3,1,0,1,7,246
067632011,184,4,0,3,0,1,3,195
067632012,223,9,2,2,0,0,2,238
067632013,250,7,0,2,1,0,5,265
067632101,10,3,0,0,0,13,2,28
067700101,118,7,0,2,0,0,10,137
067700102,178,6,1,18,1,3,2,209
067700103,414,21,1,6,0,0,15,457
067700104,344,11,1,3,0,0,4,363
067700105,411,25,5,3,1,0,4,449
067700106,377,21,5,7,1,2,16,429
067700107,370,30,5,7,0,1,18,431
067700108,291,47,14,7,4,2,12,377
067700109,289,20,14,5,9,1,22,360
067700110,253,24,6,1,10,3,13,310
067700111,307,17,4,5,2,1,16,352
067700201,8,0,0,0,0,0,0,8
067700202,55,14,2,1,0,15,23,110
067700203,40,6,0,1,1,19,0,67
067700204,18,4,2,0,0,5,5,34
067700205,291,23,2,3,0,0,6,325
067700206,195,30,1,5,1,0,6,238
067700207,265,14,4,5,0,3,6,297
067700208,15,4,0,0,0,0,1,20
067700301,12,1,0,0,0,2,2,17
067700302,4,1,0,0,0,0,2,7
067700303,7,0,0,0,0,1,4,12
067700304,5,0,0,1,0,4,0,10
067700305,3,5,0,0,0,0,0,8
067700401,8,0,0,0,0,2,12,22
067700402,3,0,0,0,0,0,0,3
067700403,7,0,0,0,0,4,5,16
067700404,5,10,0,0,0,0,0,15
067700501,1,0,0,0,0,0,1,2
067700502,1,0,0,0,0,0,1,2
067700503,2,0,0,0,0,0,1,3
067700504,4,3,0,0,0,0,0,7
067700601,3,0,0,0,0,1,6,10
067700602,9,3,0,0,0,0,0,12
067700701,8,0,1,0,0,0,0,9
067700702,2,1,0,1,0,0,2,6
067700703,1,1,0,0,0,0,2,4
067700704,5,1,0,0,0,0,0,6
067700705,6,0,0,0,0,1,4,11
067700801,25,4,0,0,0,1,1,31
067700802,4,2,0,0,0,0,0,6
067700803,10,0,1,0,0,1,3,15
067700804,7,7,0,0,0,0,0,14
067700805,3,0,0,1,0,1,2,7
067700901,179,13,6,7,0,1,7,213
067700902,17,1,0,0,0,1,2,21
067700903,23,6,0,0,0,0,0,29
067700904,3,0,0,0,0,0,3,6
067700905,5,0,1,0,0,1,1,8
067700906,44,3,0,0,0,4,3,54
067700907,12,0,0,0,0,1,0,13
067700908,39,16,1,4,0,9,8,77
067701001,238,18,2,2,0,2,9,271
067701002,256,27,3,6,1,0,21,314
067701003,254,16,4,7,0,1,6,288
067701004,212,31,3,2,0,13,6,267
067701005,346,22,4,4,0,1,6,383
067701006,321,24,12,6,0,0,7,370
067701007,335,20,2,1,1,0,1,360
067701008,343,25,21,11,0,3,5,408
067701009,319,22,12,15,3,2,7,380
067701010,284,13,4,4,1,3,10,319
067701011,140,24,5,2,0,2,4,177
067701012,115,9,0,3,0,1,3,131
067701013,383,17,1,7,3,4,19,434
067701014,29,0,0,1,1,1,2,34
067701101,35,0,0,0,0,0,0,35
067701102,13,0,0,0,0,2,6,21
067701103,47,0,0,1,0,6,4,58
067701104,15,0,0,0,0,0,0,15
067701105,28,0,0,1,0,3,0,32
067701201,454,8,3,2,0,3,11,481
067701202,37,5,0,0,0,0,7,49
067701203,130,10,0,1,0,4,6,151
067701204,8,6,0,0,0,0,0,14
067701205,12,1,0,0,0,0,0,13
067701206,6,7,0,0,0,0,0,13
067701301,12,8,0,1,0,1,3,25
067701302,14,4,0,1,3,3,2,27
067701303,19,15,0,0,0,0,0,34
067701304,20,0,0,0,0,0,0,20
067701305,9,6,0,0,0,0,0,15
067701306,8,4,0,1,0,1,0,14
067701307,11,0,0,0,0,1,1,13
067701401,7,0,0,0,0,0,1,8
067701402,15,0,0,0,0,11,0,26
067701403,4,6,0,0,0,3,0,13
067701501,3,0,0,0,0,0,0,3
067701502,6,1,0,0,0,2,5,14
067701503,6,0,0,0,0,3,0,9
067701504,5,1,0,0,0,1,0,7
067701505,11,3,0,0,0,0,0,14
067701601,280,27,0,11,0,2,17,337
067701602,238,17,1,4,0,2,12,274
067701603,244,34,0,7,4,1,24,314
067701604,9,1,0,0,0,0,3,13
067701605,36,4,0,0,0,8,2,50
067701606,8,0,2,1,0,3,0,14
067701607,9,1,0,0,0,0,0,10
067701701,6,1,0,0,0,0,0,7
067701702,7,1,0,0,0,0,4,12
067701703,4,5,0,1,0,0,3,13
067701704,5,6,0,0,0,1,7,19
067701705,14,14,0,0,0,2,3,33
067701801,168,0,1,1,1,13,27,211
067701802,8,0,0,0,1,6,7,22
067701803,7,0,0,0,0,0,1,8
067701804,10,3,0,0,0,0,5,18
067701805,15,2,0,0,0,4,4,25
067701806,8,0,0,0,0,2,1,11
067701901,4,0,0,0,0,0,4,8
067701902,3,0,0,0,0,3,1,7
067701903,8,3,0,0,0,0,1,12
067701904,5,0,1,0,0,4,1,11
067702001,10,0,0,0,0,7,1,18
067702002,2,3,0,0,0,0,0,5
067702101,243,41,10,5,7,4,11,321
067702102,301,21,16,6,10,5,11,370
067702103,244,59,13,3,5,2,24,350
067702104,286,37,25,3,14,7,22,394
067702105,305,28,11,1,7,5,10,367
067702106,261,30,20,6,4,1,13,335
067702107,389,25,4,5,6,2,10,441
067702108,234,15,6,5,3,2,10,275
067702109,253,26,15,5,10,7,15,331
067702110,263,28,5,6,2,1,16,321
067702201,262,17,0,3,0,1,3,286
067702202,310,13,0,0,0,1,7,331
067702203,402,18,0,1,0,0,7,428
067702204,461,9,1,6,0,0,9,486
067702205,329,13,3,1,0,3,4,353
067702206,384,17,9,2,0,0,7,419
067702207,266,18,3,5,0,0,1,293
067702208,242,11,4,3,1,1,9,271
067702209,204,12,7,5,10,1,12,251
067702210,277,21,4,6,2,1,6,317
067702211,280,30,0,3,0,1,10,324
067702212,319,18,3,0,1,3,4,348
067702213,197,18,6,0,3,2,4,230
067702214,348,27,17,19,6,5,14,436
067702301,25,1,0,0,0,18,1,45
067780101,275,22,2,7,0,4,9,319
067780102,216,19,6,11,0,3,13,268
067780103,230,15,5,8,1,3,11,273
067780104,212,15,3,2,0,0,7,239
067780105,359,35,1,14,8,13,24,454
067780106,340,12,3,6,0,4,21,386
067780107,205,17,1,12,1,1,5,242
067780108,239,14,1,3,0,14,13,284
067780109,232,32,0,11,0,6,12,293
067780110,25,9,0,1,0,3,9,47
067780111,20,5,3,4,0,17,4,53
067780201,202,15,3,9,2,5,11,247
067780202,149,10,0,2,0,3,3,167
067780203,159,5,4,4,0,8,2,182
067780204,257,11,1,9,0,6,8,292
067780205,375,33,3,8,3,2,13,437
067780206,249,18,2,7,0,5,9,290
067780207,384,3,1,3,1,4,7,403
067780208,233,12,9,3,1,2,2,262
067780209,324,8,2,7,0,0,6,347
067780210,297,19,9,6,20,5,22,378
067780211,183,22,5,4,1,5,3,223
067780212,208,6,3,5,0,3,6,231
067780213,175,6,0,6,0,1,4,192
067780214,274,8,3,3,1,1,20,310
067780215,311,31,0,17,0,2,13,374
067780216,170,4,0,2,0,0,8,184
067780217,181,6,1,3,1,1,2,195
067780218,214,6,0,2,0,7,2,231
067780301,52,9,0,1,0,18,11,91
067780401,19,4,0,0,0,1,6,30
067780402,20,10,0,5,1,10,9,55
067780403,60,8,4,7,1,25,14,119
067780404,122,5,1,8,0,20,3,159
067780405,124,13,0,0,0,6,2,145
067780406,103,15,2,6,0,16,4,146
067780407,304,17,2,12,0,15,9,359
067780501,191,10,0,6,0,6,3,216
067780502,75,2,1,5,2,10,9,104
067780503,14,9,0,0,0,0,0,23
067780504,29,0,0,0,0,0,3,32
067780505,27,2,0,1,0,8,5,43
067780506,323,6,6,3,0,4,11,353
067780507,229,15,0,4,0,9,7,264
067780601,4,0,0,0,0,0,0,4
067780602,176,16,1,23,1,79,8,304
067780603,127,14,1,2,0,7,8,159
067780604,330,23,3,11,0,3,14,384
067780701,15,1,1,0,0,1,1,19
067780702,17,1,0,0,0,0,3,21
067780703,11,1,2,1,0,3,0,18
067780704,14,8,1,0,0,2,8,33
067780801,16,13,0,0,0,1,5,35
067780802,2,4,0,0,0,0,0,6
067780803,16,3,0,0,0,0,0,19
067780901,9,0,0,8,0,2,1,20
067780902,120,27,8,14,0,15,15,199
067780903,225,21,1,17,0,21,10,295
067780904,126,15,2,10,0,5,3,161
067780905,379,31,1,7,1,4,13,436
067780906,352,44,4,16,1,11,1,429
067780907,151,16,0,14,0,3,7,191
067780908,111,15,0,2,0,6,3,137
067780909,238,13,6,2,1,6,21,287
067780910,223,7,4,1,0,5,16,256
067780911,311,31,4,7,7,2,9,371
067780912,293,39,2,10,3,1,8,356
067780913,302,25,10,12,5,4,12,370
067781001,400,0,3,9,0,7,15,434
067781002,241,2,0,3,0,0,7,253
067781003,249,5,0,10,1,4,2,271
067781004,303,1,3,7,0,1,4,319
067781005,307,1,3,4,1,3,2,321
067781006,197,3,4,0,1,2,5,212
067781007,333,1,2,12,1,5,7,361
067781008,365,9,2,3,0,0,11,390
067781009,394,27,4,12,2,5,17,461
067781010,190,7,2,1,1,5,5,211
067781011,256,15,2,7,2,4,10,296
067781012,288,15,6,3,0,0,5,317
067781013,390,10,8,4,2,2,3,419
067781014,275,11,0,3,0,1,1,291
067781015,231,8,0,9,0,7,24,279
067840101,5,0,0,0,0,1,8,14
067840102,12,0,0,0,0,3,14,29
067840201,5,6,0,0,0,3,7,21
067840202,157,17,3,6,1,8,16,208
067840203,16,2,0,0,0,3,8,29
067840204,5,0,0,0,0,4,0,9
067840301,6,0,0,0,0,2,9,17
067840302,12,2,0,0,0,0,8,22
067840303,4,0,0,0,0,6,5,15
067840401,3,1,0,0,0,0,1,5
067840402,13,7,0,0,0,2,3,25
067840403,5,0,0,0,0,0,7,12
067840404,6,0,0,0,0,3,3,12
067840501,7,0,0,0,0,4,0,11
067840502,6,0,0,0,0,6,0,12
067840503,9,0,0,0,0,5,0,14
067840601,10,0,0,0,0,3,5,18
067840701,11,1,0,0,0,3,0,15
067840702,9,0,0,0,0,0,3,12
067840703,8,4,0,0,0,0,0,12
067840704,11,1,0,0,0,0,2,14
067840801,24,5,0,0,0,3,3,35
067840802,84,4,1,3,0,8,8,108
067840803,266,12,2,14,0,11,11,316
067840804,302,22,0,22,2,0,11,359
067840805,244,15,3,8,2,1,8,281
067840806,233,12,1,8,3,5,3,265
067840807,287,26,5,5,15,4,10,352
067840808,376,19,8,7,1,5,7,423
067840809,261,12,2,22,0,6,4,307
067840810,230,14,5,2,5,2,2,260
067840811,326,8,3,13,1,2,6,359
067840812,15,12,0,0,0,0,0,27
067840813,27,3,0,0,0,7,0,37
067840901,9,6,0,0,0,0,0,15
067840902,5,5,0,0,0,0,0,10
067841001,9,0,0,0,0,0,0,9
067841002,3,0,0,0,0,4,0,7
067841003,11,0,0,0,0,2,1,14
067841004,8,6,0,0,0,0,0,14
067841101,5,0,0,0,0,2,4,11
067841102,8,1,0,0,0,5,0,14
067841103,11,0,0,0,0,1,0,12
067841104,3,0,0,0,0,0,7,10
067841201,11,2,0,0,0,1,4,18
067841202,10,0,0,0,0,4,3,17
067841203,26,1,0,0,1,2,0,30
067841204,6,0,0,0,0,3,1,10
067910101,402,32,3,5,5,1,27,475
067910102,175,34,4,2,1,4,8,228
067910103,228,20,0,0,1,1,11,261
067910104,165,40,11,2,2,2,10,232
067910105,203,24,3,1,2,3,11,247
067910106,283,53,11,3,7,3,30,390
067910107,354,42,22,5,17,3,27,470
067910108,199,56,19,2,0,1,7,284
067910109,219,41,3,23,0,3,14,303
067910110,331,41,7,4,9,2,17,411
067910111,205,22,14,4,2,1,15,263
067910201,172,29,2,0,6,1,5,215
067910202,289,23,16,9,8,1,11,357
067910203,255,12,6,1,3,3,19,299
067910204,259,18,10,8,1,0,3,299
067910205,262,15,8,11,1,2,18,317
067910206,355,49,9,2,8,2,6,431
067910207,286,13,13,10,1,1,18,342
067910208,307,21,8,18,1,4,12,371
067910209,248,22,14,2,2,3,4,295
067910210,342,63,5,3,2,0,15,430
067910211,327,33,6,1,14,0,16,397
067910212,294,26,9,2,22,7,35,395
067910213,339,45,13,6,13,3,24,443
067910214,273,16,4,4,1,2,3,303
067910215,289,51,15,7,1,0,7,370
067910216,249,33,15,2,4,2,5,310
067910217,283,30,14,2,2,3,14,348
067910218,424,25,5,1,0,1,9,465
067910301,306,16,3,5,3,6,10,349
067910302,200,18,7,4,4,1,4,238
067910303,239,20,1,11,4,1,7,283
067910304,383,32,12,4,4,3,13,451
067910305,158,21,5,3,3,1,5,196
067910306,187,28,1,7,7,0,11,241
067910307,382,27,12,8,8,7,17,461
067910308,242,6,4,1,2,1,2,258
067910309,318,32,5,9,1,1,5,371
067910310,392,34,4,8,3,9,9,459
067910401,218,39,8,1,19,0,11,296
067910402,253,39,13,8,8,0,19,340
067910403,223,37,19,0,4,5,8,296
067910404,210,31,4,1,0,13,10,269
067910405,157,41,6,2,5,5,13,229
067910406,217,45,6,3,6,0,13,290
067910407,204,57,12,2,12,0,10,297
067910408,266,61,13,3,22,17,7,389
067910409,188,31,7,2,13,1,17,259
067910410,190,29,8,6,16,3,12,264
067910411,221,30,11,6,9,2,20,299
067910412,189,34,6,4,1,0,8,242
067910501,35,1,0,0,0,6,5,47
067910502,28,8,0,0,0,0,0,36
067910503,8,0,0,0,0,5,3,16
067910601,70,14,0,1,0,5,15,105
067910602,33,5,0,0,0,3,12,53
067910603,23,0,0,0,0,3,5,31
067910701,53,4,0,0,0,10,12,79
067910702,37,9,1,0,1,6,8,62
067910801,15,0,0,0,0,0,3,18
067910802,37,6,0,0,0,5,5,53
067910803,23,5,0,0,0,6,6,40
067910901,35,4,0,1,0,2,12,54
067910902,65,14,0,1,0,4,5,89
067910903,34,0,0,1,1,8,8,52
067910904,31,0,0,0,0,13,18,62
067910905,30,4,0,0,0,0,4,38
067910906,51,18,0,1,0,1,11,82
067911001,31,0,0,1,0,3,32,67
067911002,83,10,2,2,0,3,4,104
067911003,84,7,2,0,0,1,10,104
067911004,35,2,0,0,0,2,7,46
067911005,43,12,1,0,0,0,10,66
067911006,312,31,4,1,1,4,24,377
067911007,135,9,3,1,1,0,17,166
067911008,142,18,0,1,1,1,8,171
067911009,29,17,0,0,0,0,0,46
067911101,24,2,0,1,0,1,7,35
067911102,29,1,0,0,0,13,4,47
067911103,22,0,0,1,1,3,9,36
067911104,60,3,0,1,0,6,21,91
067911105,34,1,0,1,0,6,0,42
067911201,244,19,3,18,6,18,21,329
067911202,346,18,0,2,0,0,13,379
067911203,428,16,0,12,0,3,12,471
067911204,287,8,3,4,1,0,14,317
067911205,240,23,6,0,5,0,3,277
067911206,371,35,1,13,0,0,13,433
067911207,323,0,5,3,5,0,26,362
067911208,417,15,10,1,2,4,15,464
067911209,372,10,5,6,5,2,14,414
067911210,329,20,5,1,2,0,12,369
067911211,223,12,4,2,1,0,4,246
067911212,219,6,8,5,0,2,12,252
067911213,389,21,5,1,2,0,16,434
067911301,492,22,4,13,0,0,24,555
067911302,261,12,0,1,0,0,0,274
067911303,244,4,4,32,0,1,6,291
067911304,297,7,1,5,0,0,6,316
067911305,477,23,1,7,0,0,17,525
067911306,517,20,0,9,4,1,14,565
067911307,244,4,1,0,4,1,11,265
067911308,257,10,2,4,1,2,6,282
067911309,237,7,2,2,0,2,4,254
067911310,254,6,6,15,1,2,6,290
067911311,260,15,8,6,0,2,11,302
067911312,248,9,0,7,1,0,3,268
067911313,250,16,6,15,0,0,7,294
067911314,282,13,7,1,3,2,12,320
067911401,25,7,0,0,1,1,3,37
067911402,37,4,0,0,0,0,15,56
067911403,61,22,0,0,0,0,11,94
067911404,44,10,0,1,0,3,6,64
067911405,51,8,0,0,0,0,8,67
067911406,41,4,0,0,0,1,1,47
067911501,63,2,0,5,0,26,14,110
067911502,105,21,1,2,0,8,10,147
067911503,32,7,0,0,0,0,6,45
067911504,46,6,0,0,0,1,1,54
067911505,20,7,0,0,0,0,0,27
067911506,14,3,2,0,0,4,0,23
067911601,29,0,0,0,0,4,0,33
067911602,42,2,0,0,0,0,0,44
067911701,35,7,0,0,0,1,8,51
067911702,33,13,0,0,0,6,7,59
067911801,211,13,3,0,0,1,8,236
067911802,219,25,8,7,0,0,18,277
067911803,161,15,13,29,1,0,7,226
067911804,246,30,7,3,4,0,12,302
067911805,188,6,2,4,0,1,7,208
067911806,229,14,9,2,1,1,4,260
067911807,283,14,6,1,0,0,13,317
067911808,258,19,3,2,0,5,4,291
067911809,243,11,3,0,1,0,4,262
067911811,207,12,6,5,0,0,8,238
067911812,228,15,7,7,1,4,7,269
067911813,297,23,8,0,0,3,2,333
067911814,323,18,7,3,2,4,7,364
067911901,213,22,4,3,1,0,8,251
067911902,230,15,4,1,2,0,8,260
067911903,289,42,3,0,2,1,10,347
067911904,296,33,10,0,8,2,9,358
067911905,410,41,26,4,2,3,10,496
067911906,254,45,16,5,4,0,7,331
067911907,170,16,11,2,9,1,12,221
067911908,222,35,8,1,3,4,21,294
067911909,172,37,7,1,10,5,5,237
067911910,200,74,27,5,4,1,4,315
067911911,235,50,18,2,11,3,18,337
067912001,286,20,10,2,0,0,7,325
067912002,309,9,1,11,0,0,8,338
067912003,439,29,2,22,0,0,10,502
067912004,341,17,7,9,0,5,4,383
067912005,301,15,3,2,1,0,4,326
067912006,383,60,15,5,5,3,21,492
067912007,317,20,9,2,2,4,17,371
067912008,168,18,12,29,1,9,7,244
067912009,328,28,6,9,1,10,16,398
067912101,199,0,3,9,1,1,3,216
067912102,345,2,0,13,1,0,13,374
067912103,263,0,3,13,1,0,6,286
067912104,222,0,7,4,0,2,3,238
067912105,422,3,5,1,1,0,16,448
067912106,406,0,10,4,1,2,14,437
067912107,249,12,4,3,0,1,3,272
067912108,223,17,7,0,0,0,3,250
067912109,467,17,4,7,3,1,13,512
067912110,334,16,1,73,2,0,33,459
067912111,278,18,2,17,0,0,7,322
067912112,332,18,2,19,0,4,8,383
067912113,188,20,7,4,0,21,15,255
067912114,113,1,1,1,0,1,7,124
067912115,116,16,1,27,1,4,27,192
067912116,219,15,4,11,1,2,9,261
067912201,128,16,7,16,1,10,19,197
067912202,147,16,9,7,0,13,4,196
067912203,206,14,4,16,0,7,10,257
067912204,175,6,4,17,0,1,18,221
067912205,279,16,0,49,2,8,3,357
067912206,344,14,2,3,0,4,1,368
067912207,434,11,7,13,2,7,19,493
067912208,364,18,4,8,4,3,12,413
067912209,280,28,4,6,3,0,5,326
067912210,357,33,13,3,2,3,7,418
067912211,241,24,19,32,1,2,11,330
067912212,251,14,8,4,2,0,2,281
067912213,229,16,7,6,0,1,9,268
067912214,228,19,1,1,0,0,6,255
067912215,260,44,3,12,4,1,2,326
067912216,303,28,10,11,0,6,3,361
067912217,158,23,15,10,0,13,3,222
067912218,131,16,2,3,0,12,10,174
067980101,20,3,0,0,0,0,0,23
067980102,21,0,0,0,0,0,0,21
067980103,19,0,0,0,0,0,0,19
067980201,22,4,0,0,0,0,0,26
067980202,7,3,0,1,0,0,1,12
067980203,30,0,0,0,0,2,2,34
067980301,14,4,0,0,0,0,0,18
067980302,21,4,0,0,0,3,3,31
067980401,8,17,0,0,0,0,3,28
067980402,16,7,0,0,0,1,0,24
067980501,48,4,1,1,1,10,8,73
067980502,26,3,6,0,0,1,2,38
067980503,8,1,0,1,0,0,2,12
067980504,9,3,0,0,0,2,8,22
067980505,11,0,0,0,0,1,4,16
067980506,14,5,0,1,0,1,6,27
067980507,13,2,0,0,0,2,3,20
067980601,62,8,0,0,0,5,9,84
067980701,198,27,3,11,2,2,15,258
067980702,391,24,2,12,10,3,48,490
067980703,318,50,9,9,17,4,28,435
067980704,217,39,4,3,0,4,10,277
067980705,172,26,16,2,3,2,8,229
067980706,36,22,0,2,0,5,18,83
067980707,178,15,3,3,1,8,4,212
067980708,404,58,4,7,1,2,24,500
067980709,179,16,5,9,1,6,13,229
067980710,200,24,5,8,2,2,14,255
067980711,260,25,1,10,2,1,12,311
067980801,14,11,0,0,0,0,1,26
067980901,19,10,0,0,0,4,0,33
067980902,12,11,0,0,0,0,0,23
067980903,11,8,0,0,0,0,1,20
067980904,15,7,0,0,0,3,3,28
067980905,10,2,0,0,0,0,17,29
067981001,20,10,0,0,1,1,4,36
067981002,24,7,1,2,0,2,2,38
067981003,17,3,0,0,0,2,4,26
067981004,20,18,0,0,0,0,1,39
067981005,15,12,0,0,0,1,3,31
067981006,6,0,0,0,0,3,7,16
068120101,20,7,0,0,0,0,2,29
068120102,25,9,0,0,0,0,10,44
068120201,8,0,0,0,0,0,1,9
068120202,9,0,0,0,0,3,5,17
068120301,20,0,1,0,0,3,1,25
068120302,7,1,0,0,0,0,6,14
068120303,2,7,0,0,0,0,3,12
068120401,19,3,0,0,0,0,9,31
068120402,10,1,0,0,0,0,6,17
068120403,9,0,0,0,0,0,17,26
068120501,10,0,0,0,0,0,8,18
068120502,172,21,1,4,1,2,49,250
068120503,212,25,1,8,2,5,9,262
068120504,3,0,0,0,0,0,1,4
068120601,4,5,0,0,0,0,4,13
068120602,6,5,0,0,0,0,0,11
068190101,71,0,1,1,0,4,12,89
068190102,29,11,0,0,0,2,12,54
068190103,30,12,1,1,0,93,10,147
068190104,59,1,0,0,0,11,44,115
068190201,54,25,2,0,0,2,37,120
068190202,30,17,0,0,0,0,10,57
068190301,18,13,2,0,0,0,3,36
068190302,29,19,0,0,0,8,11,67
068190401,318,21,2,10,0,1,18,370
068190402,419,30,9,34,1,3,17,513
068190403,281,15,6,4,3,2,24,335
068190404,337,38,8,3,16,1,18,421
068190405,290,40,2,5,0,1,7,345
068190406,320,30,5,15,0,1,10,381
068190407,255,28,1,12,0,0,12,308
068190408,59,13,5,0,0,13,13,103
068190409,66,15,0,0,0,6,10,97
068190501,20,12,5,4,1,64,2,108
068190502,24,8,4,0,0,18,4,58
068190503,23,3,1,0,0,6,0,33
068190504,100,11,38,10,0,224,26,409
068190505,137,18,23,17,5,239,63,502
068190601,30,6,1,0,1,0,9,47
068190602,43,48,0,0,0,5,2,98
068190603,20,0,0,0,0,10,18,48
068190701,23,9,0,0,0,1,6,39
068190801,21,6,0,0,0,0,26,53
068190802,31,22,3,0,0,6,23,85
068190901,59,20,14,6,0,71,5,175
068190902,69,23,7,4,0,61,9,173
068190903,169,26,34,24,1,143,11,408
068190904,165,11,83,8,1,149,20,437
068190905,168,5,28,7,2,60,13,283
068190906,104,21,31,9,0,64,7,236
068190907,74,16,28,9,1,98,6,232
068190908,12,4,0,0,0,4,1,21
068190909,52,6,0,0,0,12,9,79
068190910,157,22,9,4,1,1,9,203
068190911,142,10,9,8,0,12,3,184
068190912,164,15,3,4,0,1,12,199
068260101,430,35,4,12,0,3,23,507
068260102,270,22,4,6,0,0,6,308
068260103,245,31,2,4,0,0,11,293
068260104,170,16,5,1,0,1,9,202
068260105,181,16,2,1,0,0,2,202
068260106,246,31,7,3,9,0,26,322
068260107,307,25,6,3,8,0,22,371
068260108,301,12,2,1,2,0,7,325
068260109,188,22,33,2,7,3,3,258
068260110,131,21,7,1,23,0,6,189
068260111,193,19,5,0,2,1,10,230
068260112,202,18,2,2,1,0,0,225
068260113,218,9,4,1,0,0,6,238
068260114,192,13,6,1,2,1,5,220
068260115,245,33,5,3,11,3,10,310
068260116,144,21,2,1,0,0,6,174
068260117,159,8,5,2,0,1,4,179
068260118,202,10,3,0,0,2,7,224
068260119,191,10,4,4,2,0,4,215
068260120,265,27,3,4,0,0,8,307
068260201,274,16,2,2,1,0,10,305
068260202,394,50,0,7,1,1,18,471
068260203,227,11,0,5,0,0,3,246
068260204,173,14,2,3,0,0,4,196
068260205,150,7,2,3,0,1,11,174
068260206,150,12,2,1,1,0,11,177
068260207,150,28,4,3,7,2,11,205
068260208,152,27,28,3,15,0,16,241
068260209,267,41,0,6,11,1,12,338
068260210,153,17,2,4,8,1,2,187
068260211,140,5,7,3,1,0,1,157
068260212,283,27,13,4,18,5,26,376
068260213,98,27,7,2,3,0,13,150
068260214,108,37,6,1,0,1,4,157
068260301,14,2,0,0,0,0,4,20
068260302,5,4,0,0,0,1,4,14
068260303,14,6,0,0,0,1,9,30
068260401,19,0,0,0,0,3,10,32
068260402,42,10,0,0,0,4,14,70
068260403,279,31,4,1,1,6,19,341
068260501,84,16,2,1,0,0,7,110
068260502,12,4,0,0,0,0,1,17
068260503,8,0,0,0,0,3,5,16
068260601,28,0,0,0,0,15,16,59
068260602,24,3,0,0,0,2,18,47
068260701,370,14,0,3,0,1,2,390
068260702,176,11,2,3,2,0,13,207
068260703,50,5,0,1,1,9,2,68
068260704,178,31,7,3,1,42,16,278
068260705,25,5,0,5,2,3,13,53
068260706,370,35,3,5,3,5,37,458
068260707,19,1,0,0,2,2,18,42
068260708,48,0,0,5,2,82,1,138
068260709,53,11,0,2,0,11,1,78
068260801,55,6,0,0,0,5,17,83
068260802,14,0,0,0,0,0,0,14
068260901,19,3,0,0,0,7,3,32
068260902,24,12,0,0,0,0,1,37
068261001,47,20,0,0,0,1,12,80
068261002,33,7,0,1,0,0,1,42
068261101,32,0,0,0,0,25,3,60
068261102,23,6,0,0,0,14,4,47
068261201,9,16,0,0,0,0,0,25
068261301,29,0,0,0,0,2,9,40
068261302,25,7,0,0,2,1,2,37
068261303,46,9,0,0,0,0,12,67
068261401,19,5,0,0,0,0,12,36
068261402,7,3,0,0,0,0,2,12
068261501,35,7,0,1,0,0,3,46
068261502,25,5,0,0,0,4,3,37
068261601,36,3,0,0,0,13,12,64
068261602,42,2,0,0,0,0,5,49
068261603,36,5,0,0,0,0,4,45
068261604,87,3,0,7,0,0,0,97
068261605,59,7,0,4,0,1,15,86
068261606,232,27,2,27,0,0,2,290
068261607,193,17,2,22,0,1,6,241
068261608,391,34,5,12,4,6,26,478
068261609,158,13,4,0,2,2,7,186
068261610,204,22,2,10,5,3,1,247
068261611,193,16,2,3,0,2,6,222
068261701,17,1,0,0,0,8,15,41
068261702,21,4,0,0,0,0,0,25
068261703,12,25,0,0,0,0,5,42
068261704,6,5,0,0,0,1,5,17
068261801,58,10,4,2,0,2,12,88
068261802,24,6,0,0,0,0,13,43
068261803,30,15,1,0,0,3,0,49
068261804,41,9,0,1,0,1,16,68
068261805,16,5,1,0,0,3,2,27
068261901,281,43,1,3,18,1,19,366
068261902,305,34,10,2,8,1,12,372
068261903,191,18,6,5,2,1,7,230
068261904,186,10,0,5,2,2,11,216
068261905,164,16,6,9,1,0,2,198
068261906,217,18,4,4,3,0,4,250
068261907,162,9,1,0,0,1,54,227
068261908,198,8,1,2,0,0,2,211
068261909,327,31,7,6,1,0,5,377
068261910,248,27,10,2,1,0,3,291
068261911,178,19,7,3,1,0,4,212
068330101,209,21,4,4,0,1,1,240
068330102,322,37,6,5,3,1,18,392
068330103,261,53,6,4,4,0,98,426
068330104,348,36,17,7,1,0,19,428
068330105,220,22,10,3,0,1,11,267
068330106,330,42,17,10,2,2,9,412
068330107,361,46,15,3,5,0,35,465
068330108,312,29,18,2,18,1,22,402
068330109,316,44,10,4,4,0,70,448
068330110,371,61,10,8,2,0,16,468
068330111,307,31,7,15,9,0,31,400
068330112,412,40,18,8,0,1,17,496
068330113,413,38,5,11,2,5,16,490
068330114,383,54,13,4,0,0,24,478
068330115,78,0,0,0,0,0,1,79
068330116,208,21,1,2,1,0,7,240
068330201,285,43,8,6,1,1,21,365
068330202,370,30,14,0,1,1,8,424
068330203,328,42,10,3,0,1,15,399
068330204,296,36,16,9,12,1,18,388
068330205,270,41,16,3,28,5,21,384
068330206,196,52,16,1,26,0,19,310
068330207,305,44,13,5,5,4,38,414
068330208,324,82,16,1,17,3,21,464
068330209,265,62,20,3,10,7,27,394
068330210,310,51,21,4,12,0,13,411
068330211,339,36,14,5,2,0,11,407
068330212,377,66,22,6,5,1,10,487
068330213,342,43,10,3,3,2,16,419
068330301,1,0,0,0,0,0,5,6
068330302,6,3,0,0,0,2,2,13
068330303,4,0,0,0,0,0,4,8
068330304,4,0,0,0,0,0,14,18
068330305,5,6,0,0,0,0,1,12
068330401,31,4,0,0,0,5,16,56
068330402,22,0,0,0,0,0,22,44
068330403,17,0,0,0,0,1,6,24
068330501,7,0,0,0,0,2,10,19
068330502,9,7,0,0,0,8,4,28
068330503,5,6,0,0,0,0,8,19
068330601,5,0,0,0,0,0,1,6
068330602,3,0,0,0,0,0,5,8
068330603,11,0,0,0,0,2,8,21
068330604,8,2,0,0,0,0,3,13
068330701,9,0,1,0,0,0,2,12
068330702,13,0,0,0,0,0,7,20
068330703,18,0,0,0,0,2,2,22
068330704,18,0,0,0,0,0,12,30
068330705,20,18,0,0,0,2,10,50
068330706,20,6,0,2,0,1,7,36
068330801,23,3,2,0,0,2,29,59
068330802,31,16,0,0,0,2,3,52
068330803,7,17,0,0,0,0,4,28
068330901,10,11,0,0,0,0,0,21
068330902,14,17,0,0,0,2,6,39
068330903,26,2,0,0,0,2,16,46
068331001,64,1,1,89,0,3,20,178
068331002,221,16,0,34,2,0,0,273
068331003,5,1,0,0,0,0,0,6
068331004,416,29,7,9,0,0,22,483
068331005,406,41,11,9,0,0,19,486
068331006,346,30,1,11,0,0,4,392
068331007,411,28,4,4,1,0,8,456
068331008,358,26,1,3,0,0,11,399
068331009,366,20,4,9,0,1,10,410
068331010,219,24,1,3,0,0,4,251
068331011,307,18,5,12,2,2,10,356
068331012,504,41,4,12,2,0,12,575
068331013,48,17,0,0,0,0,2,67
068331101,190,30,3,1,0,1,36,261
068331102,3,1,0,0,0,1,2,7
068331103,9,6,0,0,0,0,8,23
068331104,8,0,0,0,0,0,9,17
068331105,4,0,0,0,0,10,9,23
068331201,12,0,0,0,0,0,7,19
068331202,10,2,0,0,0,0,12,24
068331203,6,0,0,0,0,0,11,17
068331301,7,4,0,0,0,3,17,31
068331302,105,49,34,27,1,407,20,643
068331303,40,1,54,7,6,162,6,276
068331304,54,1,14,15,0,153,7,244
068331401,204,21,3,3,1,2,18,252
068331402,34,4,0,0,0,0,13,51
068331403,5,6,0,2,0,6,10,29
068331404,5,0,0,0,0,0,5,10
068331405,35,8,0,0,0,0,7,50
068331406,0,0,0,0,0,0,3,3
068331407,7,1,0,0,0,0,3,11
068331408,134,11,0,1,0,2,13,161
068331501,76,11,5,0,0,3,8,103
068331502,15,5,0,0,0,0,7,27
068331503,11,3,1,0,0,0,2,17
068331504,12,3,0,0,2,1,10,28
068331505,9,0,0,0,0,0,12,21
068331506,117,9,2,25,2,0,11,166
068331601,10,1,0,0,0,2,8,21
068331602,9,2,0,0,0,0,6,17
068331603,6,7,0,0,0,0,1,14
068331604,2,4,0,0,0,0,2,8
068331605,19,3,0,0,0,0,11,33
068331701,138,13,2,0,0,0,10,163
068331702,205,23,2,10,0,0,12,252
068331703,181,17,1,2,0,5,8,214
068331704,31,5,48,16,3,175,9,287
068331705,79,22,0,0,0,0,4,105
068331706,12,5,0,0,0,1,16,34
068331707,12,4,0,0,0,0,15,31
068331708,16,10,0,0,0,0,0,26
068331709,185,12,8,3,0,2,11,221
068331801,66,51,15,22,1,202,13,370
068331802,160,55,21,19,2,306,42,605
068331803,103,58,8,7,0,268,18,462
068331804,66,14,30,10,3,312,10,445
068331805,93,22,47,13,4,265,9,453
068331806,50,3,21,4,4,318,5,405
068331807,77,49,71,15,3,184,34,433
068331808,26,16,0,0,0,2,17,61
068331809,99,13,5,47,0,53,20,237
068331810,11,1,0,0,0,9,16,37
068331811,58,5,14,3,1,49,276,406
068331901,252,23,0,2,1,2,18,298
068331902,73,3,2,4,0,13,21,116
068331903,332,32,2,32,1,0,6,405
068331904,251,22,4,2,0,1,44,324
068331905,438,31,5,13,1,0,22,510
068331906,305,19,13,14,1,0,4,356
068331907,294,19,2,5,0,1,10,331
068331908,283,20,3,49,2,2,9,368
068331909,293,18,2,7,3,1,10,334
068331910,229,12,0,5,0,2,3,251
068331911,235,19,2,9,1,0,9,275
068331912,211,19,2,4,0,0,4,240
068331913,364,29,2,12,1,1,89,498
068331914,107,7,1,1,0,0,0,116
068331915,49,6,0,0,1,2,9,67
068470101,156,6,6,3,0,5,15,191
068470102,346,10,3,7,1,4,9,380
068470103,312,7,2,3,1,0,24,349
068470104,376,17,6,1,13,0,19,432
068470105,269,25,11,6,3,2,9,325
068470106,11,0,0,1,0,6,2,20
068470107,48,36,1,0,0,1,8,94
068470108,3,0,0,0,0,2,18,23
068470109,10,0,0,0,0,2,16,28
068470110,23,2,0,0,0,13,19,57
068470111,350,8,4,2,0,2,7,373
068470112,177,16,0,4,1,2,6,206
068470113,191,4,1,1,1,0,7,205
068470114,285,13,1,2,0,2,4,307
068470115,161,10,1,1,0,1,1,175
068470201,56,3,0,0,0,0,26,85
068470202,7,6,0,0,0,5,17,35
068470203,25,7,0,0,0,1,10,43
068470204,30,20,0,0,0,0,12,62
068470205,9,3,0,0,0,9,15,36
068540101,173,20,7,3,0,9,9,221
068540102,289,34,13,1,4,2,13,356
068540103,297,26,2,2,0,0,4,331
068540104,256,20,4,5,0,4,17,306
068540105,304,26,7,4,0,2,13,356
068540106,252,29,9,4,8,2,19,323
068540107,267,58,8,6,9,1,9,358
068540108,291,27,7,3,6,5,12,351
068540109,356,24,10,8,2,4,14,418
068540110,386,17,4,10,4,7,32,460
068540111,455,32,3,33,0,8,20,551
068540112,282,23,4,6,9,3,13,340
068540113,347,15,1,3,0,3,11,380
068540114,201,12,0,5,1,4,4,227
068540115,160,4,3,5,1,8,12,193
068540201,380,23,5,17,4,7,18,454
068540202,443,30,6,7,1,11,18,516
068540203,327,36,7,7,3,4,16,400
068540204,280,35,5,3,3,8,14,348
068540205,241,33,2,0,13,3,14,306
068540206,302,32,5,4,4,3,37,387
068540207,336,33,4,15,0,2,16,406
068540208,273,19,10,4,1,1,21,329
068540209,410,31,10,18,10,3,17,499
068540210,195,26,1,2,0,4,6,234
068540211,236,15,0,2,0,6,7,266
068540301,90,2,2,2,0,2,11,109
068540302,28,0,0,0,0,10,19,57
068540303,30,0,1,0,0,10,19,60
068540401,186,13,1,3,0,8,11,222
068540402,90,21,0,0,0,1,17,129
068540403,81,30,0,3,0,19,10,143
068540501,43,12,0,0,0,23,4,82
068540502,54,32,0,0,0,7,2,95
068540503,18,22,0,0,0,0,7,47
068540601,64,1,0,5,0,13,33,116
068540602,151,52,5,13,3,139,26,389
068540701,26,3,0,0,0,11,2,42
068540702,31,15,0,0,0,22,3,71
068540801,102,15,2,4,1,4,24,152
068540802,79,8,0,3,0,3,24,117
068540803,31,17,0,0,1,7,13,69
068540901,47,5,0,0,0,17,14,83
068541001,168,18,1,5,0,2,4,198
068541002,241,25,11,5,0,4,9,295
068541003,280,28,4,8,0,6,19,345
068541004,312,14,2,14,1,11,15,369
068541005,266,26,3,2,0,2,22,321
068541006,309,41,8,19,1,4,24,406
068541007,100,3,1,4,0,7,7,122
068541008,111,9,1,5,1,9,17,153
068541009,62,9,0,3,1,17,10,102
068541010,50,1,0,1,0,23,12,87
068541011,46,15,0,1,0,4,15,81
068541012,36,9,0,0,0,2,19,66
068541013,83,14,0,0,0,5,38,140
068541014,175,17,1,7,0,5,2,207
068541015,124,11,0,2,2,1,14,154
068541101,31,7,0,0,0,8,5,51
068541102,26,6,0,0,0,18,15,65
068541103,23,12,0,0,0,3,8,46
068541201,51,25,0,1,0,7,10,94
068541202,20,2,1,2,0,0,1,26
068541203,29,26,0,2,0,0,15,72
068541301,49,15,0,0,0,4,4,72
068541302,38,18,1,0,0,8,32,97
068541401,155,24,3,4,1,3,13,203
068541402,98,21,0,0,0,3,20,142
068541403,62,16,0,1,0,28,20,127
068541404,13,1,0,0,0,0,8,22
068541405,29,3,0,0,0,4,11,47
068541406,152,10,5,1,1,5,13,187
068680101,468,12,4,4,1,4,10,503
068680102,230,16,0,23,0,4,2,275
068680103,207,18,4,18,0,0,3,250
068680104,200,50,5,4,0,52,4,315
068680105,100,41,22,2,0,85,7,257
068680106,73,10,15,2,0,80,59,239
068680107,60,27,30,0,0,57,0,174
068680108,199,60,38,7,1,84,7,396
068680109,277,24,16,2,6,9,6,340
068680110,258,16,17,3,2,13,5,314
068680201,168,40,16,1,3,51,9,288
068680202,49,51,105,0,0,280,10,495
068680203,77,7,79,3,0,207,7,380
068680204,166,43,20,6,2,34,14,285
068680205,340,58,26,1,1,40,26,492
068680206,209,57,59,9,1,98,54,487
068680207,73,106,33,0,3,103,14,332
068680208,9,4,17,0,2,83,0,115
068680209,24,38,77,0,3,228,29,399
068680210,71,108,86,3,1,177,4,450
068680211,34,8,5,3,0,230,29,309
068680212,80,7,5,3,0,68,7,170
068680213,446,25,17,14,0,17,22,541
068680301,403,23,12,6,1,3,13,461
068680302,259,22,9,6,2,13,26,337
068680303,193,40,7,1,1,12,21,275
068680304,176,12,21,1,8,44,18,280
068680305,109,17,17,2,0,46,19,210
068680306,201,59,48,4,0,140,17,469
068680307,168,45,114,1,1,150,32,511
068680308,43,2,53,0,3,257,7,365
068680309,36,20,39,0,1,306,46,448
068680310,44,5,51,4,0,161,13,278
068680311,32,22,57,1,0,182,67,361
068680312,38,8,70,6,0,228,0,350
068680313,37,50,38,1,0,213,11,350
068680401,28,1,10,1,0,282,3,325
068680402,23,23,0,1,1,166,4,218
068680403,19,38,65,1,0,148,3,274
068680404,5,2,59,4,0,129,2,201
068680405,32,46,26,3,0,236,7,350
068680406,9,17,26,0,1,54,2,109
068680407,56,9,57,2,2,250,18,394
068680408,80,1,73,26,0,194,3,377
068680409,28,0,50,2,0,393,7,480
068680410,28,29,51,4,0,30,16,158
068680501,13,0,0,0,0,0,1,14
068680502,338,19,9,11,0,5,11,393
068680503,356,44,2,5,0,4,3,414
068680504,192,7,86,24,4,289,14,616
068680505,60,4,38,20,3,300,31,456
068680506,63,7,53,16,0,402,19,560
068680507,94,36,33,17,4,381,25,590
068680508,148,17,34,48,0,235,2,484
068680509,117,36,137,36,0,133,69,528
068680510,71,6,109,31,8,274,13,512
068680511,2,1,0,0,0,0,0,3
068680601,29,43,102,6,2,238,10,430
068680602,37,26,41,2,0,119,23,248
068680603,75,8,76,5,0,316,31,511
068680604,90,38,34,0,2,210,41,415
068680605,33,3,8,6,1,34,1,86
068680606,19,4,48,0,0,199,25,295
068680607,39,57,3,0,1,199,45,344
068680608,27,25,100,5,0,163,1,321
068680609,76,62,84,0,1,159,2,384
068680610,24,2,117,0,0,155,9,307
068680701,262,21,2,3,1,7,10,306
068680702,241,74,53,4,2,73,32,479
068680703,119,10,59,3,0,83,22,296
068680704,88,22,38,2,5,272,7,434
068680705,67,98,41,0,0,75,9,290
068680706,105,5,38,3,1,176,13,341
068680707,32,1,50,0,2,222,9,316
068680708,46,6,121,1,4,208,16,402
068680709,23,45,100,2,2,190,24,386
068680710,21,1,41,0,0,353,7,423
068680711,48,11,142,0,0,188,32,421
068680712,47,1,0,0,0,0,0,48
068680801,289,77,14,0,0,39,36,455
068680802,216,22,6,4,0,9,4,261
068680803,114,13,2,6,0,30,4,169
068680804,167,38,84,4,0,163,21,477
068680805,24,16,106,0,0,118,47,311
068680806,38,7,140,0,0,217,7,409
068680807,24,1,2,0,1,172,45,245
068680808,25,2,26,0,0,163,23,239
068680809,162,112,151,13,0,71,30,539
068680810,45,43,47,1,0,110,2,248
068750101,9,0,0,0,0,0,15,24
068750201,45,90,3,1,1,9,20,169
068750301,58,5,0,1,0,3,49,116
068750401,46,3,1,1,0,2,11,64
068750402,36,13,0,0,0,5,41,95
068750403,49,2,0,1,2,11,21,86
068750501,11,7,0,0,0,1,0,19
068750502,47,25,0,0,0,10,1,83
068750601,256,26,6,17,3,1,13,322
068750602,187,8,2,3,0,0,7,207
068750603,112,6,1,6,0,1,6,132
068750604,411,44,7,7,3,1,18,491
068750605,266,16,2,53,1,0,9,347
068750606,98,5,0,1,0,3,15,122
068750607,24,4,0,0,0,0,6,34
068750608,319,31,6,6,1,0,5,368
068750609,174,4,5,2,3,1,25,214
068750701,37,6,0,0,0,36,12,91
068750801,66,13,0,0,0,3,101,183
068750802,157,15,1,1,0,12,22,208
068750803,137,30,2,2,0,1,2,174
068750804,166,13,0,31,0,3,5,218
068750805,137,28,1,2,2,0,12,182
068750901,78,8,0,1,2,1,10,100
068750902,47,26,1,0,0,1,32,107
068751001,27,15,0,0,0,0,28,70
068751101,12,5,0,0,0,10,2,29
068751201,120,31,3,0,0,7,21,182
068751301,18,8,0,0,0,3,3,32
068751302,68,37,0,0,0,3,14,122
068751401,53,6,0,1,1,1,38,100
068751402,46,11,4,0,0,11,30,102
068751501,238,32,5,7,0,1,5,288
068751502,111,9,1,4,2,2,6,135
068751503,96,17,2,0,1,1,1,118
068751504,149,12,4,1,0,2,5,173
068751505,38,14,0,0,0,3,1,56
068751506,349,39,2,13,0,3,13,419
068751507,289,24,2,5,0,0,7,327
068751508,283,21,3,3,3,1,10,324
068751509,183,19,2,3,0,0,6,213
068751601,138,57,0,5,0,0,0,200
068751602,429,40,11,4,1,1,26,512
068751603,516,23,9,9,2,4,9,572
068751604,268,50,14,41,2,9,31,415
068751605,356,54,27,20,1,82,44,584
068751606,280,17,8,8,0,1,5,319
068751607,229,30,2,5,3,0,2,271
068751608,246,18,2,2,5,0,3,276
068751609,193,25,8,3,0,2,2,233
068751610,383,20,3,6,0,0,7,419
068751611,191,16,8,0,4,3,5,227
068751612,200,21,3,3,1,0,7,235
068751613,270,14,9,15,0,0,18,326
068751614,291,9,6,3,1,0,4,314
068751615,342,21,1,8,1,1,15,389
068751701,144,36,0,0,0,4,9,193
068751801,24,5,0,0,1,25,15,70
068820101,329,14,3,1,7,0,8,362
068820102,344,11,5,1,3,2,5,371
068820103,373,16,5,7,2,2,10,415
068820104,390,13,6,2,0,1,4,416
068820105,374,16,3,5,0,0,5,403
068820106,315,16,2,6,2,0,9,350
068820107,311,25,2,2,0,0,8,348
068820108,303,13,14,4,6,0,15,355
068820109,275,16,5,3,2,0,18,319
068820110,318,13,6,3,0,0,8,348
068820201,394,44,9,8,16,0,13,484
068820202,250,25,8,5,6,0,10,304
068820203,218,31,12,4,20,0,23,308
068820204,253,50,18,2,5,0,32,360
068820205,296,54,8,6,34,0,15,413
068820206,255,31,21,5,7,1,25,345
068820207,298,34,10,3,12,0,8,365
068820208,320,36,4,4,4,0,7,375
068820209,296,25,1,3,10,2,34,371
068820210,243,31,5,1,3,0,3,286
068820211,368,24,16,6,1,1,9,425
068820212,215,7,1,1,0,0,2,226
068820213,296,23,4,5,5,1,11,345
068820214,196,7,2,1,0,0,5,211
068820301,56,11,0,0,0,3,0,70
068820302,307,17,3,3,2,0,5,337
068820303,358,22,9,2,3,0,19,413
068820304,358,18,6,3,1,0,14,400
068820305,277,26,6,1,8,1,11,330
068820306,301,21,3,2,1,1,19,348
068820307,240,1,5,10,0,1,4,261
068820308,366,0,4,6,0,0,10,386
068820401,346,16,0,3,0,0,7,372
068820402,27,0,0,6,0,113,6,152
068820403,65,3,0,2,0,12,14,96
068820501,107,0,2,1,0,0,1,111
068820502,444,5,1,12,7,1,14,484
068820503,414,3,3,4,1,2,8,435
068820504,415,18,2,10,1,0,11,457
068820505,37,6,0,0,0,0,0,43
068820506,45,4,0,1,0,0,3,53
068820507,159,16,6,1,5,1,5,193
068820508,325,17,2,4,0,5,11,364
068820509,415,27,9,13,5,4,21,494
068820601,54,3,0,0,0,108,4,169
068820701,58,0,0,0,0,0,2,60
068820702,141,8,4,3,0,10,7,173
068820703,175,10,0,0,0,0,3,188
068820801,404,20,2,4,1,0,9,440
068820802,305,11,11,3,1,0,5,336
068820803,328,15,1,2,1,0,23,370
068820804,323,24,3,0,2,0,7,359
068820805,306,17,11,1,1,0,4,340
068820806,326,17,5,2,9,5,18,382
068820807,287,17,8,5,6,1,3,327
068820808,302,14,26,4,26,1,25,398
068820809,277,33,2,2,18,1,37,370
068820810,278,42,12,3,14,0,11,360
068820811,228,32,7,4,9,0,7,287
068820812,313,61,37,2,32,6,14,465
068820813,387,13,0,3,0,0,4,407
068820901,427,11,1,3,0,1,8,451
068820902,306,9,1,14,0,1,4,335
068820903,342,13,0,10,0,0,11,376
068820904,353,4,7,1,0,0,2,367
068820905,226,10,3,4,0,0,1,244
068820906,433,19,1,6,0,0,7,466
068820907,388,24,2,13,1,0,13,441
068820908,288,13,4,5,0,0,6,316
068820909,257,8,3,2,0,0,4,274
068820910,389,25,2,2,0,0,5,423
068820911,243,21,2,8,0,1,15,290
068820912,309,18,1,9,0,1,8,346
068820913,273,16,0,9,0,0,4,302
068820914,284,5,1,6,0,0,1,297
068821001,269,25,5,7,1,0,6,313
068821002,222,27,5,9,0,0,10,273
068821003,292,17,1,0,0,0,7,317
068821004,222,11,3,1,0,0,3,240
068821005,229,10,0,1,0,1,4,245
068821006,390,13,4,14,1,0,11,433
068821007,203,17,3,1,2,0,6,232
068821008,261,5,3,0,1,0,1,271
068821009,380,17,6,3,0,0,14,420
068821010,457,13,0,13,0,0,8,491
068821011,382,12,5,2,0,0,5,406
068821101,223,0,2,7,0,42,28,302
068821201,133,1,4,6,4,39,29,216
068821301,176,2,0,1,0,12,2,193
068821401,155,5,2,1,1,20,11,195
068821501,39,1,0,2,0,28,6,76
068821601,302,25,7,3,1,3,9,350
068821602,342,17,2,1,5,0,9,376
068821603,437,24,4,0,3,0,12,480
068821604,328,12,0,5,0,0,2,347
068821605,424,14,0,1,0,0,5,444
068821606,237,11,3,4,0,0,3,258
068821607,285,5,0,1,2,1,8,302
068821608,344,11,0,3,0,0,8,366
068821701,326,12,1,9,0,0,3,351
068821702,259,13,4,6,1,0,2,285
068821703,367,25,2,22,0,1,12,429
068821704,460,8,0,11,0,0,4,483
068821705,467,17,0,5,0,0,6,495
068821706,92,2,0,4,0,22,19,139
068821707,172,39,2,4,0,25,25,267
068821708,160,4,2,8,0,86,27,287
068821709,66,7,0,0,0,1,3,77
068821710,314,33,3,14,1,1,14,380
068821711,297,14,1,4,1,0,5,322
068821801,56,2,0,0,1,107,5,171
068821802,18,1,0,0,0,0,7,26
068821803,27,3,0,0,0,36,20,86
100070101,15,0,0,0,0,29,8,52
100070102,50,15,0,3,0,28,22,118
100070103,26,5,0,1,2,9,1,44
100070104,91,31,1,5,0,120,4,252
100070105,118,37,0,7,3,102,9,276
100070201,158,49,0,5,2,4,12,230
100070202,81,2,0,23,2,19,11,138
100070203,32,7,1,0,0,3,1,44
100070204,84,26,0,8,1,16,9,144
100070301,110,14,2,2,1,21,16,166
100070302,30,7,0,0,1,1,3,42
100070401,23,0,0,0,0,17,2,42
100070402,31,20,0,1,0,5,14,71
100070403,3,0,0,0,0,2,2,7
100070404,106,79,2,9,2,107,7,312
100070405,13,4,0,2,0,40,3,62
100070406,76,34,1,13,0,100,35,259
100070407,76,2,0,2,0,156,6,242
100070408,78,32,0,4,3,187,6,310
100070409,49,2,0,4,0,224,3,282
100140101,93,7,0,3,0,5,13,121
100140102,23,0,0,0,0,2,4,29
100140103,24,3,0,0,0,1,3,31
100140104,19,1,0,0,0,0,1,21
100140201,90,13,1,8,0,43,8,163
100140202,30,7,0,0,0,0,7,44
100140301,34,7,0,0,0,0,12,53
100140302,10,1,0,0,0,0,1,12
100140303,9,1,0,0,0,0,0,10
100140401,27,15,0,0,0,13,1,56
100140402,24,1,0,1,0,3,1,30
100140501,24,17,0,0,0,3,0,44
100140502,38,1,0,0,0,0,0,39
100140503,45,10,0,1,0,8,2,66
100140601,28,7,0,0,0,3,2,40
100140602,25,1,0,0,0,1,0,27
100140701,57,19,0,0,0,4,9,89
100140702,19,3,0,0,0,0,0,22
100140801,31,5,0,0,0,0,2,38
100140802,31,5,0,0,0,4,4,44
100140803,28,6,0,0,0,0,0,34
100140901,17,2,0,1,0,1,8,29
100140902,30,1,0,0,0,0,2,33
100210101,88,19,0,1,1,1,9,119
100210102,4,6,0,0,0,0,0,10
100210103,400,33,4,5,0,1,14,457
100210104,304,22,2,15,1,13,13,370
100210105,301,41,4,3,2,9,5,365
100210106,239,23,5,0,3,3,10,283
100210107,303,16,5,4,1,3,9,341
100210108,232,24,3,10,1,4,15,289
100210109,238,12,5,5,1,3,8,272
100210110,311,29,1,1,0,1,9,352
100210111,314,29,5,8,2,5,22,385
100210112,230,14,6,11,1,3,10,275
100210113,214,26,0,2,1,3,6,252
100210114,90,7,0,87,0,0,0,184
100210201,6,2,0,0,2,1,6,17
100210202,260,29,0,0,3,8,11,311
100210301,71,19,0,3,0,10,18,121
100210401,102,11,0,1,2,2,34,152
100210501,20,3,0,0,0,1,15,39
100210601,16,4,0,0,0,10,1,31
100210701,48,5,0,0,0,1,2,56
100210801,51,21,0,0,1,6,15,94
100210901,24,7,0,0,0,1,3,35
100210902,50,9,0,0,0,6,5,70
100211001,145,34,0,0,1,38,18,236
100211002,72,38,0,4,0,9,12,135
100211003,88,15,1,3,2,72,18,199
100211004,86,3,1,0,1,117,8,216
100211005,97,10,0,2,1,114,27,251
100211006,65,10,0,7,1,202,1,286
100280101,74,16,1,15,0,18,21,145
100280201,49,63,0,0,0,1,3,116
100280202,191,83,3,14,5,10,65,371
100280301,18,8,0,0,0,12,6,44
100280302,24,31,0,1,0,1,3,60
100350101,265,25,0,7,1,13,25,336
100350102,20,3,0,1,0,1,10,35
100350103,241,34,1,4,0,2,59,341
100350104,196,26,0,6,7,4,8,247
100350105,320,16,2,8,2,6,9,363
100350106,300,56,8,26,6,2,9,407
100350107,187,34,0,7,0,1,3,232
100350108,241,17,1,6,0,0,7,272
100350109,211,28,0,4,1,2,11,257
100350110,191,22,2,6,3,1,4,229
100350111,195,19,1,18,0,2,18,253
100350112,308,20,4,8,2,5,6,353
100350113,252,40,0,6,1,0,7,306
100350114,198,9,0,2,0,2,8,219
100350115,225,20,1,6,0,1,3,256
100350201,81,17,0,2,0,0,9,109
100350202,27,0,0,0,0,2,5,34
100350203,27,5,0,0,0,0,0,32
100350204,298,33,0,10,3,7,24,375
100350205,170,9,3,4,8,9,20,223
100350206,170,4,3,8,0,11,26,222
100350301,65,0,0,3,0,1,18,87
100350302,26,13,0,0,0,2,11,52
100350303,74,20,0,0,0,7,1,102
100350304,49,16,0,1,0,4,11,81
100350305,57,1,0,0,0,0,0,58
100350306,159,28,3,5,0,11,5,211
100350307,81,33,0,0,0,0,2,116
100350401,104,19,0,10,1,1,11,146
100350402,42,3,0,0,1,1,4,51
100350501,116,15,0,2,0,2,21,156
100350502,137,21,4,10,1,2,13,188
100350503,175,29,1,6,2,5,20,238
100350504,13,3,0,0,0,2,5,23
100350505,42,4,0,0,0,0,0,46
100350506,58,18,0,3,0,0,2,81
100350507,13,5,0,0,0,0,5,23
100350508,194,35,1,16,3,12,24,285
100350601,58,14,0,0,1,0,29,102
100350602,47,13,0,0,0,0,0,60
100350603,58,9,2,7,1,2,25,104
100350604,49,10,0,5,0,1,13,78
100350605,99,33,0,4,0,2,26,164
100350606,107,22,2,8,0,1,9,149
100350607,110,12,0,0,0,0,11,133
100350608,232,32,4,6,0,9,24,307
100420101,25,6,0,0,0,8,5,44
100420102,57,0,0,0,0,10,4,71
100420103,172,5,3,2,0,2,25,209
100420104,192,17,0,0,0,0,9,218
100420105,222,18,4,7,0,1,25,277
100420106,246,20,7,2,1,3,32,311
100420107,233,13,1,6,4,13,12,282
100420201,44,16,0,4,1,7,1,73
100420202,159,12,2,1,1,10,21,206
100420203,15,11,0,0,0,0,0,26
100420204,70,5,0,0,0,5,4,84
100420205,78,7,0,2,0,1,5,93
100420206,215,14,1,42,2,14,23,311
100420207,346,28,1,5,1,2,17,400
100420301,169,22,0,6,1,7,22,227
100420302,186,22,2,2,0,8,6,226
100420303,303,24,4,49,6,17,23,426
100420304,49,0,0,2,0,1,15,67
100420305,213,15,2,11,1,4,13,259
100420306,231,35,1,31,0,11,6,315
100420307,28,3,0,1,0,1,0,33
100420401,99,17,0,3,1,30,20,170
100420402,108,9,0,16,1,71,13,218
100420501,20,18,0,0,0,13,11,62
100420502,85,40,0,0,0,28,8,161
100420601,12,0,0,0,0,0,14,26
100420602,114,21,1,2,0,5,17,160
100420603,37,6,0,0,0,0,5,48
100420604,51,14,0,0,0,0,4,69
100490101,61,0,0,6,4,0,3,74
100490102,358,5,2,20,1,7,26,419
100490103,295,2,0,3,0,3,2,305
100490104,168,2,0,71,0,0,1,242
100490105,286,0,0,45,0,0,11,342
100490106,270,11,0,0,0,0,10,291
100490107,215,11,0,2,0,0,3,231
100490108,234,5,0,0,0,0,6,245
100490109,191,8,0,5,0,0,8,212
100490110,381,25,2,16,1,0,12,437
100490111,457,45,0,103,1,1,26,633
100490112,347,20,0,4,1,0,10,382
100490113,375,19,2,0,0,2,6,404
100490114,345,20,0,2,0,0,8,375
100490115,295,26,0,2,0,0,0,323
100490201,241,21,3,7,2,2,9,285
100490202,247,17,0,5,3,0,3,275
100490203,294,8,0,5,1,4,7,319
100490204,244,13,0,9,1,0,7,274
100490205,247,25,9,35,0,0,4,320
100490206,195,28,4,9,1,5,0,242
100490207,373,47,3,7,2,0,4,436
100490208,345,10,3,5,1,2,31,397
100490209,276,14,1,3,2,0,3,299
100490210,207,27,5,6,0,0,9,254
100490211,183,21,2,24,1,0,2,233
100490212,205,6,0,0,0,0,0,211
100490213,180,10,1,1,0,1,1,194
100490214,214,17,0,0,0,0,4,235
100490215,202,15,0,0,0,2,8,227
100490216,362,22,9,21,6,1,12,433
100490217,248,19,1,4,12,3,13,300
100490218,214,12,12,7,0,1,10,256
100490219,253,18,4,18,4,4,5,306
100490220,141,9,4,44,1,1,11,211
100490221,179,19,20,7,0,0,0,225
100490301,352,14,1,1,0,0,7,375
100490302,257,11,0,0,1,0,3,272
100490303,291,24,1,14,1,1,1,333
100490304,241,18,7,18,3,1,3,291
100490305,220,13,0,7,0,1,13,254
100490306,195,17,3,10,2,0,9,236
100490307,216,2,1,2,0,0,6,227
100490308,302,6,1,4,0,0,3,316
100490309,388,14,1,7,0,0,20,430
100490310,168,14,5,1,1,1,2,192
100490311,327,35,3,8,1,0,5,379
100490312,203,22,2,0,2,0,8,237
100490313,179,14,4,5,0,0,1,203
100490314,245,23,2,3,1,0,10,284
100490315,239,16,6,2,20,0,5,288
100490316,171,9,20,1,11,0,25,237
100490317,343,41,10,6,25,0,24,449
100490318,172,29,6,4,24,2,13,250
100490319,277,39,13,3,25,1,18,376
100490320,305,43,11,2,18,1,20,400
100490321,168,34,6,3,22,1,23,257
100490322,134,33,6,0,9,1,14,197
100490323,171,14,7,0,37,1,6,236
100490324,197,28,3,3,13,0,21,265
100490401,205,12,0,0,0,0,3,220
100490402,199,6,0,0,0,0,14,219
100490403,240,5,0,5,0,3,7,260
100490404,338,19,1,5,1,0,4,368
100490405,246,11,0,0,1,0,5,263
100490406,291,23,0,3,0,0,6,323
100490407,347,11,4,5,0,2,1,370
100490408,183,11,2,1,0,0,2,199
100490409,359,30,3,18,7,0,12,429
100490410,256,18,5,18,0,2,6,305
100490411,279,24,2,13,0,2,6,326
100490412,237,15,1,8,0,3,6,270
100490413,229,14,3,12,2,0,11,271
100490414,232,12,2,10,3,0,10,269
100490415,274,20,3,5,2,1,12,317
100490416,345,23,5,11,5,2,13,404
100490417,211,6,0,0,0,0,3,220
100490418,274,16,0,3,0,4,10,307
100490419,286,11,4,2,1,1,17,322
100490501,234,47,21,7,23,0,16,348
100490502,187,18,14,0,13,1,13,246
100490503,191,10,1,8,8,1,13,232
100490504,202,15,6,2,6,2,2,235
100490505,248,10,1,7,1,4,5,276
100490506,175,2,3,3,1,1,9,194
100490507,181,21,2,3,16,0,7,230
100490508,281,14,5,7,9,2,19,337
100490509,211,42,0,1,6,3,14,277
100490510,287,27,1,2,1,0,14,332
100490511,179,11,4,3,13,0,0,210
100490512,338,17,2,2,2,3,6,370
100490513,383,14,1,1,0,1,9,409
100490514,152,2,1,0,2,0,4,161
100490515,367,8,1,3,2,2,6,389
100490516,393,12,4,18,2,1,29,459
100490517,158,1,2,1,0,0,1,163
100490601,284,24,6,6,5,1,19,345
100490602,186,20,14,1,21,0,26,268
100490603,208,47,14,1,1,1,14,286
100490604,163,27,6,7,49,1,10,263
100490605,193,19,17,3,14,1,12,259
100490606,229,30,7,2,1,0,3,272
100490607,255,10,4,3,13,2,10,297
100490608,136,15,5,5,3,1,8,173
100490609,254,30,0,4,6,1,17,312
100490610,217,9,7,3,5,1,14,256
100490611,273,8,0,5,4,0,15,305
100490612,196,4,5,0,1,0,4,210
100490613,342,13,0,3,1,0,7,366
100490614,216,9,0,2,3,1,16,247
100490615,303,15,0,3,0,0,4,325
100490616,256,16,7,5,1,0,7,292
100490617,174,14,1,1,0,0,2,192
100490618,252,14,0,2,0,0,0,268
100490619,203,2,2,1,1,1,3,213
100490701,273,7,17,24,1,9,2,333
100490702,196,6,7,41,1,2,8,261
100490703,247,16,3,28,2,0,10,306
100490704,212,18,5,6,0,0,2,243
100490705,170,25,3,4,2,0,3,207
100490706,339,30,3,3,0,0,8,383
100490707,377,25,6,3,2,0,7,420
100490708,254,13,2,1,0,0,4,274
100490709,254,23,1,5,0,1,4,288
100490710,257,4,0,0,0,0,8,269
100490711,256,16,3,3,0,0,3,281
100490712,372,26,0,14,2,0,5,419
100490801,164,0,3,0,0,0,1,168
100490802,239,0,8,0,0,0,2,249
100490803,318,10,1,0,1,1,2,333
100490804,220,9,1,0,0,0,1,231
100490805,246,10,1,0,2,0,10,269
100490806,170,2,5,2,0,0,3,182
100490807,270,20,6,4,3,2,7,312
100490808,374,12,5,16,3,2,13,425
100490809,230,2,4,12,6,2,19,275
100490810,279,2,3,1,2,1,20,308
100490811,232,0,1,0,0,0,18,251
100490812,176,0,2,8,1,0,9,196
100490813,422,10,5,20,1,0,2,460
100490901,89,7,3,5,1,39,14,158
100490902,94,7,0,0,0,0,18,119
100490903,225,11,1,0,0,1,3,241
100490904,237,7,0,0,0,0,0,244
100490905,140,0,0,0,0,0,1,141
100490906,414,19,0,1,0,0,0,434
100490907,265,4,1,60,0,0,6,336
100490908,183,6,0,16,1,0,4,210
100490909,318,32,1,9,1,3,10,374
100490910,248,16,0,3,1,0,23,291
100490911,186,12,0,1,1,2,1,203
100490912,296,17,0,4,0,0,5,322
100490913,236,6,0,4,0,1,5,252
100490914,303,1,0,99,0,7,18,428
100560101,10,2,0,0,0,7,15,34
100560102,112,10,3,6,3,143,16,293
100560103,38,12,0,0,0,7,10,67
100560104,11,0,0,0,0,6,8,25
100560201,21,0,1,4,0,2,11,39
100560202,18,0,0,0,0,1,6,25
100560203,24,3,0,3,0,4,6,40
100560204,11,5,0,0,0,1,5,22
100560205,202,58,0,15,3,26,8,312
100560301,20,5,0,0,0,2,0,27
100560302,51,17,0,3,0,0,5,76
100560303,46,1,0,0,0,9,19,75
100560304,31,0,0,0,0,2,14,47
100560401,39,5,0,0,0,0,6,50
100560402,15,0,0,0,0,0,12,27
100560403,41,6,0,0,0,5,15,67
100560501,11,2,0,0,0,0,0,13
100560502,84,11,0,25,1,9,7,137
100560503,74,13,2,1,0,1,7,98
100560504,55,6,0,0,0,1,0,62
100560601,35,0,0,0,1,0,6,42
100560602,6,2,0,0,0,0,0,8
100560603,22,10,0,0,0,0,0,32
100560701,38,0,0,2,0,0,8,48
100630101,174,25,0,5,2,0,14,220
100630102,62,4,0,4,0,6,6,82
100630103,72,2,0,1,0,9,28,112
100630201,95,5,0,5,1,15,12,133
100630202,200,9,2,2,0,6,4,223
100630203,146,25,0,7,0,11,11,200
100630204,220,18,1,7,0,6,18,270
100630205,254,16,0,6,0,11,13,300
100630206,186,11,0,0,2,0,0,199
100630207,166,13,0,3,1,1,10,194
100630208,183,20,8,3,4,8,10,236
100630209,212,26,0,4,0,5,16,263
100630210,195,17,0,9,0,7,7,235
100630211,173,15,0,4,1,4,6,203
100630212,209,12,2,6,2,2,8,241
100630213,292,18,0,13,1,20,18,362
100630214,5,0,0,0,0,0,0,5
100630215,0,1,0,0,0,0,0,1
100630216,0,0,0,0,0,0,1,1
100630217,0,1,0,0,0,0,0,1
100630218,0,0,0,0,0,0,1,1
100700101,31,0,0,0,0,2,1,34
100700102,42,13,0,0,0,0,4,59
100700103,366,37,5,29,0,3,29,469
100700104,281,31,4,12,1,0,16,345
100700105,253,18,13,2,17,0,13,316
100700106,213,17,1,8,0,0,4,243
100700107,275,29,2,7,0,1,13,327
100700108,248,28,1,7,1,3,11,299
100700109,235,18,1,2,2,2,13,273
100700110,337,38,5,12,10,9,21,432
100700111,282,24,2,1,2,1,13,325
100700112,281,43,0,5,1,0,11,341
100700113,177,37,0,17,1,0,9,241
100700201,127,11,0,0,0,6,35,179
100700202,89,20,0,1,0,4,12,126
100700203,263,51,2,9,2,3,28,358
100700204,201,30,7,1,0,1,17,257
100700205,111,13,0,0,2,1,38,165
100700301,260,33,1,3,0,13,26,336
100700302,72,17,0,2,0,1,2,94
100700303,131,6,1,1,0,3,30,172
100700304,24,3,0,0,0,10,1,38
100700305,267,37,1,27,10,5,23,370
100700306,253,37,1,12,1,4,14,322
100700307,247,26,1,4,1,1,12,292
100700308,202,33,2,7,2,0,19,265
100700309,53,3,0,0,0,6,9,71
100700401,60,9,0,0,0,4,10,83
100700402,48,5,0,0,0,3,11,67
100700403,64,0,0,1,0,6,22,93
100700404,275,21,0,5,2,5,64,372
100770101,15,0,0,0,0,10,0,25
100770102,74,8,0,0,0,0,6,88
100770103,52,18,0,0,0,2,9,81
100770104,187,7,0,7,3,10,18,232
100770105,195,38,3,2,12,19,8,277
100770201,44,1,0,0,1,19,10,75
100770202,74,5,0,2,1,29,12,123
100770203,24,13,0,0,0,3,5,45
100770301,55,7,1,0,0,8,5,76
100770401,59,3,0,2,0,36,2,102
100770402,18,18,0,0,0,0,0,36
100770501,14,3,0,2,0,0,2,21
100770502,60,11,8,3,1,9,4,96
100770601,95,5,2,5,0,146,30,283
100770602,41,7,1,1,0,68,23,141
100770603,73,19,0,3,0,182,5,282
100840101,166,15,0,5,1,4,13,204
100840102,12,7,0,0,0,0,3,22
100840103,196,24,1,4,1,4,8,238
100840104,176,21,1,6,0,1,17,222
100840105,179,20,2,4,0,0,16,221
100840106,186,33,0,2,0,0,4,225
100840107,7,4,0,0,2,0,3,16
100840201,23,6,0,0,0,0,1,30
100840202,137,26,0,1,0,8,41,213
100840203,150,40,0,2,2,16,12,222
100840204,131,40,0,0,3,6,14,194
100840301,12,0,0,1,0,6,3,22
100840302,29,9,0,0,0,1,1,40
100840303,136,24,0,4,0,7,36,207
100840304,278,53,0,6,0,13,17,367
100840305,123,9,0,0,0,1,3,136
100840306,195,19,1,8,0,6,9,238
100840307,232,16,0,9,0,4,9,270
100840401,176,16,1,11,0,5,21,230
100840402,18,0,0,2,0,11,1,32
100840403,95,5,0,3,0,5,2,110
100910101,5,0,0,1,0,1,1,8
100910102,58,8,0,3,0,0,0,69
100910103,190,34,2,7,2,2,9,246
100910104,212,28,3,9,2,6,4,264
100910105,231,39,3,7,7,17,13,317
100910106,190,19,2,3,1,5,14,234
100910107,244,21,10,12,1,9,10,307
100910108,353,22,6,31,1,5,17,435
100910109,299,19,2,6,1,5,19,351
100910110,255,35,2,4,0,3,2,301
100910111,255,12,1,17,3,3,6,297
100910112,173,29,1,16,3,7,16,245
100910113,197,26,4,2,0,6,6,241
100910114,211,34,0,15,1,5,14,280
100910115,136,19,0,90,0,0,0,245
100910201,119,34,2,5,0,3,16,179
100910202,50,28,0,1,0,1,1,81
100910301,1,0,0,0,0,0,5,6
100910302,202,34,0,6,1,5,30,278
100910303,201,13,1,17,1,3,22,258
100910401,7,0,0,0,0,0,8,15
100910402,0,0,0,0,0,0,1,1
100910403,365,42,1,9,1,8,15,441
100910404,115,27,0,7,1,7,7,164
100910405,11,2,0,0,0,4,1,18
100910501,155,14,2,68,0,19,43,301
100910502,174,23,2,10,1,22,33,265
100910503,153,19,0,17,1,3,15,208
100910504,165,40,1,4,1,4,4,219
100910505,243,59,2,6,3,21,16,350
100910506,32,20,0,0,0,1,0,53
100910507,111,35,0,1,0,28,38,213
100910508,74,29,0,2,0,0,12,117
100910509,66,17,1,2,1,11,31,129
100910510,18,26,0,0,0,4,5,53
100910511,1,0,0,0,0,0,4,5
100910601,54,14,0,0,0,1,0,69
100910602,26,3,0,0,0,0,4,33
100910603,42,11,0,0,0,1,1,55
100910604,21,3,0,0,0,7,9,40
100910701,15,20,0,0,0,0,5,40
100910702,61,13,0,3,0,3,25,105
100910703,22,11,0,0,0,1,3,37
100980101,101,25,0,4,0,2,8,140
100980102,182,24,0,6,0,3,23,238
100980103,8,3,0,0,0,0,0,11
100980104,68,9,0,1,0,1,6,85
100980201,33,8,0,0,0,0,2,43
100980202,27,3,0,0,0,3,9,42
100980203,197,20,1,7,0,5,7,237
100980204,50,7,0,0,0,1,4,62
100980205,159,11,2,7,1,3,17,200
100980206,146,36,2,6,6,1,13,210
100980207,69,0,0,2,0,5,9,85
100980208,42,1,0,3,0,0,12,58
100980301,42,5,0,0,0,0,0,47
100980302,24,4,0,1,0,1,0,30
100980303,121,6,0,0,0,0,1,128
100980401,73,4,0,0,0,1,3,81
100980402,220,10,3,2,3,1,7,246
100980403,186,22,3,2,0,0,3,216
100980404,371,31,2,1,1,3,42,451
100980405,238,22,2,3,0,1,9,275
100980406,19,1,0,1,0,0,4,25
100980407,163,19,0,0,0,4,22,208
100980408,187,24,2,4,0,6,7,230
100980409,174,32,0,3,4,3,10,226
100980410,14,5,0,2,0,3,7,31
101050101,38,13,0,0,0,13,17,81
101050102,178,28,1,0,0,3,29,239
101050103,146,35,0,12,0,6,33,232
101050104,280,49,1,5,1,3,54,393
101050105,248,39,1,5,0,1,20,314
101050106,172,14,0,0,0,0,19,205
101050107,255,45,0,2,0,0,16,318
101050108,178,5,0,0,1,0,15,199
101050109,253,33,1,8,2,1,6,304
101050110,156,34,5,2,3,0,6,206
101050111,256,30,7,9,5,4,13,324
101050112,268,48,0,4,0,4,6,330
101050113,143,34,0,11,1,7,10,206
101050114,298,29,2,11,5,1,30,376
101050115,284,31,0,12,0,2,12,341
101050201,63,17,0,2,0,0,7,89
101050202,186,32,2,4,1,14,33,272
101050301,8,12,0,0,0,4,3,27
101050302,210,96,0,8,1,5,27,347
101050303,231,75,0,3,4,6,30,349
101050304,263,34,0,5,0,0,13,315
101050305,154,23,0,5,4,3,44,233
101050306,177,17,2,4,6,0,20,226
101050307,137,26,1,4,1,5,25,199
101050401,119,12,0,1,1,7,28,168
101050402,56,10,0,0,0,2,7,75
101050501,50,10,0,0,0,0,35,95
101050502,18,7,0,1,0,3,9,38
101050601,1,0,0,0,0,0,4,5
101050602,162,14,1,7,1,5,26,216
101050701,86,20,0,2,0,5,19,132
101050702,237,68,0,5,1,2,33,346
101050703,20,6,0,6,0,11,0,43
101050704,25,0,0,0,0,19,0,44
101050705,39,23,0,1,0,8,17,88
101050706,42,6,1,1,1,20,10,81
101050707,77,8,0,1,0,9,13,108
101050708,132,26,0,34,3,0,13,208
101050709,131,47,0,9,0,1,6,194
101050801,33,6,0,0,0,2,12,53
101050802,8,11,0,0,0,0,0,19
101120101,117,2,0,1,0,15,12,147
101120201,42,10,0,3,0,6,5,66
101120202,61,21,0,0,0,0,1,83
101120301,29,0,0,3,0,0,1,33
101120302,92,10,2,6,0,0,3,113
101120303,48,10,0,2,0,0,4,64
101120401,26,2,0,7,0,4,0,39
101120402,189,17,3,2,0,0,1,212
101120403,384,25,3,5,2,1,7,427
101120404,329,12,2,4,3,1,8,359
101120405,310,22,2,18,1,2,7,362
101120406,325,9,0,5,0,4,13,356
101120407,226,20,7,3,1,7,9,273
101120408,319,17,1,4,2,5,9,357
101120409,304,24,0,13,7,3,17,368
101120410,229,26,1,6,2,2,6,272
101120411,189,16,4,3,1,1,10,224
101120501,16,0,0,0,0,0,2,18
101120502,202,21,2,2,5,0,9,241
101120503,235,22,0,5,1,2,7,272
101120504,221,12,6,10,1,0,10,260
101120505,216,6,1,10,0,0,18,251
101120506,233,12,0,0,0,1,7,253
101120507,234,22,2,12,1,0,9,280
101120508,204,15,4,4,0,2,13,242
101120509,298,28,4,15,5,0,12,362
101120510,274,36,2,12,4,1,5,334
101120511,222,18,1,7,0,2,5,255
101120512,214,20,1,7,1,3,10,256
101120513,276,21,1,6,0,0,5,309
101120514,183,18,0,0,1,0,0,202
101120515,214,24,0,1,0,0,8,247
140070101,17,1,0,4,0,6,3,31
140070102,121,7,0,10,1,64,4,207
140070103,79,60,9,5,0,54,17,224
140070104,23,0,0,0,0,23,0,46
140070105,70,25,4,12,2,35,10,158
140070106,31,3,0,4,1,10,8,57
140070107,10,0,0,0,0,0,33,43
140070108,111,7,0,0,0,6,34,158
140070110,133,33,9,11,0,147,10,343
140070111,179,82,24,22,2,76,12,397
140070112,166,68,11,34,2,81,25,387
140070113,162,6,9,10,2,52,4,245
140070201,90,17,4,6,0,37,38,192
140070202,31,1,0,0,1,6,8,47
140070203,31,8,0,3,0,8,4,54
140070204,139,59,0,9,0,12,60,279
140070205,154,22,10,17,2,60,6,271
140070206,312,32,17,21,1,32,12,427
140070207,264,31,2,5,1,22,19,344
140070208,264,35,7,6,2,29,22,365
140070209,196,26,18,7,0,26,19,292
140070210,153,27,8,2,2,12,33,237
140070211,281,42,1,15,0,19,8,366
140070212,182,44,9,4,2,22,8,271
140070213,174,37,5,4,9,23,11,263
140070214,195,22,4,4,1,40,11,277
140070215,174,32,1,4,0,32,5,248
140070216,77,15,1,2,0,8,10,113
140070301,16,0,1,1,0,4,21,43
140070302,17,0,1,0,0,10,19,47
140070303,5,5,0,0,0,1,16,27
140070304,17,2,0,2,0,2,29,52
140070305,84,29,1,1,0,13,16,144
140070306,28,18,0,1,0,6,5,58
140070307,32,3,0,8,0,42,10,95
140070308,73,29,0,1,0,9,11,123
140070309,266,28,2,12,4,3,7,322
140070310,199,6,5,7,3,3,10,233
140070311,240,26,10,3,3,3,9,294
140070312,247,15,8,3,1,5,18,297
140070401,15,10,0,3,1,21,9,59
140070402,7,0,0,0,0,13,0,20
140070403,24,0,0,4,0,22,8,58
140070404,2,8,0,0,0,0,0,10
140070405,47,4,0,3,0,52,11,117
140070406,64,15,1,2,0,22,12,116
140070407,77,9,3,7,0,177,52,325
140070408,20,7,0,0,2,10,2,41
140070409,13,0,0,1,0,3,12,29
140070410,9,8,3,1,0,0,1,22
140070411,19,3,1,1,0,4,2,30
140070412,32,8,0,1,0,10,2,53
140070413,23,2,2,21,0,35,55,138
140070414,223,47,3,19,2,62,12,368
140070415,56,7,2,0,0,28,10,103
140070416,129,29,7,13,1,107,10,296
140070501,205,63,4,22,0,124,16,434
140070502,113,32,2,6,1,137,4,295
140070503,166,25,8,10,0,107,16,332
140070504,150,60,2,2,0,39,34,287
140070505,180,16,13,4,1,87,20,321
140070506,220,54,6,7,0,82,11,380
140070507,156,23,10,9,1,54,7,260
140070508,149,25,12,11,0,43,15,255
140070509,263,52,21,1,2,31,21,391
140070510,327,71,11,2,0,18,8,437
140070511,298,45,13,13,1,29,10,409
140070512,276,46,22,7,0,40,17,408
140070513,248,51,13,12,0,101,14,439
140070514,173,12,5,9,0,48,43,290
140070515,175,31,7,15,1,34,6,269
140070516,117,11,8,13,1,44,29,223
140070517,280,31,5,13,0,11,13,353
140070518,199,13,2,3,0,27,10,254
140070601,13,5,0,0,0,3,17,38
140070602,65,35,2,1,0,10,11,124
140070603,45,15,1,1,2,22,29,115
140070604,18,10,1,0,0,17,13,59
140070605,65,10,6,12,0,128,12,233
140070606,62,3,2,8,0,92,0,167
140070607,255,49,7,16,2,154,15,498
140070608,227,20,19,22,1,65,28,382
140070609,151,21,3,8,1,61,11,256
140070610,132,21,3,16,0,193,15,380
140070611,214,35,13,14,2,73,8,359
140070612,163,10,14,8,1,76,8,280
140070613,125,10,7,13,0,174,20,349
140070614,243,37,5,6,4,50,40,385
140070615,136,10,14,12,4,166,14,356
140070616,109,12,2,4,0,64,17,208
140070701,24,2,0,0,0,5,7,38
140070702,26,16,0,0,0,6,0,48
140070703,13,9,0,0,0,50,5,77
140070704,6,26,0,0,0,7,7,46
140070705,29,2,0,2,0,13,20,66
140070706,279,40,7,18,3,14,15,376
140070707,13,1,0,0,0,0,17,31
140070708,14,6,0,0,0,10,11,41
140070709,6,0,0,0,0,6,2,14
140070710,12,0,0,0,0,1,2,15
140070711,12,0,0,0,0,5,2,19
140070712,14,0,0,0,0,11,5,30
140070713,27,3,0,1,0,15,9,55
140070714,6,0,2,0,0,8,6,22
140070715,68,3,0,1,1,4,21,98
140070716,13,1,0,3,0,19,12,48
140070717,8,20,0,0,0,8,1,37
140070718,28,2,0,4,0,112,7,153
140070719,177,26,7,8,6,84,18,326
140070720,19,7,0,0,0,81,11,118
140070801,10,0,0,0,1,3,3,17
140070802,62,22,0,1,0,19,10,114
140070803,268,30,6,6,0,58,17,385
140070804,65,6,0,4,0,21,26,122
140070805,335,46,9,4,2,31,44,471
140070806,202,18,5,6,0,8,4,243
140070807,270,27,9,3,2,9,10,330
140070808,288,38,13,7,4,18,20,388
140070809,246,19,4,15,3,20,10,317
140070810,34,3,1,0,1,9,12,60
140070811,14,10,1,0,0,2,3,30
140070812,15,5,1,2,0,9,13,45
140070813,16,5,1,0,0,1,11,34
140070814,330,20,4,4,1,0,4,363
140070815,333,25,11,7,4,2,10,392
140070816,210,24,2,8,0,10,6,260
140070817,334,22,12,9,2,26,11,416
140070818,275,27,4,3,1,2,8,320
140070819,35,1,5,2,2,86,4,135
140070820,178,34,1,2,1,6,11,233
140070901,10,1,0,0,0,6,3,20
140070902,25,12,0,0,0,14,1,52
140070903,14,22,0,0,0,0,3,39
140070904,243,52,15,8,1,127,19,465
140070905,14,7,1,0,0,1,13,36
140070906,27,9,0,3,0,24,8,71
140070907,12,3,0,0,0,5,4,24
140070908,90,28,10,11,0,40,5,184
140140101,154,6,1,2,4,0,1,168
140140102,264,0,3,4,21,1,10,303
140140103,330,21,1,1,0,0,4,357
140140104,199,7,0,3,1,0,15,225
140140105,298,7,8,0,1,0,21,335
140140106,324,0,7,4,0,2,6,343
140140107,225,18,10,1,0,1,4,259
140140108,202,0,3,1,0,0,12,218
140140109,345,25,6,2,1,1,21,401
140140110,271,1,11,37,1,0,13,334
140140111,172,19,2,0,0,0,0,193
140140112,306,9,3,2,1,1,9,331
140140113,314,0,0,2,0,0,4,320
140140201,227,15,0,0,2,3,3,250
140140202,450,46,54,57,9,1,6,623
140140203,343,30,15,19,0,0,8,415
140140204,269,23,5,0,0,0,2,299
140140205,221,0,2,2,2,0,1,228
140140206,180,18,2,16,0,0,5,221
140140207,350,34,4,2,4,0,6,400
140140208,279,1,1,3,3,1,2,290
140140209,237,16,3,1,0,0,2,259
140140210,255,20,1,0,1,0,5,282
140140211,179,8,0,0,12,0,0,199
140140212,229,23,8,1,5,0,5,271
140140213,342,24,3,1,4,0,9,383
140140214,318,26,10,4,2,0,8,368
140140215,350,0,10,3,1,1,7,372
140140301,122,5,3,3,1,1,8,143
140140302,491,15,0,4,1,0,2,513
140140303,386,13,3,5,9,1,14,431
140140304,332,29,7,7,3,1,7,386
140140305,259,10,4,4,1,0,5,283
140140306,221,15,2,0,0,0,9,247
140140307,210,13,2,1,3,0,9,238
140140308,310,19,3,1,0,0,2,335
140140309,341,13,1,2,0,0,4,361
140140310,248,20,7,2,5,0,8,290
140140311,262,11,5,1,0,0,5,284
140140312,352,30,4,1,6,0,4,397
140140313,330,19,6,1,1,0,8,365
140140401,373,19,0,4,0,1,8,405
140140402,257,17,4,4,0,2,2,286
140140403,92,21,0,2,1,5,2,123
140140404,249,8,3,12,0,1,7,280
140140405,447,11,0,0,0,0,6,464
140140406,393,12,0,0,1,1,3,410
140140407,282,33,4,3,2,2,3,329
140140408,413,23,15,7,7,1,10,476
140140409,283,37,5,7,0,0,6,338
140140410,333,14,3,6,0,0,3,359
140140411,378,21,8,6,3,0,6,422
140140501,240,0,2,4,3,2,9,260
140140502,289,3,4,0,0,2,8,306
140140503,202,2,0,3,1,0,1,209
140140504,302,18,0,1,0,2,2,325
140140505,398,5,2,1,0,0,7,413
140140506,181,11,0,0,0,0,3,195
140140507,203,1,1,2,1,0,4,212
140140508,356,4,4,2,0,0,2,368
140140509,213,10,1,8,4,0,3,239
140140510,375,34,6,1,2,0,10,428
140140511,300,7,1,2,1,0,2,313
140140512,291,3,2,4,0,0,6,306
140140513,326,13,4,2,1,0,2,348
140140514,304,16,0,0,0,0,3,323
140140515,376,11,1,0,0,0,6,394
140140601,202,8,11,15,0,6,11,253
140140602,43,12,0,0,0,0,0,55
140140603,62,7,0,2,0,0,1,72
140140604,209,11,2,16,1,1,13,253
140140605,213,18,3,5,0,7,14,260
140140606,261,39,1,5,2,0,8,316
140140607,388,20,21,33,6,12,10,490
140140608,144,4,0,7,0,0,0,155
140140609,295,16,4,7,0,0,13,335
140140610,288,9,3,9,3,0,7,319
140140701,329,24,2,2,1,0,5,363
140140702,211,10,2,0,0,0,3,226
140140703,168,16,2,0,0,0,0,186
140140704,249,12,1,6,1,0,6,275
140140705,298,13,10,16,6,1,19,363
140140706,13,2,0,0,0,0,1,16
140140707,182,10,1,6,2,0,2,203
140140708,280,15,7,6,1,0,5,314
140140709,354,12,0,4,0,0,7,377
140140710,59,0,0,0,0,0,3,62
140140711,167,2,0,1,0,0,3,173
140140712,116,3,0,2,1,5,7,134
140140713,244,12,1,0,0,0,3,260
140140714,262,4,0,0,0,0,3,269
140140715,231,9,0,0,0,0,0,240
140140801,3,0,0,0,0,0,0,3
140140802,202,8,4,3,0,0,3,220
140140803,111,3,1,0,0,0,6,121
140140804,285,16,0,39,5,0,4,349
140140805,443,30,5,18,1,0,16,513
140140806,233,21,1,10,1,1,16,283
140140807,280,18,5,3,3,1,3,313
140140808,176,13,0,0,2,0,8,199
140140809,408,11,1,6,1,0,2,429
140140810,331,23,5,0,0,1,17,377
140140811,320,24,3,2,0,0,2,351
140140812,239,6,15,4,5,1,7,277
140140901,10,0,0,0,0,1,0,11
140140902,308,16,1,20,3,0,14,362
140140903,276,8,0,2,0,1,4,291
140140904,225,13,1,2,1,0,4,246
140140905,363,10,4,7,1,0,3,388
140140906,203,9,5,3,0,0,2,222
140140907,134,6,3,2,0,0,0,145
140140908,350,38,1,1,0,0,23,413
140140909,369,45,8,4,1,0,18,445
140140910,328,24,9,6,3,0,4,374
140140911,385,12,11,4,5,0,10,427
140140912,439,14,9,14,2,0,7,485
140140913,306,21,6,8,5,1,4,351
140140914,238,8,1,0,0,0,6,253
140140915,13,0,0,0,0,0,2,15
140141001,156,6,1,28,1,0,9,201
140141002,440,37,14,3,0,0,7,501
140141003,215,21,3,0,0,0,5,244
140141004,247,12,3,0,0,1,3,266
140141005,189,20,4,0,0,2,3,218
140141006,352,22,8,2,3,1,13,401
140141007,152,10,10,2,3,2,3,182
140141008,438,48,3,4,1,0,18,512
140141009,320,24,8,2,6,0,3,363
140141010,307,32,7,1,3,2,13,365
140141011,378,25,2,3,0,1,11,420
140141012,224,23,7,6,2,2,3,267
140141013,275,17,5,5,0,0,3,305
140141014,186,13,5,5,2,0,4,215
140141015,213,8,0,2,1,0,1,225
140141016,264,13,0,1,1,0,1,280
140141017,225,16,15,14,1,0,3,274
140141018,193,8,1,39,3,0,14,258
140141101,104,8,1,1,1,0,5,120
140141102,224,9,6,2,1,0,2,244
140141103,259,10,4,2,17,3,5,300
140141104,195,13,1,3,1,0,6,219
140141105,265,13,7,1,2,0,0,288
140141106,226,4,7,2,1,0,6,246
140141107,218,9,0,4,0,0,5,236
140141108,247,8,0,1,0,0,3,259
140141109,384,10,1,2,0,0,6,403
140141110,210,23,2,5,0,0,5,245
140141111,280,14,3,6,1,0,9,313
140141201,234,8,0,0,0,0,6,248
140141202,316,17,2,3,2,0,5,345
140141203,312,23,4,3,1,0,1,344
140141204,347,21,2,7,1,0,5,383
140141205,374,12,1,3,0,1,5,396
140141206,240,11,1,2,0,0,1,255
140141207,256,22,5,5,10,0,5,303
140141208,315,12,16,2,4,2,7,358
140141209,316,18,3,4,3,0,3,347
140141301,116,8,0,2,3,0,5,134
140141302,333,24,1,4,1,0,9,372
140141303,262,14,3,3,4,0,2,288
140141304,328,10,3,2,3,1,3,350
140141305,206,7,2,2,0,0,5,222
140141306,176,11,2,8,0,1,4,202
140141307,320,22,4,7,0,0,7,360
140141308,274,14,0,0,0,0,2,290
140141309,417,10,0,0,0,0,2,429
140141310,151,4,4,9,0,5,2,175
140141401,318,8,1,0,0,0,4,331
140141402,454,6,1,1,0,0,2,464
140141403,332,7,0,6,0,2,7,354
140141404,190,11,0,9,1,0,4,215
140141405,238,15,2,4,1,0,10,270
140141406,328,17,3,3,0,0,9,360
140141407,348,30,9,6,2,0,17,412
140141408,10,8,0,1,0,2,5,26
140141501,200,24,5,8,0,1,3,241
140141502,241,23,7,0,3,3,4,281
140141503,187,29,2,2,4,0,5,229
140141504,247,29,3,2,4,0,6,291
140141505,293,18,9,0,0,0,5,325
140141506,446,40,6,1,0,0,16,509
140141507,194,13,2,0,1,0,3,213
140141508,235,10,0,1,0,1,6,253
140141509,392,40,3,1,1,0,9,446
140141510,312,30,4,1,5,0,3,355
140141511,378,24,1,0,0,0,13,416
140141512,188,7,1,0,1,0,2,199
140141513,454,33,9,5,1,0,12,514
140141514,333,23,2,18,0,1,4,381
140141515,243,23,0,24,1,0,5,296
140141516,155,13,1,4,0,0,10,183
140141517,302,9,1,38,2,0,6,358
140141518,222,15,3,40,2,3,5,290
140141519,246,18,1,35,0,5,6,311
140141520,347,19,5,32,0,3,12,418
140141601,330,11,3,5,0,0,8,357
140141602,397,6,0,0,0,0,11,414
140141603,415,17,0,10,0,0,10,452
140141604,177,2,5,1,0,0,5,190
140141605,248,9,0,1,0,1,2,261
140141606,303,18,4,1,8,0,4,338
140141607,291,12,9,4,14,0,1,331
140141608,171,12,11,6,12,0,8,220
140141609,191,0,10,8,28,2,1,240
140141610,245,12,2,13,0,1,9,282
140141611,251,9,2,2,2,1,6,273
140141612,247,18,4,28,1,0,7,305
140141613,254,7,3,21,1,1,6,293
140141614,247,15,0,13,1,0,14,290
140141615,225,19,2,7,2,3,9,267
140141616,521,15,0,34,0,1,8,579
140141617,293,11,0,5,0,0,16,325
140141618,380,15,1,0,0,0,3,399
140141701,387,3,11,15,6,3,2,427
140141702,291,14,4,6,3,1,2,321
140141703,259,9,0,0,0,0,2,270
140141704,368,19,11,5,0,0,7,410
140141705,297,22,13,18,0,1,5,356
140141706,400,27,9,9,1,3,7,456
140141707,209,6,6,48,0,0,23,292
140141708,295,13,7,4,0,0,7,326
140141709,220,0,5,6,1,1,11,244
140141710,330,15,10,17,1,0,9,382
140141711,323,20,12,9,1,0,11,376
140141712,240,18,4,0,0,0,4,266
140141713,417,17,8,12,2,1,10,467
140141714,250,19,4,2,2,0,8,285
140141715,370,9,0,6,0,0,5,390
140141716,405,7,3,4,0,0,7,426
140141717,435,21,1,6,1,0,6,470
140141718,330,20,9,8,4,0,15,386
140141719,266,26,1,3,1,1,2,300
140141720,181,18,6,6,2,0,7,220
140141721,371,3,5,4,7,0,18,408
140141801,381,22,20,16,7,1,26,473
140141802,263,22,5,12,0,3,5,310
140141803,263,1,3,1,0,1,2,271
140141804,212,0,0,1,0,1,3,217
140141805,386,1,8,21,2,1,3,422
140141806,213,0,7,2,0,0,7,229
140141807,216,2,7,8,0,3,7,243
140141808,446,34,12,17,12,0,11,532
140141809,326,3,4,1,2,0,4,340
140141810,243,27,2,2,0,3,30,307
140141811,329,0,2,7,2,0,7,347
140141812,305,16,5,6,3,1,3,339
140141813,296,1,1,0,1,0,9,308
140141814,326,4,1,5,1,0,4,341
140141815,251,3,2,1,7,0,4,268
140141816,420,11,4,19,0,0,12,466
140141817,243,3,1,0,0,0,3,250
140141818,244,2,0,0,0,0,4,250
140141901,360,3,4,5,14,0,12,398
140141902,229,0,5,5,5,3,3,250
140141903,234,2,6,4,2,0,1,249
140141904,281,2,6,4,0,0,2,295
140141905,211,1,6,5,1,0,7,231
140141906,335,4,0,0,0,0,17,356
140141907,370,0,0,0,0,0,1,371
140141908,409,2,0,1,0,0,10,422
140141909,292,2,2,33,1,0,4,334
140141910,192,0,2,1,2,1,2,200
140141911,391,4,8,0,3,0,20,426
140141912,225,0,1,4,0,1,4,235
140141913,328,0,0,0,0,0,6,334
140141914,324,7,0,5,0,0,3,339
140141915,417,0,1,6,1,0,5,430
140141916,380,7,21,18,1,1,3,431
140141917,226,4,4,3,2,1,3,243
140141918,236,7,1,8,2,1,13,268
140141919,236,2,0,2,0,0,3,243
140142001,248,20,3,3,1,0,15,290
140142002,233,31,11,2,3,2,2,284
140142003,251,11,8,5,7,2,4,288
140142004,309,18,12,7,0,0,2,348
140142005,368,26,6,3,0,0,6,409
140142006,236,14,2,4,2,0,5,263
140142007,246,30,4,2,0,1,3,286
140142008,204,20,3,3,7,0,8,245
140142009,217,10,2,3,0,0,5,237
140142010,251,15,6,9,1,0,9,291
140142011,220,19,7,2,2,0,6,256
140142012,292,22,12,1,3,2,7,339
140142013,275,18,11,3,1,1,11,320
140142014,275,21,2,1,2,0,8,309
140142015,185,26,10,2,3,1,5,232
140142016,367,17,5,6,0,1,8,404
140142101,272,39,7,21,0,19,1,359
140142102,275,30,14,20,0,0,3,342
140142103,252,16,8,17,0,3,9,305
140142104,378,49,4,11,0,7,7,456
140142105,207,25,5,8,0,4,15,264
140142201,197,23,1,44,0,0,2,267
140142202,318,25,3,1,0,0,2,349
140142203,202,14,26,89,1,2,5,339
140142204,197,12,3,3,0,0,1,216
140142205,118,15,1,45,0,0,2,181
140142206,415,39,6,23,2,0,10,495
140142207,201,13,4,16,0,1,5,240
140142208,335,31,3,1,0,0,9,379
140142209,230,28,3,1,1,1,3,267
140142210,288,19,2,1,4,0,5,319
140142211,278,17,10,17,1,9,15,347
140142212,289,54,68,0,2,1,13,427
140142213,3,0,0,0,0,0,0,3
140142214,228,23,4,11,0,0,9,275
140142215,307,38,11,1,0,0,1,358
140142216,282,51,244,129,0,0,24,730
140142217,298,20,3,3,1,1,4,330
140142218,393,28,0,1,1,0,16,439
140142301,200,18,3,9,4,0,11,245
140142302,284,28,12,4,0,1,12,341
140142303,214,29,8,3,2,0,2,258
140142304,185,0,0,0,0,0,0,185
140142305,172,33,8,3,0,0,4,220
140142306,255,25,11,5,6,1,17,320
140142307,248,18,11,6,10,0,10,303
140142308,341,50,6,6,3,0,6,412
140142309,166,17,1,2,0,0,5,191
140142310,256,28,11,5,34,4,16,354
140142311,214,28,4,6,13,2,4,271
140142312,245,31,3,6,0,0,4,289
140142313,448,42,6,7,3,0,23,529
140142314,242,10,14,3,0,0,4,273
140142315,263,27,4,3,6,0,13,316
140142316,194,17,7,4,3,0,27,252
140142401,331,39,10,4,5,0,12,401
140142402,330,35,9,3,4,1,2,384
140142403,290,15,10,3,9,0,4,331
140142404,412,25,8,4,5,1,12,467
140142405,255,22,5,7,2,0,12,303
140142406,300,33,7,3,10,2,12,367
140142407,251,25,4,1,8,0,6,295
140142408,244,28,7,3,3,0,4,289
140142409,287,37,9,4,9,0,12,358
140142410,180,7,5,1,5,0,6,204
140142411,222,24,3,0,1,0,3,253
140142412,183,17,11,2,18,1,51,283
140142413,217,23,8,1,9,2,13,273
140142414,198,19,5,2,4,0,6,234
140142501,269,62,14,0,0,26,11,382
140142502,181,1,3,0,0,0,3,188
140142503,88,14,1,0,1,0,1,105
140142504,318,27,4,1,0,1,18,369
140142505,230,12,1,5,2,1,3,254
140142506,325,11,6,0,4,0,8,354
140142507,310,2,6,7,3,1,9,338
140142508,175,28,7,0,6,1,6,223
140142509,189,6,7,0,1,0,7,210
140142510,186,25,0,3,7,0,11,232
140142511,240,3,5,3,0,0,5,256
140142512,231,6,9,4,4,2,11,267
140142513,231,1,5,7,11,0,5,260
140142514,208,5,3,1,0,0,1,218
140142515,343,28,15,0,4,3,9,402
140142516,314,25,7,5,2,0,8,361
140142517,221,14,4,1,3,0,7,250
140142518,308,35,3,1,2,1,6,356
140142601,217,12,4,3,10,0,4,250
140142602,175,20,3,4,2,0,19,223
140142603,225,18,4,1,5,0,8,261
140142604,166,19,7,3,23,0,12,230
140142605,172,9,3,3,3,0,23,213
140142606,229,17,12,1,5,0,12,276
140142607,226,11,7,3,1,1,1,250
140142608,342,44,11,4,47,0,16,464
140142609,264,37,21,4,27,0,12,365
140142610,194,24,5,0,2,0,5,230
140142611,361,35,15,1,7,5,10,434
140142612,276,39,16,0,3,2,10,346
140142613,202,22,11,4,4,0,2,245
140142614,239,25,6,1,10,0,19,300
140142615,305,45,10,6,1,0,12,379
140142616,239,28,29,5,1,1,11,314
140142701,231,0,4,0,1,0,11,247
140142702,302,30,7,0,1,0,9,349
140142703,316,13,5,2,0,0,14,350
140142704,243,6,3,0,1,0,12,265
140142705,179,10,4,0,8,0,1,202
140142706,219,20,6,3,0,0,4,252
140142707,275,24,3,2,2,0,11,317
140142708,295,18,10,0,2,0,11,336
140142709,197,7,2,2,4,0,6,218
140142710,277,12,10,1,0,1,11,312
140142711,252,25,6,0,6,0,7,296
140142712,205,10,8,3,6,1,12,245
140142801,381,0,7,2,8,0,6,404
140142802,307,18,9,4,10,0,8,356
140142803,360,0,8,3,6,0,11,388
140142804,398,0,4,3,2,1,10,418
140142805,310,3,4,2,2,1,10,332
140142806,252,0,3,2,6,1,2,266
140142807,224,0,1,2,1,0,0,228
140142808,363,3,7,1,1,0,16,391
140142809,284,24,0,3,1,1,8,321
140142810,308,26,10,2,3,1,3,353
140142811,270,18,1,3,0,2,2,296
140142812,238,10,4,4,0,1,1,258
140142813,339,14,2,5,1,0,9,370
140142814,311,17,0,1,0,0,4,333
140142815,246,9,1,0,1,0,8,265
140142816,418,14,1,2,1,0,2,438
140142901,304,12,0,1,2,0,9,328
140142902,261,15,1,0,0,0,1,278
140142903,274,17,0,0,1,0,4,296
140142904,279,10,9,2,1,0,6,307
140142905,309,2,4,1,1,0,5,322
140142906,363,24,13,0,0,0,5,405
140142907,223,10,4,1,9,0,12,259
140142908,260,12,5,1,4,0,3,285
140142909,282,17,3,0,0,0,4,306
140142910,259,21,0,4,6,0,8,298
140142911,200,8,5,2,0,3,7,225
140142912,246,7,8,1,0,0,6,268
140142913,246,7,4,5,2,0,4,268
140142914,272,27,14,0,1,0,2,316
140142915,382,6,1,1,2,0,15,407
140142916,285,26,5,0,4,0,2,322
140142917,305,24,12,0,5,4,6,356
140142918,214,13,4,1,1,0,8,241
140142919,208,19,5,0,0,0,2,234
140143001,259,15,9,4,3,0,10,300
140143002,378,22,6,6,3,0,15,430
140143003,241,24,2,10,1,0,3,281
140143004,315,25,4,7,4,0,4,359
140143005,186,0,2,16,0,0,10,214
140143006,250,12,2,17,3,0,9,293
140143007,136,9,1,2,4,0,4,156
140143008,273,11,0,1,0,1,1,287
140143009,362,13,5,1,4,0,6,391
140143010,269,13,5,0,0,0,4,291
140143011,277,14,4,1,2,0,6,304
140143012,303,18,5,2,1,1,8,338
140143013,297,22,4,1,2,0,2,328
140143014,310,17,2,2,0,0,5,336
140143015,252,12,2,2,2,0,4,274
140143101,261,4,1,2,0,0,1,269
140143102,376,10,1,3,0,0,2,392
140143103,385,10,2,1,1,0,5,404
140143104,289,10,0,0,0,0,2,301
140143105,306,20,1,0,0,0,3,330
140143106,254,15,5,0,1,0,3,278
140143107,414,24,14,4,1,0,2,459
140143108,287,18,3,0,0,0,3,311
140143109,373,20,1,2,2,0,4,402
140143110,228,12,2,0,1,0,1,244
140143111,236,15,1,1,2,0,1,256
140143112,343,18,4,6,25,0,13,409
140143113,266,28,9,0,7,0,15,325
140143114,263,20,3,2,8,0,7,303
140143115,224,14,2,0,1,0,3,244
140143116,305,8,5,1,1,0,5,325
140143201,216,1,6,1,2,1,0,227
140143202,384,2,2,4,1,0,8,401
140143203,223,0,7,1,0,0,1,232
140143204,226,0,2,6,1,0,8,243
140143205,314,3,6,1,1,1,6,332
140143206,310,1,23,2,0,1,9,346
140143207,357,0,9,0,0,1,11,378
140143208,250,0,4,4,0,0,72,330
140143209,225,0,3,0,0,0,5,233
140143210,413,1,6,2,7,0,9,438
140143211,265,11,5,1,0,0,5,287
140143212,215,8,2,0,1,0,3,229
140143213,271,37,4,0,0,0,1,313
140143301,259,11,7,1,2,0,8,288
140143302,208,8,5,1,0,0,6,228
140143303,249,9,0,0,0,0,7,265
140143304,204,7,10,6,2,0,6,235
140143305,212,8,2,0,4,0,3,229
140143306,196,7,7,3,5,1,11,230
140143307,295,21,0,18,0,0,0,334
140143308,332,15,4,11,5,1,12,380
140143309,246,19,10,3,0,0,8,286
140143310,241,12,15,3,1,0,5,277
140143311,263,14,7,5,1,0,4,294
140143312,240,4,5,6,2,0,18,275
140143313,251,11,7,2,0,0,19,290
140143314,215,21,6,4,1,0,7,254
140143315,267,28,15,4,18,0,7,339
140143316,198,17,6,1,0,0,2,224
140143317,310,17,6,3,6,2,18,362
140143318,363,21,3,2,1,0,5,395
140143319,273,13,5,4,3,0,21,319
140143320,208,13,5,2,1,0,7,236
140143401,218,12,3,0,8,0,3,244
140143402,279,12,0,1,1,0,4,297
140143403,252,20,6,2,5,0,5,290
140143404,133,11,2,1,2,0,7,156
140143405,167,14,6,0,4,0,8,199
140143406,168,13,5,0,3,0,4,193
140143407,196,19,2,2,0,1,8,228
140143408,193,17,2,1,3,0,2,218
140143409,245,18,5,2,1,0,4,275
140143410,192,18,4,5,0,0,4,223
140143411,192,11,6,2,0,0,4,215
140143412,226,5,4,0,1,0,9,245
140143413,229,12,4,3,3,0,18,269
140143414,195,19,3,5,1,1,3,227
140143415,197,16,2,2,1,0,5,223
140143416,226,16,11,4,2,0,21,280
140143417,190,17,2,2,2,0,3,216
140143418,340,29,5,3,0,0,18,395
140143419,186,33,11,2,10,0,8,250
140143501,245,6,7,1,3,0,3,265
140143502,417,15,4,9,2,0,10,457
140143503,202,18,3,0,3,0,2,228
140143504,369,28,4,2,0,0,11,414
140143505,181,21,1,350,0,0,6,559
140143506,678,16,0,0,0,0,10,704
140143507,335,17,4,1,0,0,6,363
140143508,254,8,0,0,1,0,2,265
140143509,226,22,8,2,7,1,10,276
140143510,212,5,5,1,2,0,5,230
140143511,289,7,5,0,0,0,6,307
140143512,250,16,3,1,1,0,4,275
140143513,209,4,0,0,0,0,4,217
140143514,318,27,5,3,12,0,14,379
140143601,241,19,1,1,5,0,3,270
140143602,228,17,4,1,3,0,4,257
140143603,311,19,8,3,3,1,12,357
140143604,298,23,4,3,2,0,7,337
140143605,281,17,2,2,1,0,15,318
140143606,237,28,6,0,2,0,8,281
140143607,255,31,2,3,8,0,5,304
140143608,257,22,6,4,0,1,12,302
140143609,204,20,3,5,13,0,9,254
140143610,192,15,6,3,3,0,9,228
140143611,248,11,2,2,0,1,5,269
140143612,249,27,4,2,4,0,10,296
140143613,206,15,14,2,5,1,3,246
140143614,208,11,2,2,0,1,5,229
140143701,366,12,4,3,1,2,6,394
140143702,152,11,5,2,2,0,2,174
140143703,203,12,3,1,7,0,12,238
140143704,223,11,6,1,8,0,4,253
140143705,215,16,3,1,7,0,3,245
140143706,210,10,5,0,4,0,0,229
140143707,270,15,8,0,2,0,20,315
140143708,297,22,19,2,10,3,7,360
140143709,220,20,22,1,1,0,18,282
140143710,211,9,5,0,0,0,4,229
140143711,403,23,13,4,6,0,20,469
140143712,232,13,9,2,4,0,7,267
140143713,219,20,6,13,10,0,6,274
140143714,180,10,7,6,0,0,11,214
140143715,210,12,11,2,2,1,16,254
140143716,183,10,3,0,8,0,8,212
140143717,185,12,7,1,6,0,8,219
140143718,162,17,12,3,12,0,10,216
140143719,207,12,5,7,14,0,17,262
140143720,201,24,5,1,5,0,13,249
140143721,159,17,10,7,1,0,6,200
140143801,350,46,6,4,1,0,12,419
140143802,304,36,11,2,13,1,11,378
140143803,324,24,13,4,5,4,6,380
140143804,299,19,8,2,7,1,21,357
140143805,216,13,2,1,8,1,8,249
140143806,250,27,8,3,3,0,9,300
140143807,249,24,19,0,3,0,11,306
140143808,359,35,33,1,0,2,22,452
140143809,234,31,11,1,2,0,2,281
140143810,293,55,10,2,7,1,7,375
140143811,255,40,7,3,14,0,18,337
140143812,215,19,4,1,3,0,23,265
140143813,286,30,8,2,2,0,8,336
140143814,294,44,37,2,17,2,17,413
140143815,243,24,13,3,8,1,9,301
140143816,222,32,32,8,10,1,8,313
140143901,171,33,8,0,10,2,12,236
140143902,372,51,41,2,13,2,19,500
140143903,333,72,40,5,22,5,15,492
140143904,208,42,19,4,4,0,5,282
140143905,190,54,15,9,1,0,7,276
140143906,217,30,18,3,5,2,18,293
140143907,197,30,1,1,2,0,10,241
140143908,259,43,46,8,24,1,27,408
140143909,279,37,61,0,17,0,4,398
140143910,256,76,47,7,45,0,7,438
140143911,237,37,25,2,24,2,9,336
140143912,313,57,23,5,15,0,32,445
140143913,166,21,12,2,1,0,8,210
140144001,245,52,23,0,0,0,7,327
140144002,210,24,12,5,7,1,11,270
140144003,223,28,14,5,12,1,3,286
140144004,188,14,6,3,3,0,11,225
140144005,156,17,20,3,6,1,13,216
140144006,175,36,12,1,0,0,3,227
140144007,225,15,4,1,1,0,2,248
140144008,288,40,24,2,3,2,14,373
140144009,214,24,23,1,6,2,22,292
140144010,227,52,17,2,16,1,30,345
140144011,204,19,16,3,4,0,13,259
140144012,226,30,24,2,6,0,8,296
140144101,251,33,10,2,4,0,2,302
140144102,197,24,10,4,8,0,3,246
140144103,312,31,8,2,5,1,15,374
140144104,193,24,1,2,6,0,0,226
140144105,210,21,5,2,0,1,1,240
140144106,238,28,14,3,3,0,5,291
140144107,217,39,8,7,10,0,4,285
140144108,157,18,4,2,0,0,4,185
140144109,207,38,7,0,4,0,2,258
140144110,285,22,6,3,9,0,17,342
140144111,182,22,9,0,2,0,9,224
140144112,290,32,10,4,5,0,9,350
140144113,283,27,5,6,4,4,18,347
140144114,307,21,16,1,2,0,15,362
140144115,251,26,4,3,9,2,5,300
140144116,195,20,3,2,5,0,4,229
140144117,254,43,15,4,5,2,9,332
140144118,223,33,11,0,1,5,13,286
140144119,204,24,6,3,2,0,7,246
140144201,191,20,7,2,20,0,15,255
140144202,136,26,7,0,8,0,1,178
140144203,138,38,2,4,10,0,5,197
140144204,172,28,6,2,3,0,3,214
140144205,183,31,2,3,8,0,2,229
140144206,226,39,6,0,9,0,9,289
140144207,270,16,4,4,6,0,8,308
140144208,373,37,8,9,7,2,8,444
140144209,199,16,5,4,1,0,15,240
140144210,191,19,2,0,3,0,1,216
140144211,237,21,4,1,1,0,10,274
140144212,274,31,4,1,1,0,8,319
140144213,221,30,2,4,4,0,8,269
140144214,299,21,4,3,7,0,1,335
140144215,201,16,3,4,3,0,12,239
140144216,313,22,2,0,2,0,0,339
140144217,241,31,2,1,5,0,3,283
140144218,239,21,2,2,0,0,10,274
140144219,319,32,3,2,3,0,8,367
140144220,320,38,3,4,0,2,6,373
140144301,322,23,7,8,6,1,15,382
140144302,413,28,33,19,3,0,9,505
140144303,296,9,3,4,0,0,5,317
140144304,325,10,2,3,2,0,7,349
140144305,159,2,0,0,0,0,4,165
140144306,355,9,3,1,3,1,9,381
140144307,274,15,2,5,0,0,5,301
140144308,336,13,0,2,0,1,12,364
140144309,322,13,9,17,2,0,4,367
140144310,221,13,2,1,0,0,8,245
140144311,274,35,7,8,1,0,4,329
140144401,519,175,54,6,5,4,50,813
140144402,239,12,3,3,0,0,1,258
140144403,270,21,8,4,9,0,10,322
140144404,189,26,0,0,1,0,5,221
140144405,204,14,2,0,1,0,3,224
140144406,447,22,19,4,2,0,25,519
140144407,311,16,7,1,0,2,7,344
140144408,199,23,8,5,0,0,1,236
140144409,263,10,1,2,1,0,2,279
140144410,247,14,3,0,1,0,7,272
140144411,401,30,8,5,1,2,15,462
140144501,325,22,0,1,1,0,13,362
140144502,428,28,5,1,5,1,27,495
140144503,239,21,2,1,4,0,5,272
140144504,292,18,10,17,6,0,13,356
140144505,296,16,14,2,4,0,9,341
140144506,294,13,7,0,1,0,51,366
140144507,326,34,15,3,0,1,16,395
140144508,286,57,15,3,3,0,4,368
140144509,324,18,13,4,2,0,3,364
140144510,375,29,27,2,3,1,17,454
140144511,272,13,11,10,5,0,8,319
140144512,263,1,9,5,1,0,9,288
140144513,188,12,3,0,0,0,6,209
140144601,232,14,2,2,2,0,4,256
140144602,352,14,3,1,1,0,22,393
140144603,221,20,10,6,33,0,12,302
140144604,196,16,5,1,6,0,5,229
140144605,202,13,0,3,1,0,9,228
140144606,262,37,6,1,1,1,9,317
140144607,214,21,2,5,4,0,5,251
140144608,219,15,10,0,3,0,16,263
140144609,276,9,5,0,2,0,8,300
140144610,258,15,1,0,0,0,16,290
140144611,296,41,11,1,8,0,15,372
140144612,248,61,17,3,23,0,25,377
140144613,141,20,5,1,11,0,1,179
140144614,309,12,3,0,6,3,8,341
140144615,271,24,3,2,6,2,9,317
140144616,233,16,0,2,6,0,1,258
140144701,133,29,3,0,2,0,2,169
140144702,159,21,0,0,1,0,10,191
140144703,292,25,18,6,4,0,6,351
140144704,157,26,6,4,1,1,14,209
140144705,165,48,23,1,16,2,5,260
140144706,213,42,29,2,9,0,18,313
140144707,261,27,13,3,1,1,14,320
140144708,290,43,20,59,1,0,13,426
140144709,187,51,24,1,14,3,4,284
140144710,191,47,5,4,5,0,16,268
140144711,222,24,7,0,3,0,11,267
140144712,417,95,27,0,4,0,17,560
140144801,174,3,52,0,1,0,10,240
140144802,266,28,20,2,3,1,19,339
140144803,272,11,39,6,12,0,4,344
140144804,240,11,23,2,9,3,12,300
140144805,234,17,14,3,36,2,5,311
140144806,189,24,19,1,6,0,14,253
140144807,298,26,32,5,9,1,18,389
140144808,218,15,14,4,24,2,7,284
140144809,158,23,8,2,8,0,7,206
140144810,330,34,31,7,20,0,16,438
140144811,253,19,40,2,15,2,5,336
140144812,223,23,16,2,18,2,10,294
140144813,258,76,23,1,11,1,14,384
140144814,233,27,14,3,6,0,4,287
140144815,372,77,29,3,15,4,9,509
140144816,258,34,16,1,14,2,16,341
140144901,135,17,10,1,11,0,28,202
140144902,168,33,8,2,4,0,12,227
140144903,145,22,9,3,1,0,14,194
140144904,177,24,3,0,0,0,2,206
140144905,206,39,24,1,3,2,17,292
140144906,130,38,6,3,13,0,0,190
140144907,332,34,46,3,8,0,11,434
140144908,299,39,26,3,8,0,8,383
140144909,310,78,46,5,11,2,9,461
140144910,147,46,44,0,1,0,4,242
140144911,96,27,21,1,4,0,4,153
140144912,168,30,40,3,4,1,2,248
140144913,330,79,33,4,17,14,27,504
140144914,222,71,36,2,19,0,32,382
140144915,246,60,41,4,12,2,11,376
140144916,345,82,25,1,32,2,28,515
140144917,151,78,4,0,1,0,12,246
140144918,156,40,19,0,2,0,5,222
140144919,217,74,24,2,14,3,17,351
140144920,198,64,68,5,0,1,6,342
140144921,289,49,43,4,15,0,7,407
140145001,250,2,24,1,4,1,5,287
140145002,283,2,14,3,9,0,13,324
140145003,209,1,18,12,2,1,4,247
140145004,220,7,9,4,24,1,9,274
140145005,213,1,4,2,8,0,23,251
140145006,207,0,11,9,9,1,15,252
140145007,273,2,15,2,7,0,14,313
140145008,235,0,27,7,9,0,9,287
140145009,357,5,56,3,0,0,7,428
140145010,247,1,10,3,14,0,14,289
140145011,255,0,32,0,7,0,5,299
140145012,195,29,12,2,12,0,9,259
140145013,192,22,5,1,10,0,7,237
140145014,237,3,7,1,10,0,13,271
140145015,262,1,13,2,6,0,8,292
140145101,262,5,8,1,7,0,13,296
140145102,231,6,16,13,6,0,9,281
140145103,187,0,7,0,2,0,7,203
140145104,242,0,11,3,9,1,9,275
140145105,223,1,1,1,1,0,11,238
140145106,307,2,3,3,7,0,10,332
140145107,273,2,3,1,3,0,6,288
140145108,243,13,6,0,1,0,8,271
140145109,304,16,6,2,2,0,6,336
140145110,216,13,14,1,10,0,9,263
140145111,243,20,6,0,2,1,7,279
140145112,318,0,8,3,2,1,14,346
140145113,295,2,4,1,0,0,5,307
140145114,245,8,2,2,0,0,12,269
140145115,182,7,4,2,1,0,2,198
140145116,143,7,3,0,0,0,3,156
140145117,323,21,7,1,5,2,10,369
140145118,248,0,11,2,4,1,16,282
140145119,331,12,2,1,1,0,9,356
140145120,485,7,3,4,1,1,8,509
140145121,241,3,1,8,0,0,14,267
140145201,221,14,6,0,1,0,11,253
140145202,328,18,11,5,2,1,29,394
140145203,211,17,4,0,5,1,14,252
140145204,394,6,9,5,0,0,11,425
140145205,157,17,4,1,0,0,12,191
140145206,188,18,3,2,5,0,11,227
140145207,216,14,9,1,0,0,6,246
140145208,210,31,12,2,12,0,13,280
140145209,184,22,4,0,9,0,9,228
140145210,182,23,12,4,5,1,7,234
140145211,148,18,0,0,3,0,6,175
140145212,282,19,0,1,1,0,8,311
140145213,223,11,8,3,6,0,9,260
140145214,236,19,8,2,7,1,2,275
140145215,156,11,3,1,2,0,5,178
140145216,226,24,8,2,7,0,5,272
140145217,205,13,2,0,0,0,7,227
140145218,263,6,0,0,0,0,7,276
140145219,252,11,1,2,1,0,5,272
140145301,240,59,20,4,8,0,10,341
140145302,214,60,13,4,6,2,8,307
140145303,134,38,1,0,1,0,5,179
140145304,163,27,11,2,11,0,16,230
140145305,176,53,56,9,17,1,7,319
140145306,268,49,58,8,15,2,17,417
140145307,215,19,22,1,4,1,13,275
140145308,292,30,19,1,4,2,4,352
140145309,218,22,14,4,1,0,13,272
140145310,274,33,14,1,4,0,12,338
140145311,245,22,8,2,11,1,22,311
140145312,202,18,14,2,12,1,14,263
140145313,179,25,8,1,5,2,4,224
140145314,175,24,9,1,9,1,8,227
140145315,336,95,37,0,3,2,6,479
140145316,159,22,7,3,5,2,5,203
140145317,169,15,3,2,5,5,5,204
140145318,197,15,12,1,1,0,10,236
140145319,197,23,6,0,3,0,5,234
140145320,135,12,6,1,1,1,5,161
140145401,146,17,72,1,17,1,20,274
140145402,175,47,19,2,25,0,10,278
140145403,202,93,16,1,6,2,8,328
140145404,205,74,20,1,8,4,5,317
140145405,135,42,25,0,6,0,4,212
140145406,263,93,24,2,11,0,12,405
140145407,150,69,9,0,7,0,2,237
140145408,168,49,8,1,21,8,18,273
140145409,222,101,42,3,4,2,13,387
140145410,152,51,17,1,2,0,7,230
140145411,114,55,10,0,19,0,4,202
140145412,208,92,36,1,10,4,9,360
140145413,397,181,41,0,22,5,43,689
140145414,252,134,16,58,9,30,35,534
140145415,215,106,26,31,0,1,23,402
140145416,195,80,14,0,0,2,7,298
140145501,221,41,27,1,10,0,9,309
140145502,212,60,41,0,10,4,17,344
140145503,80,11,14,0,13,2,5,125
140145504,121,24,3,0,2,0,7,157
140145505,138,56,8,1,0,0,19,222
140145506,105,56,13,0,11,0,14,199
140145507,146,62,37,0,75,2,19,341
140145508,54,8,40,0,35,0,3,140
140145509,139,63,45,1,48,0,18,314
140145510,154,50,39,0,30,5,16,294
140145511,206,64,19,2,53,5,23,372
140145512,143,47,5,1,27,6,24,253
140145513,125,11,20,0,73,24,3,256
140145514,139,53,9,0,7,5,5,218
140145515,81,27,24,0,0,1,4,137
140145516,198,55,46,0,18,0,9,326
140145517,338,191,30,12,13,5,52,641
140145518,128,44,11,1,1,6,9,200
140145519,268,133,14,0,13,5,18,451
140145601,199,78,11,1,29,1,6,325
140145602,217,71,25,0,16,3,7,339
140145603,209,82,85,1,42,2,13,434
140145604,158,63,29,0,6,0,4,260
140145605,138,26,11,1,2,0,2,180
140145606,146,52,17,0,15,0,26,256
140145607,123,74,26,0,22,0,23,268
140145608,121,47,29,1,6,0,3,207
140145609,138,50,34,1,10,0,6,239
140145610,87,39,17,0,4,1,3,151
140145611,243,54,35,2,3,4,12,353
140145612,89,15,15,2,13,0,12,146
140145613,143,50,22,2,19,4,13,253
140145614,126,41,6,1,45,0,1,220
140145615,126,22,41,0,36,0,0,225
140145616,130,30,20,0,11,0,6,197
140145617,179,56,55,1,25,7,5,328
140145618,203,121,37,1,8,2,6,378
140145619,164,41,4,0,0,1,21,231
140145701,354,89,35,0,20,5,13,516
140145702,217,70,29,0,20,6,19,361
140145703,241,48,20,2,31,6,23,371
140145704,387,136,22,1,166,7,45,764
140145705,149,35,7,1,4,1,15,212
140145706,113,36,4,0,13,0,8,174
140145707,193,80,17,0,13,15,27,345
140145708,70,15,12,0,83,2,3,185
140145709,136,44,7,0,37,4,13,241
140145710,147,60,25,1,73,1,18,325
140145711,171,55,18,2,52,4,10,312
140145712,133,73,18,0,23,1,13,261
140145713,223,68,34,0,67,5,15,412
140145714,259,73,96,0,24,10,12,474
140145715,307,83,37,2,30,8,12,479
140145716,105,24,7,0,17,0,7,160
140145801,136,46,18,0,2,0,3,205
140145802,258,46,68,3,13,4,12,404
140145803,147,61,12,0,12,0,5,237
140145804,219,34,41,2,4,5,15,320
140145805,236,56,17,0,16,3,14,342
140145806,283,60,31,4,11,1,9,399
140145807,192,47,13,0,0,2,36,290
140145808,270,108,57,3,29,3,23,493
140145809,260,91,53,0,15,2,3,424
140145810,117,15,10,0,3,1,3,149
140145811,299,90,76,0,14,1,5,485
140145812,265,54,32,1,14,4,6,376
140145813,90,31,15,1,8,2,54,201
140145901,231,40,11,0,3,0,9,294
140145902,149,51,4,1,2,0,43,250
140145903,284,95,49,0,5,0,3,436
140145904,266,64,24,1,6,4,2,367
140145905,218,21,48,0,3,0,19,309
140145906,216,74,17,0,4,1,12,324
140145907,195,79,12,0,6,2,18,312
140145908,118,32,15,1,19,0,3,188
140145909,208,50,22,4,7,4,19,314
140145910,206,48,14,0,2,3,20,293
140145911,157,20,16,0,9,0,10,212
140145912,314,57,16,0,8,5,14,414
140146001,264,28,8,2,1,1,16,320
140146002,242,26,12,1,4,1,13,299
140146003,204,9,18,1,2,0,26,260
140146004,288,35,40,7,23,3,22,418
140146005,347,55,27,1,18,0,8,456
140146006,252,42,9,3,0,1,13,320
140146007,202,33,9,2,2,0,8,256
140146008,181,45,32,1,6,3,5,273
140146009,260,54,26,2,3,4,19,368
140146010,209,61,6,2,4,1,6,289
140146011,360,54,20,4,9,0,30,477
140146012,161,41,20,2,14,1,5,244
140146013,217,28,9,1,10,2,7,274
140146014,358,54,24,1,3,0,10,450
140146015,328,63,29,5,6,0,20,451
140146016,242,23,15,0,0,1,7,288
140146017,326,37,19,3,7,0,8,400
140146018,304,75,18,6,6,0,13,422
140146101,267,10,5,1,4,0,2,289
140146102,255,10,2,0,0,0,7,274
140146103,213,9,2,2,3,0,10,239
140146104,192,6,1,2,0,0,7,208
140146105,284,5,0,2,0,0,3,294
140146106,218,12,0,0,0,0,5,235
140146107,219,5,2,2,1,0,3,232
140146108,256,11,3,0,0,1,2,273
140146109,221,12,0,0,0,0,5,238
140146110,211,14,6,1,1,0,3,236
140146111,258,7,2,1,0,0,4,272
140146112,427,32,3,5,1,0,2,470
140146113,334,20,0,11,0,0,6,371
140146114,223,4,0,2,0,0,4,233
140146115,239,2,2,5,0,0,6,254
140146201,239,13,5,1,0,0,14,272
140146202,277,40,3,3,11,1,6,341
140146203,254,23,4,2,1,0,9,293
140146204,214,22,5,1,1,1,7,251
140146205,208,13,19,2,4,1,11,258
140146206,244,26,4,5,1,0,10,290
140146207,229,12,1,0,2,0,6,250
140146208,236,25,9,3,1,1,2,277
140146209,321,29,14,1,0,0,7,372
140146210,309,24,9,4,2,1,3,352
140146211,375,27,1,10,0,1,7,421
140146212,292,11,4,4,0,0,9,320
140146213,258,16,4,0,1,0,7,286
140146301,209,18,4,0,7,1,13,252
140146302,215,11,1,0,0,0,9,236
140146303,197,18,4,4,6,1,1,231
140146304,221,14,2,5,1,1,11,255
140146305,351,20,15,3,2,2,12,405
140146306,287,28,11,3,7,0,15,351
140146307,276,21,4,3,4,0,0,308
140146308,267,28,7,5,1,0,8,316
140146309,266,18,8,0,8,0,7,307
140146310,205,30,1,7,2,1,4,250
140146311,202,27,1,1,0,0,1,232
140146312,168,27,2,0,3,1,5,206
140146313,204,11,3,1,1,0,4,224
140146401,205,47,7,0,2,0,4,265
140146402,383,59,18,5,2,3,13,483
140146403,292,66,42,0,4,0,3,407
140146404,322,33,37,2,1,4,7,406
140146405,232,42,5,3,3,0,8,293
140146406,216,40,8,1,5,0,11,281
140146407,350,38,16,4,13,2,16,439
140146408,296,35,5,4,1,0,6,347
140146409,321,31,9,5,6,0,4,376
140146410,305,26,13,7,6,0,12,369
140146411,245,30,9,1,11,0,4,300
140146501,209,23,36,3,20,0,12,303
140146502,308,71,36,2,13,1,13,444
140146503,202,48,25,4,21,1,26,327
140146504,143,18,6,0,6,2,14,189
140146505,207,28,11,5,8,2,8,269
140146506,268,71,8,2,10,0,26,385
140146507,159,13,5,2,3,1,12,195
140146508,144,49,9,3,7,0,9,221
140146509,185,21,4,3,9,0,5,227
140146510,179,18,6,2,9,0,8,222
140146511,260,17,20,1,1,0,4,303
140146512,301,40,14,1,4,1,13,374
140146513,170,25,8,3,7,0,8,221
140146514,365,41,12,2,2,1,14,437
140146515,147,19,7,2,2,0,5,182
140146516,295,26,20,15,0,0,7,363
140146601,303,117,35,0,49,2,13,519
140146602,326,138,30,0,25,1,11,531
140146603,131,64,12,0,15,0,11,233
140146604,232,98,45,0,48,4,13,440
140146605,190,52,15,0,109,6,15,387
140146606,228,87,45,2,37,0,10,409
140146607,240,61,30,0,28,3,19,381
140146608,76,59,5,1,33,0,7,181
140146609,219,103,48,0,14,2,10,396
140146610,160,77,20,0,10,0,13,280
140146611,132,57,35,3,95,1,8,331
140146612,211,89,29,0,38,0,18,385
140146613,164,64,36,0,22,2,7,295
140146614,335,111,94,3,12,2,18,575
140146701,209,109,25,0,99,5,24,471
140146702,99,45,5,1,45,0,21,216
140146703,358,139,42,0,50,3,21,613
140146704,169,66,12,0,15,4,11,277
140146705,206,98,6,0,22,4,69,405
140146706,304,146,45,3,30,4,6,538
140146707,201,46,9,1,34,1,8,300
140146708,255,102,32,1,34,5,33,462
140146709,262,117,20,0,17,1,23,440
140146710,227,150,39,1,31,1,12,461
140146711,462,200,45,5,49,9,19,789
140146801,189,76,13,1,69,5,17,370
140146802,139,40,88,4,158,2,14,445
140146803,310,98,36,0,94,7,12,557
140146804,430,172,26,0,61,4,30,723
140146805,118,56,15,1,18,1,22,231
140146806,253,63,25,0,10,1,13,365
140146807,161,30,29,1,28,3,13,265
140146808,81,24,5,0,13,1,4,128
140146809,269,98,39,3,17,4,19,449
140146810,208,120,27,4,11,2,9,381
140146811,105,20,16,0,5,0,9,155
140146812,165,34,15,0,7,0,8,229
140146813,86,26,3,2,19,0,4,140
140146814,251,103,24,0,47,0,7,432
140146901,227,82,37,0,9,6,8,369
140146902,128,33,10,0,2,3,18,194
140146903,162,67,9,0,19,2,3,262
140146904,217,93,32,0,6,0,13,361
140146905,237,58,20,0,4,1,33,353
140146906,207,32,10,4,8,2,7,270
140146907,198,40,12,1,7,0,7,265
140146908,209,16,2,2,0,0,17,246
140146909,169,46,8,0,4,1,6,234
140146910,175,20,6,15,1,0,6,223
140146911,393,107,81,11,26,2,44,664
140146912,176,69,2,2,22,1,1,273
140146913,85,54,0,0,0,0,0,139
140146914,348,148,43,1,2,1,35,578
140147001,287,157,20,1,15,8,60,548
140147002,266,80,23,1,13,5,9,397
140147003,326,132,17,0,14,8,15,512
140147004,189,58,57,9,7,9,15,344
140147005,335,157,37,0,12,7,42,590
140147006,338,149,38,0,7,4,15,551
140147007,251,103,29,7,3,1,10,404
140147008,268,109,11,1,5,0,13,407
140147009,235,94,15,0,5,2,19,370
140147010,334,150,16,0,10,2,17,529
140147011,212,63,17,0,22,1,6,321
140147101,176,75,9,0,28,4,6,298
140147102,372,153,52,0,16,15,20,628
140147103,281,96,21,1,9,5,40,453
140147104,374,208,27,0,11,4,26,650
140147105,277,167,20,0,2,2,21,489
140147106,358,166,21,2,7,8,42,604
140147107,417,155,47,2,12,3,33,669
140147108,251,137,16,4,3,0,9,420
140147109,407,223,13,2,7,10,31,693
140147110,405,286,57,1,33,4,52,838
140147111,256,125,23,1,4,4,15,428
140147201,606,242,158,5,12,2,75,1100
140147202,707,267,65,0,8,10,57,1114
140147203,632,294,50,0,4,0,29,1009
140147204,565,233,73,3,7,3,41,925
140147205,235,96,24,1,0,3,29,388
140147206,579,248,61,2,7,11,39,947
140147207,670,287,58,3,6,11,34,1069
140147301,181,28,18,4,7,0,15,253
140147302,207,26,6,1,10,0,11,261
140147303,191,17,6,0,2,0,23,239
140147304,226,41,8,1,20,1,6,303
140147305,220,22,10,2,10,0,9,273
140147306,249,19,10,3,14,0,20,315
140147307,153,5,0,0,0,0,2,160
140147308,219,16,10,1,8,0,15,269
140147309,285,42,7,1,8,6,11,360
140147310,182,19,6,1,12,0,7,227
140147311,222,26,24,1,38,0,7,318
140147312,202,32,7,5,15,0,39,300
140147313,212,21,17,5,10,0,12,277
140147401,256,9,0,4,0,0,13,282
140147402,242,15,3,2,1,0,5,268
140147403,195,7,4,10,8,0,7,231
140147404,212,18,6,3,5,0,11,255
140147405,226,14,14,0,5,0,5,264
140147406,318,14,6,4,0,2,8,352
140147407,259,17,7,5,5,0,9,302
140147408,277,8,2,0,0,0,4,291
140147409,235,13,3,1,5,0,3,260
140147410,236,19,8,3,10,0,14,290
140147411,308,28,10,2,3,0,11,362
140147412,326,18,12,1,5,0,17,379
140147413,235,31,15,3,15,0,21,320
140147414,275,21,7,3,3,1,8,318
140147415,280,20,9,1,8,0,9,327
140147416,207,15,9,1,7,0,2,241
140147417,254,5,7,3,4,0,15,288
140147418,245,41,8,1,7,0,12,314
140147501,323,13,0,1,0,0,3,340
140147502,190,10,0,1,0,0,1,202
140147503,242,5,0,1,1,1,2,252
140147504,209,14,2,1,1,0,5,232
140147505,222,16,7,11,0,1,2,259
140147506,293,2,3,1,0,0,4,303
140147507,310,3,2,1,0,0,8,324
140147508,225,15,1,7,0,0,6,254
140147509,277,7,3,0,0,0,5,292
140147510,315,33,12,5,1,0,7,373
140147511,304,31,3,3,3,1,18,363
140147512,217,3,7,4,2,0,9,242
140147513,412,19,6,5,0,1,5,448
140147514,378,16,1,8,0,0,15,418
140147515,386,14,1,2,3,0,16,422
140147516,236,17,11,3,1,0,8,276
140147517,287,28,9,2,3,0,8,337
140147518,294,11,0,3,0,0,2,310
140147519,382,13,3,6,1,0,15,420
140147601,321,26,5,1,11,1,8,373
140147602,295,14,3,0,2,2,4,320
140147603,238,22,10,2,0,0,3,275
140147604,273,8,6,3,5,0,9,304
140147605,275,23,5,0,5,1,6,315
140147606,540,24,0,12,0,0,9,585
140147607,263,15,8,2,2,0,6,296
140147608,249,12,1,1,0,0,2,265
140147609,274,32,3,4,1,0,15,329
140147610,286,25,8,1,6,0,13,339
140147611,281,19,4,2,3,1,6,316
140147612,304,10,1,10,1,0,3,329
140147613,207,12,5,0,1,0,3,228
140147614,265,9,1,0,1,1,10,287
140147615,238,13,16,3,0,0,7,277
140147616,354,17,1,1,0,0,3,376
140147617,300,1,1,0,0,0,17,319
140147701,332,23,11,5,7,0,9,387
140147702,235,19,6,3,1,0,12,276
140147703,231,30,9,0,1,0,24,295
140147704,252,18,3,2,2,0,11,288
140147705,283,26,7,0,2,1,9,328
140147706,251,17,11,2,0,0,2,283
140147707,345,18,7,4,3,2,9,388
140147708,270,7,8,4,4,2,23,318
140147709,255,24,15,3,14,1,7,319
140147710,281,36,7,1,4,0,12,341
140147711,210,13,3,5,2,2,3,238
140147712,260,20,10,1,1,1,9,302
140147713,382,12,6,3,1,0,12,416
140147714,209,26,3,1,0,0,5,244
140147715,286,15,4,0,1,0,3,309
140147716,212,11,5,0,3,0,4,235
140147717,292,30,6,3,0,1,6,338
140147718,229,20,7,2,7,1,3,269
140147719,242,13,6,14,1,0,4,280
140147720,309,22,3,2,4,0,5,345
140147721,180,7,2,2,1,0,2,194
140147722,247,15,10,4,0,2,3,281
140147801,328,24,18,1,12,1,17,401
140147802,177,20,5,2,10,0,18,232
140147803,226,24,10,1,6,1,11,279
140147804,222,5,5,2,2,0,22,258
140147805,225,17,3,2,1,1,2,251
140147806,123,7,1,2,0,0,2,135
140147807,257,26,10,2,3,1,11,310
140147808,271,21,7,1,10,0,13,323
140147809,263,21,12,3,0,0,3,302
140147810,289,25,10,0,4,1,5,334
140147811,378,27,8,2,7,2,14,438
140147812,271,13,3,1,1,0,17,306
140147813,199,17,6,0,6,0,5,233
140147814,416,87,37,144,4,7,26,721
140147815,179,17,8,0,1,0,5,210
140147816,155,25,7,2,4,0,14,207
140147901,297,40,9,2,5,0,9,362
140147902,281,48,19,6,7,1,12,374
140147903,209,25,5,3,5,0,6,253
140147904,199,17,8,5,6,5,8,248
140147905,225,24,5,1,7,2,16,280
140147906,295,28,13,3,8,1,5,353
140147907,315,30,17,4,8,0,9,383
140147908,214,20,4,2,1,1,15,257
140147909,374,39,22,0,0,1,11,447
140147910,223,17,5,5,1,0,8,259
140147911,266,14,5,3,3,0,9,300
140147912,158,10,5,1,0,0,6,180
140147913,229,21,4,4,1,0,5,264
140147914,178,23,6,3,3,0,3,216
140147915,321,28,6,0,1,1,13,370
140147916,274,20,8,6,6,1,3,318
140147917,277,36,9,0,2,0,5,329
140147918,229,19,2,0,8,0,9,267
140147919,224,14,12,5,6,0,17,278
140147920,248,14,12,2,2,1,14,293
140148001,243,94,17,9,8,1,13,385
140148002,216,80,14,0,8,6,16,340
140148003,180,92,1,0,5,0,23,301
140148004,182,94,0,0,3,0,5,284
140148005,239,91,27,1,15,0,4,377
140148006,372,186,27,2,6,0,16,609
140148007,155,56,3,1,2,10,5,232
140148008,153,73,20,2,9,9,10,276
140148009,195,74,2,1,3,0,3,278
140148010,234,72,35,2,5,0,4,352
140148011,192,28,1,2,1,0,21,245
140148012,175,12,7,2,11,1,3,211
140148013,135,27,9,3,1,0,2,177
140148014,128,4,4,2,0,0,9,147
140148101,258,131,4,0,9,1,7,410
140148102,297,151,53,120,9,7,22,659
140148103,583,294,35,1,12,4,33,962
140148104,541,347,61,1,7,3,39,999
140148105,520,198,53,4,11,15,24,825
140148106,671,255,180,0,19,12,35,1172
140148107,224,88,14,2,2,1,20,351
140148108,265,138,17,0,2,7,13,442
140148109,239,113,11,1,6,1,34,405
140148110,183,86,8,0,3,0,11,291
140148201,306,146,58,3,12,4,20,549
140148202,394,149,11,1,10,2,26,593
140148203,317,122,60,0,26,3,10,538
140148204,531,268,41,1,23,7,32,903
140148205,202,94,11,0,0,6,7,320
140148206,149,71,6,0,1,0,30,257
140148207,330,92,14,0,8,2,5,451
140148208,586,233,43,0,10,3,24,899
140148209,304,120,38,6,16,1,17,502
140148210,193,90,43,1,8,0,28,363
140148211,211,71,20,0,4,1,24,331
140148301,259,17,12,4,0,3,7,302
140148302,286,22,17,4,2,0,22,353
140148303,253,40,9,8,1,0,12,323
140148304,228,24,9,1,2,0,5,269
140148305,208,38,3,2,5,1,13,270
140148306,162,16,5,0,1,0,7,191
140148307,280,29,9,2,1,0,16,337
140148308,153,17,2,0,1,0,6,179
140148309,301,59,14,5,5,0,9,393
140148310,177,22,5,2,7,0,10,223
140148311,220,17,9,0,0,0,8,254
140148312,276,27,5,0,0,0,7,315
140148313,216,24,1,3,1,0,6,251
140148314,253,23,2,3,1,0,9,291
140148315,184,17,2,0,2,0,4,209
140148316,159,19,4,5,1,0,6,194
140148401,264,19,5,1,2,0,4,295
140148402,254,14,2,0,1,1,2,274
140148403,260,25,7,7,5,1,6,311
140148404,174,19,5,1,1,0,0,200
140148405,259,38,11,14,2,0,12,336
140148406,172,13,8,2,8,0,11,214
140148407,157,19,4,2,2,0,1,185
140148408,221,33,6,0,0,0,13,273
140148409,223,21,5,3,6,1,7,266
140148410,228,21,6,5,5,0,7,272
140148411,216,39,1,2,3,0,7,268
140148412,250,19,5,0,3,0,7,284
140148501,259,5,3,4,1,0,14,286
140148502,222,26,1,2,0,0,1,252
140148503,212,19,3,1,1,1,3,240
140148504,255,12,5,1,2,0,6,281
140148505,297,20,0,1,1,0,17,336
140148506,314,26,0,1,2,0,14,357
140148507,211,34,2,0,0,0,2,249
140148508,387,15,3,3,2,1,9,420
140148509,374,14,8,2,3,0,3,404
140148510,328,21,6,2,2,1,6,366
140148511,339,17,2,2,2,0,4,366
140148512,270,18,3,3,0,0,13,307
140148513,308,18,6,1,1,0,2,336
140148514,331,21,6,3,0,1,8,370
140148515,200,37,10,3,4,0,2,256
140148516,283,20,9,1,1,1,11,326
140148601,199,8,0,5,0,0,6,218
140148602,151,1,1,1,0,0,1,155
140148603,219,8,2,5,5,0,3,242
140148604,301,25,0,171,1,0,13,511
140148605,334,10,0,2,0,0,9,355
140148606,270,29,2,3,1,0,0,305
140148607,278,10,1,2,1,0,8,300
140148608,235,16,1,6,0,0,12,270
140148609,253,12,0,3,0,0,2,270
140148610,335,15,3,2,1,0,5,361
140148611,201,25,1,0,0,1,1,229
140148612,208,11,8,6,1,0,3,237
140148701,297,37,7,6,1,0,8,356
140148702,266,24,29,1,3,2,19,344
140148703,175,8,4,3,0,0,9,199
140148704,221,21,1,2,1,0,7,253
140148705,382,23,8,6,3,0,8,430
140148706,198,13,4,1,0,0,4,220
140148707,223,27,2,3,1,0,6,262
140148708,369,22,1,0,1,0,1,394
140148709,182,19,2,5,0,0,5,213
140148710,215,6,1,1,1,0,2,226
140148711,267,10,0,1,1,0,3,282
140148712,280,11,3,6,0,0,1,301
140148713,166,5,4,1,1,0,0,177
140148801,232,19,3,1,0,0,6,261
140148802,290,19,8,6,4,0,5,332
140148803,264,22,10,4,1,1,6,308
140148804,242,17,6,0,0,0,10,275
140148805,122,5,3,0,0,0,2,132
140148806,272,19,1,0,0,0,6,298
140148807,291,19,5,1,0,2,2,320
140148808,248,19,3,1,1,1,10,283
140148809,250,12,2,2,0,0,8,274
140148810,271,23,5,3,0,0,16,318
140148811,351,27,2,1,0,0,12,393
140148812,268,10,1,4,0,0,4,287
140148813,272,17,9,28,0,1,8,335
140148814,342,7,0,0,0,1,10,360
140148815,327,36,14,1,0,0,5,383
140148901,245,22,5,0,2,0,14,288
140148902,194,19,1,2,5,0,9,230
140148903,378,17,4,0,6,0,16,421
140148904,358,36,4,6,0,0,6,410
140148905,215,23,3,7,5,1,7,261
140148906,305,15,3,2,2,0,11,338
140148907,256,13,2,2,1,0,4,278
140148908,207,14,3,2,1,0,6,233
140148909,262,13,7,3,1,2,5,293
140148910,226,15,3,1,0,1,4,250
140148911,191,10,2,3,1,1,2,210
140148912,214,9,3,1,0,0,0,227
140148913,254,15,7,3,0,0,1,280
140148914,223,14,5,5,3,0,2,252
140148915,366,22,10,1,1,0,9,409
140148916,378,16,3,4,0,0,3,404
140149001,208,34,16,2,2,0,17,279
140149002,209,22,11,4,12,0,18,276
140149003,170,14,1,3,0,0,16,204
140149004,181,16,10,2,0,0,7,216
140149005,212,13,9,2,3,0,9,248
140149006,263,21,2,3,1,1,4,295
140149007,322,9,2,3,3,0,7,346
140149008,205,30,4,4,4,0,3,250
140149009,251,21,10,26,3,1,9,321
140149010,174,28,4,0,1,0,13,220
140149011,209,13,4,4,12,1,3,246
140149012,255,11,1,3,0,1,14,285
140149013,312,12,0,3,0,0,9,336
140149014,231,35,2,3,5,0,0,276
140149015,265,16,11,6,3,2,8,311
140149101,370,14,4,4,3,1,5,401
140149102,305,42,7,7,2,2,9,374
140149103,244,7,10,2,2,0,8,273
140149104,349,39,6,4,3,0,11,412
140149105,206,30,6,1,5,0,2,250
140149106,324,17,3,1,1,0,8,354
140149107,318,44,25,2,4,1,15,409
140149108,262,45,4,1,0,0,9,321
140149109,191,17,21,1,3,0,9,242
140149110,311,36,35,0,3,3,19,407
140149111,275,34,21,1,2,0,9,342
140149112,299,24,12,1,5,0,8,349
140149113,288,28,9,2,0,0,12,339
140149114,388,16,13,3,5,1,5,431
140149115,295,25,5,6,4,2,6,343
140149116,225,13,2,2,2,0,6,250
140149117,260,22,6,3,2,2,5,300
140149118,296,16,5,0,1,0,7,325
140149119,296,14,2,1,5,0,7,325
140149120,227,39,22,7,3,1,6,305
140149201,294,43,13,1,9,1,14,375
140149202,154,25,10,1,3,0,15,208
140149203,176,25,12,0,3,0,2,218
140149204,216,15,3,3,2,1,6,246
140149205,220,14,27,0,3,0,4,268
140149206,214,9,5,2,1,1,6,238
140149207,179,15,3,1,1,0,8,207
140149208,181,22,5,2,0,0,7,217
140149209,269,42,9,8,4,2,14,348
140149210,247,41,14,4,1,1,6,314
140149211,238,20,6,1,10,1,18,294
140149212,296,62,9,7,5,1,11,391
140149213,157,31,1,0,3,1,11,204
140149214,297,33,8,2,4,0,3,347
140149215,239,36,15,0,6,0,5,301
140149216,263,44,8,1,3,0,6,325
140149217,269,33,11,3,4,0,4,324
140149218,215,44,24,1,4,1,17,306
140149301,233,9,7,3,0,0,6,258
140149302,240,29,0,0,0,0,5,274
140149303,333,25,5,4,2,0,9,378
140149304,379,15,1,4,1,0,9,409
140149305,252,43,4,2,2,0,4,307
140149306,337,11,5,4,1,0,3,361
140149307,268,9,0,4,2,1,0,284
140149308,389,30,8,6,2,1,9,445
140149309,249,21,10,5,0,1,8,294
140149310,333,26,7,3,2,0,3,374
140149311,364,20,5,1,1,0,9,400
140149312,398,17,4,1,0,0,8,428
140149313,214,8,1,1,2,0,6,232
140149314,168,8,13,0,3,0,3,195
140149315,230,20,0,0,0,0,13,263
140149316,230,13,3,5,3,0,2,256
140149317,381,27,5,3,6,2,5,429
140149318,297,28,14,1,0,0,9,349
140149319,289,12,1,1,0,0,8,311
140149320,144,10,2,2,2,1,2,163
140149321,264,44,45,20,0,0,5,378
140149401,280,22,4,4,3,0,5,318
140149402,240,13,9,1,2,0,11,276
140149403,201,7,4,3,1,0,11,227
140149404,417,13,2,3,0,0,3,438
140149405,336,15,3,0,0,0,6,360
140149406,254,15,7,1,0,0,3,280
140149407,377,16,2,1,2,0,3,401
140149408,394,12,0,0,0,0,2,408
140149409,270,11,3,1,0,0,3,288
140149410,225,21,1,3,3,0,0,253
140149411,256,13,2,3,0,2,1,277
140149412,264,8,1,2,0,0,3,278
140149413,245,5,2,1,4,0,1,258
140149414,184,16,3,1,0,0,1,205
140149501,218,13,3,6,9,0,10,259
140149502,230,11,4,2,3,0,6,256
140149503,186,13,4,1,4,0,5,213
140149504,262,10,1,0,0,0,3,276
140149505,298,8,1,0,0,1,4,312
140149506,284,8,0,0,0,0,4,296
140149507,246,9,0,0,0,0,2,257
140149508,324,14,0,1,0,0,5,344
140149509,254,16,5,0,2,0,10,287
140149510,332,34,14,2,5,1,15,403
140149511,221,16,1,6,0,0,6,250
140149512,347,10,1,1,0,0,3,362
140149513,327,8,4,13,1,0,5,358
140149514,345,16,7,2,3,0,3,376
140149601,235,15,2,8,2,0,5,267
140149602,212,19,7,1,1,0,2,242
140149603,315,33,1,1,2,1,7,360
140149604,312,26,9,4,3,1,5,360
140149605,229,24,6,1,0,1,3,264
140149606,192,13,0,1,0,0,2,208
140149607,204,24,9,2,0,0,3,242
140149608,279,28,8,7,3,0,15,340
140149609,257,14,8,4,0,0,10,293
140149610,308,15,7,9,0,1,11,351
140149611,246,10,10,11,1,0,5,283
140149612,305,21,5,1,0,1,3,336
140149613,332,2,4,6,0,0,1,345
140149614,217,18,5,2,0,0,9,251
140149615,214,17,2,5,4,0,8,250
140149616,316,34,8,16,4,0,17,395
140149617,417,14,7,0,0,1,8,447
140149701,400,14,0,2,3,0,6,425
140149702,187,6,2,1,0,0,2,198
140149703,207,16,0,16,0,0,2,241
140149704,177,6,1,1,6,0,6,197
140149705,214,15,2,0,1,0,2,234
140149706,372,13,2,4,2,0,7,400
140149707,281,14,1,3,0,0,7,306
140149708,340,19,2,2,5,1,4,373
140149709,325,35,3,0,0,0,3,366
140149710,296,20,4,2,0,0,7,329
140149711,323,8,4,0,0,0,7,342
140149712,236,9,1,1,2,0,11,260
140149713,179,5,2,3,0,0,4,193
140149714,417,17,2,4,1,0,5,446
140149715,301,27,0,0,0,0,12,340
140149716,210,15,1,2,1,0,4,233
140149717,416,13,1,4,0,0,3,437
140149801,249,18,3,0,1,1,2,274
140149802,314,10,8,1,6,0,5,344
140149803,196,5,0,1,0,0,8,210
140149804,219,7,4,2,0,0,0,232
140149805,147,13,1,5,2,0,7,175
140149806,232,11,2,1,2,0,5,253
140149807,368,15,3,2,0,0,2,390
140149808,210,10,1,7,18,0,2,248
140149809,303,23,8,8,4,0,8,354
140149810,185,19,2,0,2,1,3,212
140149811,209,11,0,5,3,0,5,233
140149812,187,13,4,0,0,0,5,209
140149813,339,26,5,3,0,0,7,380
140149901,306,25,7,6,3,2,10,359
140149902,315,14,6,5,2,0,8,350
140149903,330,26,1,1,0,0,4,362
140149904,205,7,3,4,5,0,6,230
140149905,204,7,0,0,2,0,3,216
140149906,287,7,2,0,0,0,0,296
140149907,224,21,4,1,0,0,3,253
140149908,382,19,6,3,3,0,23,436
140149909,298,15,8,5,4,0,6,336
140149910,296,21,4,3,0,0,7,331
140149911,180,8,2,5,0,0,3,198
140149912,199,14,1,7,0,0,6,227
140149913,366,13,13,5,0,0,2,399
140210101,23,3,0,1,0,24,0,51
140210102,27,8,0,1,0,4,1,41
140210103,52,36,0,0,0,12,4,104
140210104,111,3,1,2,0,37,12,166
140210105,74,4,1,1,0,27,5,112
140210106,175,15,1,11,6,67,10,285
140210107,154,37,3,17,1,101,20,333
140210108,154,19,2,15,1,31,4,226
140210109,170,29,6,16,1,69,13,304
140210110,116,14,6,8,2,102,20,268
140210201,15,2,0,0,0,5,7,29
140210202,26,8,0,1,0,0,9,44
140210203,16,2,0,0,0,5,8,31
140210204,49,13,0,2,0,2,16,82
140210205,94,13,2,2,0,34,16,161
140210206,86,115,1,5,0,73,26,306
140210207,149,22,4,6,0,56,15,252
140210208,98,5,1,12,0,60,4,180
140210209,199,32,10,6,18,66,13,344
140210210,119,11,4,14,0,85,11,244
140210211,88,34,3,8,0,80,6,219
140210212,121,11,0,13,6,44,7,202
140210213,141,6,3,7,5,7,6,175
140210301,46,9,4,6,1,1,2,69
140210302,115,6,3,3,0,2,8,137
140210303,175,12,3,1,1,1,5,198
140210304,210,6,4,6,1,1,6,234
140210305,119,6,2,8,2,1,10,148
140210306,108,12,1,0,0,2,1,124
140210307,44,1,1,0,0,3,4,53
140210308,101,1,0,1,1,9,14,127
140210309,166,19,2,2,0,1,2,192
140210310,100,15,1,6,0,7,13,142
140210311,116,9,0,2,0,4,4,135
140210312,110,8,0,4,0,6,0,128
140210313,95,7,0,0,0,0,6,108
140210314,259,4,0,4,0,0,4,271
140210315,229,8,1,19,2,0,14,273
140210316,199,0,2,19,1,0,3,224
140210401,88,7,1,1,0,0,9,106
140210402,78,7,1,1,1,1,17,106
140210403,110,6,0,0,0,1,5,122
140210404,93,13,3,5,2,1,3,120
140210405,85,6,0,0,0,1,3,95
140210406,267,15,7,3,1,2,5,300
140210407,283,7,3,10,1,1,9,314
140210408,83,4,0,1,0,0,5,93
140210409,351,11,8,21,2,5,6,404
140210410,238,14,3,11,0,0,10,276
140210501,43,9,0,2,1,8,4,67
140210502,81,13,2,10,0,2,8,116
140210503,13,6,1,0,0,0,1,21
140210504,43,4,0,97,0,1,7,152
140210505,48,8,11,5,2,7,1,82
140210506,121,8,2,9,0,3,2,145
140210507,217,27,9,30,0,2,11,296
140210508,232,8,7,33,1,2,5,288
140210601,66,26,0,0,0,7,2,101
140210602,25,4,1,4,0,12,7,53
140210603,24,3,0,0,0,19,1,47
140210604,48,11,0,10,0,8,8,85
140210605,79,4,0,0,0,7,5,95
140210606,18,0,0,0,0,0,1,19
140210607,55,9,0,0,0,4,6,74
140210608,223,6,0,2,0,0,0,231
140210609,281,26,7,2,1,1,13,331
140210610,159,7,2,1,3,1,9,182
140210611,399,53,11,10,4,2,4,483
140210612,359,27,7,3,0,1,13,410
140210613,248,26,2,12,0,1,11,300
140210614,413,21,3,16,0,2,4,459
140210615,402,30,3,6,0,1,7,449
140210616,305,18,8,8,0,2,5,346
140210701,62,23,1,4,0,1,8,99
140210702,157,8,3,9,0,8,11,196
140210703,87,0,0,0,0,0,8,95
140210704,147,9,0,1,0,0,6,163
140210705,350,27,3,6,1,0,8,395
140210706,289,20,3,17,1,0,8,338
140210707,266,18,9,8,3,0,10,314
140210708,260,12,3,12,0,0,3,290
140210709,225,4,0,0,0,0,1,230
140210710,187,5,0,0,0,0,1,193
140210711,232,15,3,2,3,0,5,260
140210712,187,12,2,1,1,1,2,206
140210713,53,4,8,0,0,1,1,67
140210714,146,4,0,1,0,0,2,153
140210715,264,7,1,5,0,0,5,282
140210716,154,7,2,23,0,0,4,190
140210801,42,6,2,0,1,0,0,51
140210802,135,6,2,1,0,5,4,153
140210803,339,5,0,3,0,1,3,351
140210804,263,16,0,8,0,0,0,287
140210805,271,8,3,3,0,0,3,288
140210806,118,11,2,10,0,1,2,144
140210807,295,17,3,15,0,0,10,340
140210808,221,8,2,5,1,0,3,240
140210809,346,15,6,8,2,0,5,382
140210810,207,12,1,7,3,0,7,237
140210811,217,9,1,8,3,0,3,241
140210812,219,16,4,3,3,0,5,250
140210813,236,28,0,6,1,1,1,273
140210814,251,17,2,5,2,1,5,283
140210901,235,20,4,16,1,0,7,283
140210902,237,22,10,1,0,1,0,271
140210903,212,12,1,18,1,1,6,251
140210904,195,7,2,5,1,2,2,214
140210905,182,32,3,3,16,1,13,250
140210906,255,10,4,6,0,0,3,278
140210907,193,28,4,3,14,2,5,249
140210908,163,34,4,2,15,0,7,225
140210909,194,18,3,2,12,0,31,260
140210910,257,19,2,7,0,0,3,288
140210911,365,19,5,3,0,0,14,406
140210912,190,16,4,0,1,0,5,216
140210913,262,18,9,2,1,1,7,300
140210914,312,14,4,3,13,2,10,358
140211001,380,22,4,4,1,0,7,418
140211002,265,13,2,1,0,2,2,285
140211003,289,42,2,4,14,1,20,372
140211004,352,47,7,1,4,0,11,422
140211005,201,27,2,3,1,2,5,241
140211006,309,18,15,23,1,1,13,380
140211007,169,23,0,5,3,0,4,204
140211008,272,16,3,0,0,0,1,292
140211009,230,22,4,5,22,0,13,296
140211010,300,27,12,1,12,0,9,361
140211011,331,22,1,2,0,0,7,363
140211012,402,10,0,0,2,0,4,418
140211013,339,11,0,1,6,0,9,366
140211014,414,32,4,7,0,0,4,461
140211015,120,7,2,0,0,1,0,130
140211016,222,2,0,1,0,0,3,228
140211101,221,14,1,19,0,0,2,257
140211102,245,8,1,2,0,0,3,259
140211103,199,9,1,3,1,2,3,218
140211104,236,9,3,8,0,0,4,260
140211105,250,26,2,6,3,0,9,296
140211106,114,13,0,1,2,0,3,133
140211107,251,14,11,17,7,1,4,305
140211108,264,20,6,12,2,0,3,307
140211109,371,30,6,5,1,2,8,423
140211110,177,12,5,10,0,5,9,218
140211111,196,13,4,23,0,1,5,242
140211112,370,18,11,12,1,3,5,420
140211113,276,19,4,13,1,2,5,320
140211114,215,10,4,15,1,2,10,257
140211115,211,16,2,5,0,5,2,241
140211116,218,17,16,8,0,1,3,263
140211117,263,17,4,10,1,2,4,301
140211118,337,11,4,14,0,0,1,367
140211119,291,20,4,4,1,1,7,328
140211201,181,16,4,16,1,43,4,265
140211202,160,32,2,14,0,11,10,229
140211203,268,22,10,17,0,49,23,389
140211204,222,22,7,30,1,23,11,316
140211205,207,26,8,15,1,22,21,300
140211206,226,15,6,14,1,11,3,276
140211207,194,11,2,7,0,4,7,225
140211208,135,19,4,8,2,53,6,227
140211209,134,4,2,2,5,30,8,185
140211210,246,28,9,1,7,18,21,330
140211211,250,30,3,10,0,53,6,352
140211212,181,23,4,19,0,5,9,241
140211213,192,28,11,21,0,25,14,291
140211214,265,24,19,7,4,24,31,374
140211301,229,31,7,10,0,64,25,366
140211302,154,12,6,5,0,19,3,199
140211303,178,24,7,24,0,41,8,282
140211304,169,21,8,14,1,40,13,266
140211305,287,30,7,24,2,25,18,393
140211306,196,19,6,11,3,19,24,278
140211307,166,22,6,8,0,16,3,221
140211308,329,21,9,2,1,8,13,383
140211309,177,26,5,8,0,6,2,224
140211310,227,29,5,3,3,7,10,284
140211311,194,25,9,0,0,3,8,239
140211312,199,25,6,12,2,9,14,267
140211313,251,23,15,6,13,14,21,343
140211314,276,23,3,4,3,20,13,342
140211401,206,31,5,10,2,8,6,268
140211402,164,34,6,4,4,12,8,232
140211403,191,10,16,2,1,13,5,238
140211404,288,18,8,17,3,8,3,345
140211405,273,24,4,7,0,8,7,323
140211406,225,26,0,13,0,3,4,271
140211407,357,29,19,12,2,17,9,445
140211408,204,13,8,5,0,16,25,271
140211409,200,39,7,10,0,9,13,278
140211410,232,18,2,7,2,15,5,281
140211411,276,14,12,9,1,12,10,334
140211412,215,21,7,4,2,12,7,268
140211501,207,47,6,8,0,41,6,315
140211502,245,49,1,12,1,28,12,348
140211503,197,29,9,15,1,11,6,268
140211504,254,21,7,8,6,7,14,317
140211505,193,18,3,2,2,3,5,226
140211506,278,28,14,4,1,3,12,340
140211507,208,6,4,7,0,4,5,234
140211508,107,12,2,23,0,23,7,174
140211509,160,22,5,14,0,21,13,235
140211510,191,7,1,10,0,9,5,223
140211511,194,18,3,5,2,4,18,244
140211601,269,14,3,10,2,7,14,319
140211602,371,25,6,19,0,13,17,451
140211603,218,20,6,2,2,5,9,262
140211604,239,19,1,4,1,1,9,274
140211605,225,19,3,8,0,4,8,267
140211606,230,29,3,4,0,6,14,286
140211607,259,20,1,2,6,1,12,301
140211608,239,29,10,3,1,7,5,294
140211609,217,11,4,11,3,14,13,273
140211610,214,23,5,7,0,7,8,264
140211611,330,31,10,18,1,14,14,418
140211701,225,12,13,27,5,3,5,290
140211702,218,25,9,37,0,8,4,301
140211703,195,13,3,43,1,4,0,259
140211704,221,22,7,9,1,2,3,265
140211705,188,13,6,5,1,12,4,229
140211706,298,34,14,25,6,8,14,399
140211707,294,17,9,26,0,7,8,361
140211708,382,18,8,13,2,8,14,445
140211709,387,32,4,22,0,6,11,462
140211710,315,29,8,17,3,5,3,380
140211801,228,0,9,14,1,5,2,259
140211802,192,1,5,6,0,1,6,211
140211803,181,3,4,8,0,0,11,207
140211804,276,0,8,1,27,3,17,332
140211805,285,1,26,6,4,1,6,329
140211806,203,0,6,5,2,1,3,220
140211807,216,2,3,29,0,0,3,253
140211808,231,9,0,1,0,1,0,242
140211809,260,3,3,11,0,2,5,284
140211810,275,1,3,6,4,4,7,300
140211811,223,1,4,10,1,2,4,245
140211812,373,7,9,5,2,1,13,410
140211813,375,5,7,18,2,2,9,418
140211814,217,24,9,24,2,2,8,286
140211815,321,20,35,5,10,7,6,404
140211816,297,23,6,5,1,1,11,344
140211901,228,27,5,7,0,6,10,283
140211902,263,14,3,6,2,3,12,303
140211903,168,18,7,2,1,10,10,216
140211904,159,19,7,13,0,4,6,208
140211905,188,15,13,11,0,3,2,232
140211906,196,30,6,2,9,6,9,258
140211907,164,15,4,8,1,0,3,195
140211908,151,18,5,2,1,2,1,180
140211909,239,17,5,18,1,2,8,290
140211910,300,23,13,17,7,3,10,373
140211911,279,30,19,4,0,0,13,345
140211912,200,17,2,8,3,0,3,233
140211913,207,16,3,19,2,1,3,251
140212001,169,6,0,1,0,0,6,182
140212002,170,11,0,9,0,0,28,218
140212003,302,22,7,12,7,0,6,356
140212004,231,9,3,7,0,0,2,252
140212005,298,16,1,18,1,3,3,340
140212006,188,2,0,2,0,2,3,197
140212007,279,13,1,1,0,1,1,296
140212008,223,9,2,1,0,2,1,238
140212009,196,12,2,2,0,1,1,214
140212010,198,12,3,0,0,0,2,215
140212011,184,29,5,3,1,2,3,227
140212012,235,18,10,1,2,1,6,273
140212013,236,20,12,2,0,1,5,276
140212014,320,23,3,9,2,0,4,361
140212015,296,39,3,4,2,3,13,360
140212016,183,10,2,3,0,3,3,204
140212017,182,18,6,2,3,1,7,219
140212018,264,10,0,5,0,1,2,282
140212101,256,19,7,46,1,4,8,341
140212102,170,13,1,8,0,0,2,194
140212103,176,17,1,10,0,5,2,211
140212104,52,3,0,4,0,0,12,71
140212105,239,8,6,2,0,1,5,261
140212106,265,10,7,10,1,1,13,307
140212107,208,8,2,4,1,0,15,238
140212108,202,25,7,0,0,2,4,240
140212109,189,14,1,2,0,0,3,209
140212110,294,30,4,25,2,1,1,357
140212111,90,14,2,6,0,13,7,132
140212112,152,12,1,9,1,34,13,222
140212113,260,8,3,7,0,0,5,283
140212114,186,8,2,5,0,0,4,205
140212115,171,6,1,2,0,0,5,185
140212116,269,13,1,16,1,0,7,307
140212117,145,9,3,4,5,0,4,170
140212118,352,11,4,9,0,2,8,386
140212119,171,23,2,54,0,4,5,259
140212120,187,5,27,92,0,1,2,314
140280101,24,2,0,0,0,0,6,32
140280102,139,15,0,1,0,0,1,156
140280103,92,14,0,2,0,4,5,117
140280104,235,10,2,9,0,6,54,316
140280105,161,4,0,0,0,1,39,205
140280106,69,9,0,2,0,0,12,92
140280107,26,8,0,1,1,1,11,48
140280108,101,6,0,5,1,0,30,143
140280109,193,13,2,5,6,10,34,263
140280110,339,0,0,0,0,0,0,339
140280111,253,19,2,3,3,4,17,301
140280201,366,0,0,6,0,0,4,376
140280202,258,15,6,7,0,4,5,295
140280203,256,23,4,10,1,1,3,298
140280204,438,26,2,4,0,2,4,476
140280205,213,11,4,4,0,1,7,240
140280206,195,23,3,6,4,2,9,242
140280207,217,31,5,4,12,4,4,277
140280208,315,30,6,9,4,3,6,373
140280209,292,38,9,8,3,3,7,360
140280210,224,7,2,3,0,0,5,241
140280211,349,16,6,9,2,1,10,393
140280212,318,27,7,7,1,0,10,370
140280213,304,18,4,5,0,1,8,340
140280214,306,42,5,0,1,0,0,354
140280215,353,21,2,12,2,0,13,403
140280216,364,32,6,20,2,2,4,430
140280301,258,15,0,6,0,1,8,288
140280302,311,38,6,7,4,0,10,376
140280303,311,29,6,5,6,3,8,368
140280304,342,40,4,2,8,1,25,422
140280305,313,26,8,3,0,0,3,353
140280306,233,24,19,6,7,3,14,306
140280307,245,30,7,4,12,0,6,304
140280308,224,48,23,5,45,1,13,359
140280309,287,37,6,3,3,0,3,339
140280310,280,16,7,5,3,4,6,321
140280311,287,29,5,7,0,0,5,333
140280312,149,12,1,12,0,0,4,178
140280401,24,12,0,1,0,0,2,39
140280402,99,10,0,0,0,1,19,129
140280403,110,4,0,0,0,9,3,126
140280404,117,25,0,2,0,13,17,174
140280405,77,12,0,5,0,5,37,136
140280406,191,23,1,4,4,2,21,246
140280407,209,28,6,6,10,4,10,273
140280408,205,32,0,3,0,0,14,254
140280409,264,10,4,4,2,9,8,301
140280410,214,10,4,4,0,11,8,251
140280501,149,3,0,3,0,0,9,164
140280502,134,6,0,2,0,4,7,153
140280503,46,8,0,0,0,9,9,72
140280504,113,3,1,3,1,6,35,162
140280505,242,25,2,8,1,10,13,301
140280506,280,2,1,0,0,1,8,292
140280507,264,5,2,2,0,1,3,277
140280508,256,7,6,4,1,1,5,280
140280509,219,19,7,6,0,7,3,261
140280510,225,18,3,4,0,6,10,266
140280511,209,1,0,1,0,1,27,239
140280512,210,18,1,6,0,3,8,246
140280513,208,6,4,4,0,3,19,244
140280514,388,34,5,14,0,14,19,474
140280515,110,8,2,1,4,11,5,141
140280601,21,9,0,0,0,1,3,34
140280602,95,26,2,4,0,7,22,156
140280603,144,23,2,2,0,10,16,197
140280604,55,13,0,0,0,0,13,81
140280605,19,7,1,0,0,0,4,31
140280606,193,35,9,7,0,25,7,276
140280607,278,55,17,17,0,40,21,428
140280701,55,43,0,1,0,0,7,106
140280702,57,15,0,0,0,1,12,85
140280703,32,7,0,0,0,1,7,47
140280704,13,1,0,0,0,1,72,87
140280705,23,0,0,1,0,9,3,36
140280706,77,1,0,3,1,35,29,146
140350101,19,0,0,0,0,0,1,20
140350102,14,0,0,0,0,4,5,23
140350103,50,10,0,0,0,2,6,68
140350104,31,26,0,0,0,0,1,58
140350105,24,11,0,0,0,0,0,35
140350106,46,2,0,0,0,2,4,54
140350107,119,26,4,7,6,1,3,166
140350108,357,50,1,18,0,2,21,449
140350109,295,28,6,16,8,1,5,359
140350110,214,21,5,13,1,1,9,264
140350201,23,3,0,0,1,0,3,30
140350202,34,11,0,0,0,0,0,45
140350203,20,11,0,0,0,1,11,43
140350204,18,10,0,0,0,1,1,30
140350205,19,12,0,0,0,0,1,32
140350206,103,26,0,1,2,0,4,136
140350207,22,7,0,0,1,2,8,40
140350208,35,4,1,0,0,0,9,49
140350209,22,5,0,1,0,4,13,45
140350210,199,29,2,5,0,0,12,247
140350211,204,33,2,15,1,3,11,269
140350212,359,29,7,5,2,3,16,421
140350213,334,31,5,7,3,1,13,394
140350214,277,27,2,0,2,1,11,320
140350215,307,32,8,4,1,1,5,358
140350301,38,14,0,0,0,3,9,64
140350302,18,26,0,0,0,0,0,44
140350303,84,14,0,0,0,9,14,121
140350304,72,4,0,0,0,0,35,111
140350305,75,6,0,0,0,0,5,86
140350306,66,8,0,0,0,0,12,86
140350307,183,24,1,0,0,2,10,220
140350308,42,9,0,0,0,0,8,59
140350309,47,11,0,0,0,0,0,58
140350310,159,25,1,4,1,1,2,193
140350311,290,19,1,3,0,1,5,319
140350312,279,11,5,6,4,1,3,309
140350313,247,31,3,9,1,4,3,298
140350314,227,21,1,0,0,1,2,252
140350315,293,22,3,8,1,0,8,335
140350316,266,19,3,1,1,0,2,292
140350317,366,28,1,4,0,6,15,420
140350318,358,42,4,16,7,4,21,452
140350401,28,21,0,0,0,2,2,53
140350402,57,3,0,0,0,4,17,81
140350403,73,8,0,1,0,4,54,140
140350404,215,17,5,3,0,1,4,245
140350405,245,15,6,2,1,0,3,272
140350406,337,28,0,2,2,1,12,382
140350407,263,23,9,8,1,1,14,319
140350408,190,11,14,4,5,5,9,238
140350409,235,13,2,14,1,2,3,270
140350410,202,36,2,2,3,0,4,249
140350411,185,19,8,1,4,0,6,223
140350412,258,17,4,2,3,3,10,297
140350413,246,26,5,0,2,0,11,290
140350414,289,16,3,8,1,0,5,322
140350415,288,9,1,1,0,0,3,302
140350501,13,2,0,0,0,1,4,20
140350502,46,13,0,0,0,0,4,63
140350503,33,15,0,0,0,1,5,54
140350504,47,18,0,0,0,3,0,68
140350505,38,14,0,0,0,0,15,67
140350506,35,9,0,1,0,1,3,49
140350507,16,0,0,0,0,0,11,27
140350508,229,31,4,4,1,0,2,271
140350509,206,20,1,1,0,0,4,232
140350510,220,13,0,8,0,4,5,250
140350511,253,21,8,9,8,0,14,313
140350512,369,35,5,11,1,1,9,431
140350513,280,26,3,3,1,1,10,324
140350514,189,19,6,2,0,0,10,226
140420101,41,0,0,1,0,0,30,72
140420102,30,5,0,0,0,0,15,50
140420103,57,1,0,0,0,0,13,71
140420104,36,10,0,1,0,0,1,48
140420105,89,13,0,0,0,2,7,111
140420106,39,1,0,0,0,1,17,58
140420107,63,1,0,0,0,0,15,79
140420108,82,0,0,0,0,7,17,106
140420109,340,56,2,24,0,5,7,434
140420110,227,13,8,3,4,5,8,268
140420111,269,4,1,9,1,3,16,303
140420112,133,7,1,4,2,3,7,157
140420201,35,5,0,0,0,6,7,53
140420202,62,25,1,0,0,1,9,98
140420203,46,4,0,0,0,8,2,60
140420204,29,2,0,0,0,1,17,49
140420205,86,6,0,3,1,0,20,116
140420206,29,4,0,0,0,1,5,39
140420207,43,3,0,1,0,4,3,54
140420208,126,11,0,0,0,6,25,168
140420209,116,23,1,1,7,0,12,160
140420210,220,12,0,10,0,1,26,269
140420301,93,0,0,0,0,4,7,104
140420302,79,0,0,0,0,4,24,107
140420303,57,0,0,0,0,5,4,66
140420304,52,0,0,0,0,16,11,79
140420305,55,1,0,10,0,2,10,78
140420306,10,0,0,0,0,0,4,14
140420307,134,2,1,0,1,0,20,158
140420308,151,20,2,22,1,13,23,232
140420309,257,20,8,16,0,1,8,310
140420310,323,23,6,13,0,2,13,380
140420311,265,29,4,8,22,1,9,338
140420312,120,6,1,3,0,0,5,135
140420313,418,36,4,9,0,0,12,479
140420314,390,24,7,8,2,2,14,447
140420401,312,18,4,5,2,12,9,362
140420402,232,11,11,1,3,0,7,265
140420403,228,8,7,1,2,3,8,257
140420404,380,33,9,9,20,0,20,471
140420405,355,7,13,4,8,0,18,405
140420406,320,17,6,26,0,0,16,385
140420407,321,10,3,13,0,0,14,361
140420408,309,25,8,2,7,2,10,363
140420409,254,21,4,2,3,0,6,290
140420410,279,17,3,1,3,0,11,314
140420411,333,16,3,8,0,2,12,374
140420412,275,20,5,1,1,0,5,307
140420413,332,15,6,18,2,0,11,384
140420414,219,15,5,5,2,0,8,254
140420415,370,10,3,11,0,1,15,410
140420416,194,7,4,5,0,0,0,210
140420417,211,15,0,2,0,3,5,236
140420418,283,21,4,22,1,4,4,339
140420419,192,24,3,21,1,48,30,319
140420501,23,0,0,0,0,1,5,29
140420502,24,9,0,0,0,0,22,55
140420503,22,0,0,0,0,0,25,47
140420504,38,17,0,0,0,0,4,59
140420505,28,6,0,0,0,0,11,45
140420506,29,2,0,0,0,2,4,37
140420507,40,2,0,0,0,7,11,60
140420508,75,14,0,0,0,1,14,104
140420509,54,0,0,1,0,1,17,73
140420510,172,15,1,2,2,0,3,195
140420511,171,8,3,2,0,1,7,192
140420512,220,12,2,7,0,0,0,241
140420513,202,13,2,0,1,1,4,223
140420514,259,10,5,4,1,1,5,285
140420515,182,10,3,4,1,5,7,212
140420516,195,9,11,6,2,3,5,231
140420517,315,2,2,2,0,1,2,324
140420601,248,23,7,4,1,7,12,302
140420602,230,18,4,4,2,0,6,264
140420603,331,34,5,5,6,3,10,394
140420604,308,44,62,10,7,1,7,439
140420605,274,57,34,3,5,1,17,391
140420606,329,49,6,3,2,2,14,405
140420607,217,63,19,5,11,0,11,326
140420608,421,54,31,8,2,0,3,519
140420609,275,42,13,7,7,0,16,360
140420610,204,73,5,6,6,1,11,306
140420611,294,78,34,3,97,0,12,518
140420612,174,62,38,2,17,3,6,302
140420613,299,80,96,4,42,10,21,552
140420614,281,95,22,5,20,1,52,476
140420615,307,32,0,6,0,0,3,348
140420616,379,17,4,12,3,0,14,429
140420617,281,49,21,4,7,0,3,365
140420618,202,23,2,2,0,0,2,231
140420619,170,45,11,3,3,1,20,253
140420620,175,77,9,0,29,0,15,305
140420621,398,9,4,7,1,0,45,464
140420701,336,10,7,4,0,0,9,366
140420702,315,22,7,2,0,0,14,360
140420703,395,32,5,3,0,0,8,443
140420704,287,24,4,4,6,2,9,336
140420705,371,73,21,2,5,1,27,500
140420706,246,28,19,3,2,0,17,315
140420707,309,52,15,3,3,0,1,383
140420708,305,28,9,0,2,0,15,359
140420709,306,15,9,2,0,0,7,339
140420710,325,11,6,2,1,0,2,347
140420711,558,35,7,2,0,1,4,607
140420712,253,22,2,8,0,0,24,309
140420713,243,34,7,4,3,2,7,300
140420714,166,67,10,4,1,1,14,263
140420715,306,30,3,1,2,0,0,342
140420801,220,67,22,3,22,0,11,345
140420802,155,46,9,2,20,1,12,245
140420803,321,123,13,3,18,5,19,502
140420804,172,46,11,4,13,0,10,256
140420805,293,57,15,0,17,0,22,404
140420806,227,15,10,21,2,0,14,289
140420807,279,18,7,2,5,0,19,330
140420808,210,33,26,5,14,1,14,303
140420809,279,11,13,3,3,2,4,315
140420810,318,40,22,8,1,0,11,400
140420811,214,53,14,2,7,0,13,303
140420812,323,40,10,0,1,1,3,378
140420813,175,19,8,5,0,0,1,208
140420814,250,21,15,9,5,4,5,309
140420815,278,19,14,4,3,1,10,329
140420816,274,20,2,8,1,0,16,321
140420817,187,14,3,2,2,1,13,222
140420818,274,17,3,1,0,2,3,300
140420819,399,23,5,20,0,16,14,477
140420820,202,81,9,1,9,0,9,311
140420821,183,44,31,7,13,0,7,285
140420822,191,24,10,0,0,0,3,228
140420823,233,19,9,10,1,0,3,275
140420901,236,9,0,4,0,1,12,262
140420902,299,26,12,5,3,0,6,351
140420903,249,7,2,6,0,2,12,278
140420904,221,15,4,15,4,2,4,265
140420905,309,25,11,39,0,27,15,426
140420906,313,27,2,7,0,2,11,362
140420907,200,13,2,6,0,7,1,229
140420908,205,17,21,2,3,0,6,254
140420909,369,43,19,10,13,3,17,474
140420910,206,46,19,8,9,1,7,296
140420911,180,36,45,2,2,0,10,275
140420912,119,27,13,7,40,0,27,233
140420913,241,44,45,2,4,3,22,361
140420914,315,34,11,9,16,0,23,408
140420915,247,27,8,4,3,1,35,325
140420916,264,13,6,6,1,11,16,317
140420917,244,41,14,8,5,3,8,323
140420918,230,25,5,15,0,0,2,277
140420919,286,20,17,6,4,1,6,340
140420920,252,15,0,1,1,0,7,276
140420921,251,16,6,5,7,0,8,293
140420922,195,23,6,1,3,0,3,231
140420923,189,34,24,2,19,1,19,288
140420924,211,28,13,5,17,0,4,278
140420925,214,28,22,4,20,2,18,308
140421001,49,6,5,0,1,1,9,71
140421002,44,2,0,2,0,0,29,77
140421003,3,0,0,0,0,3,3,9
140421004,26,4,0,0,0,3,39,72
140421005,39,5,0,0,0,0,16,60
140421006,25,1,0,0,0,0,12,38
140421007,27,3,0,0,0,1,17,48
140421008,222,5,9,3,4,3,17,263
140421009,271,6,3,5,6,0,17,308
140421010,228,18,0,3,1,2,4,256
140421011,165,8,3,6,2,0,7,191
140421012,274,10,3,5,4,3,17,316
140421013,214,8,3,4,0,1,9,239
140421014,212,5,3,8,1,1,7,237
140421015,269,21,4,11,0,0,3,308
140421016,342,31,7,4,2,0,15,401
140421101,225,13,1,7,5,3,24,278
140421102,222,8,3,7,0,0,23,263
140421103,237,12,7,9,0,1,4,270
140421104,248,10,1,0,0,0,3,262
140421105,317,38,26,14,1,1,4,401
140421106,209,15,4,7,1,0,13,249
140421107,416,27,5,17,0,0,9,474
140421108,380,37,2,6,3,1,15,444
140421109,356,27,12,15,1,1,7,419
140421110,276,26,10,7,1,0,8,328
140421111,290,19,6,2,0,1,6,324
140421112,290,28,5,4,1,0,6,334
140421113,195,33,6,5,0,1,5,245
140490101,39,3,0,0,0,0,1,43
140490102,46,15,0,1,0,3,8,73
140490103,61,15,1,1,2,4,5,89
140490104,37,12,0,1,0,1,8,59
140490105,49,15,0,0,0,0,0,64
140490106,23,4,0,0,0,0,1,28
140490107,24,13,0,0,0,0,3,40
140490108,58,25,0,1,0,6,15,105
140490109,105,27,1,2,0,9,16,160
140490110,18,0,0,0,0,7,1,26
140490111,119,13,6,4,0,7,7,156
140490112,121,13,4,5,0,23,27,193
140490113,302,54,0,7,4,3,12,382
140490114,223,31,2,9,1,3,5,274
140490115,179,25,2,24,2,10,14,256
140490116,336,40,4,13,1,4,23,421
140490201,196,8,2,0,0,0,71,277
140490202,45,4,0,2,0,12,15,78
140490203,34,1,0,0,0,12,2,49
140490204,81,33,0,3,4,26,10,157
140490205,24,10,0,2,0,1,16,53
140490206,26,0,1,1,0,11,1,40
140490207,51,4,1,6,0,28,9,99
140490208,9,5,3,0,0,0,4,21
140490209,25,41,0,0,0,20,13,99
140490210,49,10,0,0,0,60,9,128
140490211,126,7,2,1,0,10,27,173
140490212,28,0,0,0,2,3,6,39
140490213,66,18,0,3,1,12,7,107
140490214,141,15,0,1,1,0,6,164
140490215,83,5,6,7,0,6,5,112
140490301,161,15,0,4,1,1,6,188
140490302,167,12,0,4,0,0,1,184
140490303,297,27,4,2,2,1,9,342
140490304,159,17,1,10,0,1,14,202
140490305,216,2,4,6,0,1,15,244
140490306,158,11,0,2,1,2,2,176
140490307,259,15,2,0,0,1,9,286
140490308,224,23,8,5,2,3,6,271
140490309,301,30,9,3,5,2,16,366
140490310,226,38,11,3,9,2,5,294
140490311,319,25,4,12,1,5,16,382
140490312,257,23,1,9,0,1,15,306
140490313,216,29,2,6,0,4,14,271
140490314,190,20,4,4,1,0,5,224
140490315,120,25,3,0,6,0,25,179
140490316,208,17,2,2,0,0,2,231
140490317,190,22,3,6,4,1,2,228
140490318,218,36,4,1,0,0,16,275
140490319,349,32,5,9,1,2,11,409
140490320,285,29,5,11,3,4,13,350
140490321,208,7,5,2,0,2,9,233
140490322,309,40,3,7,0,0,2,361
140490323,207,18,2,2,0,4,5,238
140490324,158,16,3,7,0,1,3,188
140490325,263,25,2,12,2,6,9,319
140560101,68,16,0,0,0,1,4,89
140560102,64,20,1,0,0,1,20,106
140560103,56,3,0,3,0,4,13,79
140560104,368,29,3,5,0,0,5,410
140560105,385,17,0,7,0,1,7,417
140560106,347,34,3,21,0,2,7,414
140560107,281,16,2,9,5,3,14,330
140560108,325,14,5,6,1,0,4,355
140560109,252,13,5,5,1,0,7,283
140560110,267,12,5,6,1,2,11,304
140560111,234,31,9,5,2,0,4,285
140560112,234,19,4,2,6,4,15,284
140560113,303,31,12,10,6,0,6,368
140560114,221,12,0,4,0,0,6,243
140560115,191,26,5,16,1,1,5,245
140560116,232,16,1,2,3,1,8,263
140560117,350,30,0,8,2,4,11,405
140560118,245,16,3,22,1,3,4,294
140560201,36,3,0,0,0,0,13,52
140560202,20,16,0,0,0,0,1,37
140560203,9,14,0,0,0,0,0,23
140560204,206,16,0,1,1,0,1,225
140560205,299,26,4,1,0,0,0,330
140560206,300,31,3,3,8,2,9,356
140560207,150,27,13,4,10,1,14,219
140560208,228,7,0,1,3,1,4,244
140560209,248,22,4,6,1,1,6,288
140560210,328,29,6,7,5,3,8,386
140560211,358,30,1,4,2,1,4,400
140560212,342,23,7,6,2,1,1,382
140560213,461,28,2,15,0,1,7,514
140560214,438,21,1,16,1,1,5,483
140560301,6,9,0,0,0,0,0,15
140560302,31,1,1,0,0,5,15,53
140560303,61,10,0,0,0,2,21,94
140560304,56,15,0,0,0,2,4,77
140560305,38,8,0,0,0,6,13,65
140560306,12,0,0,0,0,6,4,22
140560307,11,0,0,0,0,3,3,17
140560308,27,4,0,0,0,1,10,42
140560309,39,8,0,1,0,3,3,54
140560310,47,9,0,0,1,1,4,62
140560311,300,16,11,5,3,3,19,357
140560312,288,19,4,1,1,3,4,320
140560313,351,23,7,15,7,2,12,417
140560314,257,13,4,9,4,0,8,295
140560315,198,23,0,5,7,0,5,238
140560316,283,29,1,6,2,0,13,334
140560317,183,22,3,4,0,2,3,217
140560318,185,20,1,0,2,1,10,219
140560319,351,23,5,20,2,5,9,415
140560320,209,14,2,4,1,0,14,244
140560401,34,7,1,0,0,1,11,54
140560402,46,17,0,2,0,0,4,69
140560403,11,10,0,0,0,0,8,29
140560404,10,12,0,0,0,3,5,30
140560405,36,1,0,1,1,5,10,54
140560406,24,5,0,0,0,3,8,40
140560407,360,22,6,3,0,0,10,401
140560408,143,12,4,1,0,2,6,168
140560409,210,16,8,2,0,2,2,240
140560410,198,31,2,1,0,1,3,236
140560411,223,24,5,3,2,0,13,270
140560412,189,17,2,7,3,1,3,222
140560413,288,26,4,4,0,0,6,328
140560414,283,27,6,6,1,0,13,336
140560415,267,27,7,7,2,1,8,319
140560501,26,0,0,0,1,2,1,30
140560502,21,0,0,0,0,7,20,48
140560503,16,1,0,0,0,0,0,17
140560504,47,18,0,0,0,0,0,65
140560505,10,6,0,0,0,1,1,18
140560506,62,6,0,0,0,4,5,77
140560507,58,14,3,1,0,1,8,85
140560508,203,14,1,3,1,0,9,231
140560509,198,12,4,5,4,3,5,231
140560601,62,6,0,0,0,11,5,84
140560602,37,12,0,0,0,1,7,57
140560603,21,17,0,0,0,4,0,42
140560604,19,1,0,0,0,18,4,42
140560605,30,11,0,0,0,0,12,53
140560606,24,12,0,0,0,3,2,41
140560607,28,5,0,0,0,0,21,54
140560608,51,11,0,0,0,2,1,65
140560609,81,14,0,2,2,5,32,136
140560610,42,3,1,0,0,1,12,59
140560611,57,1,0,0,0,8,5,71
140560612,67,10,2,0,0,5,27,111
140560613,71,17,0,0,0,0,2,90
140560614,22,1,0,0,0,1,11,35
140560615,257,10,1,17,1,0,21,307
140560616,227,3,2,3,2,0,7,244
140560617,270,6,3,6,0,1,14,300
140560618,180,16,0,5,1,3,8,213
140560701,228,18,2,3,1,2,2,256
140560702,217,16,2,2,0,1,0,238
140560703,286,13,4,7,0,0,6,316
140560704,241,19,1,9,0,2,8,280
140560705,197,22,3,3,3,1,5,234
140560706,319,29,10,4,2,1,7,372
140560707,209,24,0,4,5,0,3,245
140560708,346,36,8,49,3,1,8,451
140560709,392,33,2,8,1,0,11,447
140560710,224,21,1,6,0,1,2,255
140560711,344,22,3,4,1,1,10,385
140560712,388,27,9,7,1,2,13,447
140560713,304,35,0,1,0,3,38,381
140560714,228,11,4,2,1,0,8,254
140630101,29,0,13,0,0,3,20,65
140630102,29,0,0,0,0,2,28,59
140630103,21,2,0,0,0,2,25,50
140630104,12,8,0,0,0,1,4,25
140630105,18,12,0,0,0,0,3,33
140630106,36,1,0,0,0,1,42,80
140630107,17,3,0,0,0,0,20,40
140630108,19,7,0,0,0,0,33,59
140630109,277,15,3,8,4,3,45,355
140630201,29,25,0,0,0,0,18,72
140630202,70,2,4,0,0,5,33,114
140630203,29,6,0,0,0,2,19,56
140630204,30,12,0,0,0,7,14,63
140630205,16,13,0,0,0,0,3,32
140630206,32,5,0,0,0,7,38,82
140630207,27,8,0,0,1,7,1,44
140630208,33,10,0,0,0,2,0,45
140630209,24,33,0,0,0,2,3,62
140630210,37,4,0,0,0,1,33,75
140630211,28,1,3,0,0,16,37,85
140630212,330,14,2,15,1,4,18,384
140630213,263,37,5,14,1,5,7,332
140630214,202,24,2,3,2,1,7,241
140630215,141,9,3,4,0,2,7,166
140630301,13,1,0,0,0,0,0,14
140630302,37,3,0,1,0,50,1,92
140630303,106,36,6,2,1,2,23,176
140630304,241,15,1,8,0,1,7,273
140630305,269,16,2,4,1,1,4,297
140630306,309,23,3,8,1,2,11,357
140630307,228,11,23,8,1,3,7,281
140630308,251,18,6,5,2,1,1,284
140630309,195,13,4,20,0,0,3,235
140630310,211,14,5,1,2,3,2,238
140630311,280,14,2,7,0,4,1,308
140630401,12,2,0,1,0,8,17,40
140630402,23,5,0,1,0,2,12,43
140630403,13,13,0,0,0,6,15,47
140630404,23,3,0,0,0,0,11,37
140630405,30,3,0,0,0,0,0,33
140630406,9,5,0,0,0,0,0,14
140630407,318,23,7,4,5,2,7,366
140630408,261,16,7,3,6,2,9,304
140630409,186,12,6,1,3,1,12,221
140630410,196,14,5,5,5,0,6,231
140630411,191,12,2,3,0,1,4,213
140630412,163,16,3,4,0,0,10,196
140630413,313,22,4,4,11,1,10,365
140630414,245,14,1,4,5,5,3,277
140630415,210,9,1,1,1,0,2,224
140630501,64,24,0,2,1,0,18,109
140630502,52,2,0,0,0,0,22,76
140630503,27,3,0,0,0,2,24,56
140630504,181,27,3,6,0,1,3,221
140630505,279,15,4,6,5,1,8,318
140630506,272,17,1,2,0,1,4,297
140630507,227,16,2,3,3,4,8,263
140630508,279,9,2,10,4,2,13,319
140630509,189,0,10,3,2,4,17,225
140630510,327,14,1,6,0,2,9,359
140630511,215,10,4,3,0,2,2,236
140630512,186,7,2,7,1,1,13,217
140630513,286,18,9,5,7,2,19,346
140630514,258,6,12,7,1,5,18,307
140630515,330,5,7,12,1,5,13,373
140630516,293,2,5,10,2,1,22,335
140630517,129,6,0,2,0,0,12,149
140630601,5,0,0,0,0,0,11,16
140630602,4,0,0,0,0,0,21,25
140630603,43,3,1,0,0,6,58,111
140630604,38,21,0,0,0,0,7,66
140630605,18,0,0,0,0,0,1,19
140630606,31,0,0,0,0,6,24,61
140630607,284,3,2,4,2,1,2,298
140630608,217,9,3,0,2,1,9,241
140630609,293,5,0,2,3,1,4,308
140630610,248,7,0,0,1,0,4,260
140630611,287,7,1,7,4,1,5,312
140630612,227,0,1,1,1,0,0,230
140630613,291,4,1,2,1,0,1,300
140630614,60,18,0,0,1,1,4,84
140630615,249,8,1,2,0,1,3,264
140630701,97,8,0,2,0,2,30,139
140630702,49,0,1,0,5,6,4,65
140630703,34,6,0,1,1,14,8,64
140630704,28,3,0,0,0,5,22,58
140630705,39,2,0,0,0,8,12,61
140630706,277,11,10,5,2,2,4,311
140630707,245,16,6,5,1,1,6,280
140630708,309,19,13,1,13,0,19,374
140630709,307,27,7,4,2,2,19,368
140630710,103,7,1,1,1,0,4,117
140630711,179,21,0,2,0,1,3,206
140630801,24,21,0,0,0,6,5,56
140630802,31,0,0,1,0,19,13,64
140630803,44,29,1,1,0,7,1,83
140630804,55,0,0,4,0,0,55,114
140630805,20,0,0,0,0,0,10,30
140630806,20,0,0,0,0,8,17,45
140630807,147,7,1,1,0,1,13,170
140630808,248,26,9,4,5,5,17,314
140630809,217,10,8,3,6,2,11,257
140630810,238,13,11,2,1,4,19,288
140630811,199,3,1,5,4,3,20,235
140630812,204,16,1,4,0,1,12,238
140630901,21,4,0,0,0,0,13,38
140630902,36,5,0,0,0,3,4,48
140630903,72,13,1,0,3,4,14,107
140630904,64,17,1,0,0,5,11,98
140630905,30,9,0,0,0,3,9,51
140630906,20,0,1,0,0,7,7,35
140630907,32,8,0,0,0,1,6,47
140630908,37,3,0,0,0,1,13,54
140630909,56,1,0,0,3,5,8,73
140630910,188,11,4,1,1,2,4,211
140630911,185,24,3,6,0,2,2,222
140630912,224,25,3,6,0,1,10,269
140630913,181,14,2,1,0,0,6,204
140630914,282,15,2,5,0,3,6,313
140630915,324,27,11,13,0,5,10,390
140630916,289,32,5,7,1,0,6,340
140630917,125,7,0,10,0,3,6,151
140630918,273,18,3,6,1,0,8,309
140630919,214,24,4,2,4,1,5,254
140630920,268,18,5,13,1,4,8,317
140630921,285,22,2,2,1,1,6,319
140630922,351,32,2,4,0,1,9,399
140630923,179,10,1,5,0,7,19,221
140631001,144,14,0,3,0,1,3,165
140631002,303,18,2,2,0,1,14,340
140631003,348,28,4,7,1,1,11,400
140631004,227,11,1,7,1,2,3,252
140631005,193,3,6,7,3,0,12,224
140631006,250,17,5,5,3,2,6,288
140631007,351,17,5,9,0,0,3,385
140631008,233,18,1,0,7,0,5,264
140631009,255,16,14,5,2,1,10,303
140631010,218,18,2,4,0,0,8,250
140631011,233,23,16,3,4,3,8,290
140631012,338,17,4,6,1,2,16,384
140631013,369,17,6,9,0,3,14,418
140631101,356,24,2,11,1,1,2,397
140631102,273,12,1,3,0,1,1,291
140631103,213,10,2,2,0,0,1,228
140631104,245,17,1,7,1,2,3,276
140631105,365,17,6,5,2,6,6,407
140631106,198,8,4,4,0,3,12,229
140631107,247,13,4,18,2,5,5,294
140631108,221,11,4,13,0,4,4,257
140631109,193,8,1,9,1,1,2,215
140631110,339,9,6,5,1,2,3,365
140631111,242,13,5,3,10,2,9,284
140631112,153,17,14,2,9,2,5,202
140631113,247,23,10,6,22,0,17,325
140631114,237,31,14,2,17,0,11,312
140631115,206,19,9,0,4,0,8,246
140631116,367,20,2,13,3,3,12,420
140631201,224,13,4,12,0,0,1,254
140631202,206,10,1,3,3,0,7,230
140631203,254,27,9,2,6,1,6,305
140631204,170,29,7,6,10,1,7,230
140631205,351,19,5,12,11,3,13,414
140631206,302,9,4,2,1,0,5,323
140631207,272,18,8,7,3,1,3,312
140631208,252,24,2,3,1,0,6,288
140631209,331,11,6,3,5,0,9,365
140631210,325,19,2,8,1,0,2,357
140631211,275,18,2,9,0,0,3,307
140631212,288,18,2,9,2,2,3,324
140631213,259,10,7,6,1,0,7,290
140631214,315,20,9,4,0,3,1,352
140631215,291,11,2,3,0,1,8,316
140631216,285,10,2,14,0,1,2,314
140631301,330,12,6,5,1,1,15,370
140631302,186,13,1,12,0,0,6,218
140631303,328,29,5,4,1,0,1,368
140631304,240,5,3,7,2,1,10,268
140631305,415,23,5,15,0,1,9,468
140631306,275,10,7,1,4,2,11,310
140631307,176,21,9,1,5,1,6,219
140631308,264,18,5,4,6,2,17,316
140631309,335,22,7,6,4,1,11,386
140631310,156,6,2,17,0,9,7,197
140631311,232,16,2,2,1,0,6,259
140631312,202,9,1,12,1,0,7,232
140631313,191,12,8,13,0,3,3,230
140631314,289,19,6,24,0,5,5,348
140700101,74,5,0,1,0,13,1,94
140700102,35,15,0,0,0,0,2,52
140700103,95,13,0,2,0,4,20,134
140700104,36,7,0,1,0,0,2,46
140700105,106,13,0,6,2,12,5,144
140700201,43,11,0,1,1,1,9,66
140700202,37,0,3,0,0,1,12,53
140700203,91,8,0,3,0,13,30,145
140700204,29,3,0,0,0,0,0,32
140700205,80,13,1,12,0,14,8,128
140700206,92,39,0,6,0,12,23,172
140700207,63,20,2,3,0,10,3,101
140700208,36,9,0,0,0,1,2,48
140700209,45,15,1,0,0,2,5,68
140700210,86,19,1,3,0,8,22,139
140700211,88,22,2,2,2,12,7,135
140700212,135,18,7,5,1,12,5,183
140700213,276,21,9,12,7,27,13,365
140770101,13,3,0,0,2,0,2,20
140770102,8,1,0,0,0,0,4,13
140770103,43,2,0,0,0,1,5,51
140770104,21,2,0,0,0,2,1,26
140770105,45,8,0,0,0,0,1,54
140770106,46,2,0,0,0,0,6,54
140770107,43,5,0,0,0,0,14,62
140770108,26,2,0,0,0,5,1,34
140770109,30,2,0,0,0,1,1,34
140770110,109,9,0,21,0,11,14,164
140770201,50,10,0,3,0,4,16,83
140770202,83,7,4,2,0,21,12,129
140770203,120,13,1,12,1,20,31,198
140770204,183,40,1,2,0,15,7,248
140770205,55,18,0,4,0,5,10,92
140770206,18,11,0,0,1,0,5,35
140770207,50,9,0,0,0,8,9,76
140770208,55,21,0,0,0,0,5,81
140770209,34,14,0,0,0,0,5,53
140770210,225,58,2,9,3,21,5,323
140770211,194,20,2,9,8,45,8,286
140770212,55,22,3,0,0,22,8,110
140770213,57,25,1,0,1,0,17,101
140840101,50,0,0,0,0,0,2,52
140840102,49,38,0,0,0,2,7,96
140840103,49,8,0,0,3,0,10,70
140840104,19,12,0,0,0,0,2,33
140840105,21,15,0,0,0,2,0,38
140840106,350,16,5,6,3,2,14,396
140840107,264,22,4,1,0,2,8,301
140840108,379,26,9,4,1,6,15,440
140840109,287,14,4,7,3,3,15,333
140840110,263,14,7,1,0,1,5,291
140840111,291,19,1,1,0,1,2,315
140840201,24,7,0,0,0,0,4,35
140840202,27,1,0,0,0,1,13,42
140840203,24,3,0,0,0,0,6,33
140840204,46,6,0,0,0,6,14,72
140840205,28,15,0,0,0,0,1,44
140840206,55,1,0,1,0,5,9,71
140840207,45,17,0,0,0,17,6,85
140840208,37,35,0,0,0,1,1,74
140840209,122,6,2,0,2,2,3,137
140840210,276,15,7,6,0,2,6,312
140840301,31,1,0,1,0,6,13,52
140840302,48,7,0,0,0,6,24,85
140840303,27,6,0,0,0,0,13,46
140840304,26,1,0,1,0,10,11,49
140840305,42,19,0,0,0,2,8,71
140840306,22,0,0,0,0,0,9,31
140840307,25,0,0,0,0,2,7,34
140840308,28,13,0,0,0,4,9,54
140840309,29,17,0,0,0,0,7,53
140840310,22,0,0,0,0,0,28,50
140840311,18,0,0,0,0,0,25,43
140840312,33,19,1,0,0,0,22,75
140840313,209,18,0,3,1,0,8,239
140840314,222,14,1,10,1,2,11,261
140840315,173,19,2,0,0,3,8,205
140840316,155,12,4,1,2,3,18,195
140840401,41,15,0,0,0,3,0,59
140840402,54,2,0,0,0,18,8,82
140840403,14,31,0,0,0,0,1,46
140840404,75,32,1,0,1,1,9,119
140840405,87,4,1,0,1,8,4,105
140840406,213,22,1,7,4,2,1,250
140840407,227,22,2,7,0,1,12,271
140840408,291,18,3,12,1,2,9,336
140840409,302,16,6,6,0,0,9,339
140840501,258,22,1,0,0,0,2,283
140840502,193,8,1,0,0,2,7,211
140840503,191,16,3,3,0,0,9,222
140840504,316,24,8,5,2,2,11,368
140840505,248,25,0,7,1,0,6,287
140840506,235,16,6,5,0,2,11,275
140840507,246,4,9,2,1,1,30,293
140840508,343,16,13,6,2,2,11,393
140840509,246,22,5,0,0,1,18,292
140840510,215,28,10,4,6,0,16,279
140840511,280,45,15,1,21,4,17,383
140840512,308,15,1,11,2,3,4,344
140840513,257,21,3,6,2,4,4,297
140840514,361,32,2,8,1,2,8,414
140840515,266,23,11,4,13,0,11,328
140840516,308,56,13,7,5,0,16,405
140840517,207,17,5,2,2,0,2,235
140840518,243,8,1,0,3,5,3,263
140840519,234,20,2,12,0,2,6,276
140840520,188,11,4,5,2,2,1,213
140840521,288,38,4,5,5,1,7,348
140840522,281,33,2,4,5,0,7,332
140840523,253,14,4,5,0,0,7,283
140840524,227,8,3,7,2,2,4,253
140840525,202,12,3,0,0,0,7,224
140840526,206,13,1,1,0,1,7,229
140840527,175,9,4,5,0,2,5,200
140910101,215,20,4,13,0,9,7,268
140910102,102,11,1,2,0,20,10,146
140910103,203,27,9,3,0,15,16,273
140910104,224,39,7,7,0,36,14,327
140910105,90,15,2,4,0,21,8,140
140910106,208,36,0,8,1,27,17,297
140910107,226,39,13,3,4,10,21,316
140910108,237,24,16,4,4,20,30,335
140910109,149,32,11,2,0,11,10,215
140910110,198,2,7,5,2,23,11,248
140910111,172,34,11,6,0,33,11,267
140910112,204,21,10,6,2,28,16,287
140910113,269,47,4,3,1,22,8,354
140910114,237,28,7,9,0,7,8,296
140910115,102,17,4,8,0,9,6,146
140910116,211,11,8,8,0,27,22,287
140910117,151,21,1,8,0,5,8,194
140910118,218,24,5,28,0,35,8,318
140910119,142,23,8,40,1,26,7,247
140910201,90,21,0,1,1,2,3,118
140910202,37,12,0,0,0,0,0,49
140910203,72,17,4,1,2,17,10,123
140910204,48,25,0,0,0,0,3,76
140910205,4,3,0,0,0,1,0,8
140910206,24,4,0,3,0,0,2,33
140910207,4,0,0,0,0,0,4,8
140910208,6,1,0,0,0,0,2,9
140910209,253,59,6,11,2,36,24,391
140910210,246,30,2,4,5,72,18,377
140910211,95,29,3,3,0,27,11,168
140910212,4,2,0,0,0,12,3,21
140910301,6,2,0,1,0,4,6,19
140910302,11,5,2,1,0,2,0,21
140910303,217,29,3,16,1,59,8,333
140910304,282,21,6,38,2,36,15,400
140910305,222,33,5,11,1,33,22,327
140910306,178,16,6,10,0,31,11,252
140910307,196,31,11,10,0,24,6,278
140910308,216,16,3,18,0,31,14,298
140910309,278,26,14,3,4,18,12,355
140910310,184,31,9,7,0,28,9,268
140910311,176,33,16,30,0,33,15,303
140910401,244,23,7,10,3,3,11,301
140910402,269,20,5,6,0,8,5,313
140910403,230,9,8,0,0,9,27,283
140910404,254,18,9,1,1,9,6,298
140910405,256,31,10,6,0,6,19,328
140910406,232,41,28,2,5,12,19,339
140910407,305,45,17,11,2,45,46,471
140910408,219,36,6,9,2,25,4,301
140910409,340,57,26,3,8,21,8,463
140910410,140,2,2,0,1,0,7,152
140910411,315,33,18,2,1,12,22,403
140910412,106,12,6,6,0,2,13,145
140910413,339,30,10,5,0,17,17,418
140910414,228,24,9,4,3,11,11,290
140910415,235,16,1,7,0,16,9,284
140910416,167,11,10,6,1,6,8,209
140910417,323,23,6,4,5,11,5,377
140910418,241,25,11,1,0,16,17,311
140910419,194,11,4,4,0,4,30,247
140910420,273,14,3,1,1,2,10,304
140910501,5,0,0,0,0,0,2,7
140910502,151,26,3,4,1,12,14,211
140910503,218,20,10,6,1,27,15,297
140910504,300,25,14,12,7,24,18,400
140910505,247,21,11,16,0,19,5,319
140910506,200,21,4,8,0,24,5,262
140910507,155,42,3,2,0,16,5,223
140910508,95,53,0,12,0,37,19,216
140910509,190,16,8,6,2,61,10,293
140910510,182,15,3,7,0,12,10,229
140910601,1,6,0,0,0,0,1,8
140910602,100,11,0,2,0,2,6,121
140910603,21,0,0,0,0,0,1,22
140910604,16,1,0,0,0,8,1,26
140910605,21,0,0,0,0,47,3,71
140910606,243,5,2,6,0,31,8,295
140910607,300,22,1,5,0,18,9,355
140910608,282,37,4,6,0,15,10,354
140910609,175,26,3,5,5,25,9,248
140910610,309,54,8,9,0,24,12,416
140910611,206,26,6,8,1,21,19,287
140910612,175,26,2,14,1,21,10,249
140910613,222,17,6,22,0,83,13,363
140910614,195,12,6,4,0,33,20,270
140910615,167,36,1,2,0,36,14,256
140910616,163,41,7,6,0,63,6,286
140910617,175,9,21,10,0,74,15,304
140910618,138,16,0,7,1,30,11,203
140910701,13,1,0,1,0,2,0,17
140910702,196,31,2,24,0,49,16,318
140910703,324,15,4,4,1,23,16,387
140910704,224,67,3,4,0,54,11,363
140910705,187,45,9,3,3,16,13,276
140910706,150,29,0,1,0,25,3,208
140910707,265,34,13,15,3,57,6,393
140910708,268,16,11,5,4,41,13,358
140910709,326,35,19,1,12,30,19,442
140910710,165,31,3,2,1,15,5,222
140910711,284,40,7,2,7,18,19,377
140910712,285,59,16,5,13,14,9,401
140910713,396,23,6,7,3,9,25,469
140910714,236,12,0,3,0,0,7,258
140910715,336,49,21,0,9,6,25,446
140910716,265,35,14,2,0,36,18,370
140910717,165,31,4,11,0,24,15,250
140910718,295,53,5,2,0,26,4,385
140910719,184,12,10,2,1,16,18,243
140910720,379,39,8,0,0,5,17,448
140910721,390,23,3,9,1,7,7,440
140910722,319,26,4,4,0,10,10,373
140910723,232,15,1,9,0,2,5,264
140910801,11,6,0,0,0,14,3,34
140910802,74,73,4,6,1,59,24,241
140910803,4,0,0,2,0,1,3,10
140910804,93,43,8,10,0,63,10,227
140910805,164,50,19,1,2,46,9,291
140910806,191,20,14,7,0,45,29,306
140910807,172,42,27,9,1,76,27,354
140910808,131,10,10,3,0,99,5,258
140910809,212,36,9,8,3,62,6,336
140910810,225,21,6,16,0,71,3,342
140910811,171,29,6,9,2,101,32,350
140910812,234,59,10,38,2,52,43,438
140910813,299,46,10,32,3,51,24,465
140910901,248,31,10,13,1,47,40,390
140910902,160,30,11,13,0,49,44,307
140910903,152,35,28,6,2,47,20,290
140910904,316,19,17,17,3,64,30,466
140910905,343,36,13,19,1,49,20,481
140910906,247,37,16,11,1,13,12,337
140910907,216,1,21,1,0,7,12,258
140910908,246,16,21,4,1,20,6,314
140910909,217,62,35,5,1,55,2,377
140910910,158,28,70,2,1,32,2,293
140910911,129,27,59,21,5,79,20,340
140910912,218,18,47,16,0,34,5,338
140910913,196,4,2,14,0,6,21,243
140910914,296,13,11,1,0,17,3,341
140910915,304,4,14,6,0,5,9,342
140910916,338,9,24,23,0,30,11,435
140910917,239,33,27,8,2,89,4,402
140910918,129,40,20,3,5,79,8,284
140910919,210,12,7,3,0,19,8,259
140910920,240,21,11,1,1,4,13,291
140910921,394,11,0,6,0,1,11,423
140910922,369,22,0,9,0,0,3,403
140910923,0,0,0,0,0,0,401,401
140911001,207,30,14,9,0,69,43,372
140911002,208,54,20,7,2,63,38,392
140911003,218,48,20,3,1,84,22,396
140911004,329,41,64,7,2,41,37,521
140911005,214,63,64,12,1,30,12,396
140911006,279,39,11,18,0,39,8,394
140911007,154,23,6,3,0,14,2,202
140911008,235,36,36,5,1,47,28,388
140911009,217,32,44,0,3,28,32,356
140911010,237,21,35,6,2,33,14,348
140911011,215,32,22,3,0,55,10,337
140911012,193,10,11,3,2,15,6,240
140911013,260,43,19,3,4,27,22,378
140911014,175,15,18,0,4,14,9,235
140911015,232,32,16,8,3,54,26,371
140911016,167,23,32,2,2,30,10,266
140911017,199,44,21,6,5,7,7,289
140911018,209,64,17,2,1,25,12,330
140911019,176,24,9,2,3,9,16,239
140911020,110,6,32,0,0,29,20,197
140911101,210,69,87,3,15,27,7,418
140911102,157,37,16,15,6,56,14,301
140911103,179,29,17,2,5,35,14,281
140911104,193,29,22,8,5,49,13,319
140911105,258,47,38,1,1,16,16,377
140911106,103,31,65,3,4,38,8,252
140911107,145,44,39,0,5,59,11,303
140911108,192,22,105,2,1,17,27,366
140911109,199,66,34,11,10,51,8,379
140911110,297,59,24,2,18,51,14,465
140911111,146,54,61,1,16,53,106,437
140911112,247,28,5,8,2,50,22,362
140911113,178,37,9,5,0,36,2,267
140911114,182,11,36,5,0,24,4,262
140911115,205,52,49,4,0,11,7,328
140911116,173,22,20,8,4,11,10,248
140911117,120,7,39,1,5,54,28,254
140911118,192,25,21,5,2,33,10,288
140911201,309,48,31,8,3,37,38,474
140911202,229,34,45,3,5,19,33,368
140911203,253,26,15,1,1,13,34,343
140911204,257,35,18,7,0,19,7,343
140911205,300,22,25,5,3,4,32,391
140911206,184,33,12,1,0,6,4,240
140911207,266,19,10,6,0,2,13,316
140911208,301,11,8,10,1,2,6,339
140911209,214,10,3,1,1,4,3,236
140911210,264,17,10,6,0,16,14,327
140911211,256,27,11,1,0,16,17,328
140911212,169,30,16,7,0,104,8,334
140911213,217,53,14,10,0,57,19,370
140911214,257,44,15,8,1,9,9,343
140911215,237,51,16,9,1,20,36,370
140911216,134,56,8,0,0,105,48,351
140911217,177,28,21,16,2,99,7,350
140911218,189,56,29,8,0,69,8,359
140911219,255,64,12,11,0,45,22,409
140911220,207,13,3,3,0,41,6,273
140911221,216,11,14,5,11,7,6,270
140911222,206,21,12,6,1,13,7,266
140911223,169,10,7,18,0,5,3,212
140911301,5,3,0,0,0,0,0,8
140911302,8,1,0,0,0,0,0,9
140911303,28,1,3,11,0,9,0,52
140911304,5,1,0,0,0,0,0,6
140911305,7,1,0,1,0,0,2,11
140911306,9,2,0,0,0,9,0,20
140911307,6,0,0,3,0,2,0,11
140911308,7,8,0,0,4,0,2,21
140911309,105,15,2,9,8,32,9,180
140911310,93,21,0,0,2,9,3,128
140911311,271,27,4,16,5,154,10,487
140911312,165,19,6,11,6,194,8,409
140911313,232,37,16,17,2,39,9,352
140911314,126,50,2,1,0,21,31,231
140911315,224,24,9,18,0,44,7,326
140911316,96,10,16,5,0,95,1,223
140911317,117,7,10,11,0,106,3,254
140911318,112,33,3,7,1,82,21,259
140911319,104,3,1,4,0,58,3,173
140911320,103,100,9,8,2,73,6,301
140911321,89,34,28,2,1,121,1,276
140911322,83,22,15,5,0,66,15,206
140911323,181,58,10,19,1,56,16,341
140911401,14,8,0,1,0,10,4,37
140911402,21,0,0,0,0,6,1,28
140911403,10,4,0,0,0,0,0,14
140911404,17,1,0,2,0,5,9,34
140911405,32,6,0,3,0,2,18,61
140911406,134,55,4,5,0,46,7,251
140911407,296,11,6,4,0,40,20,377
140911408,233,48,3,4,0,0,8,296
140911409,275,15,4,7,0,10,2,313
140911410,361,27,1,7,1,7,7,411
140911411,185,26,1,6,1,14,13,246
140911412,199,21,5,11,1,4,5,246
140911413,276,26,6,9,5,14,15,351
140911414,232,56,4,3,2,14,53,364
140911415,167,31,8,12,0,63,6,287
140911501,5,0,0,0,0,2,0,7
140911502,113,8,2,1,0,4,23,151
140911503,192,22,9,23,1,32,13,292
140911504,189,15,4,8,0,28,11,255
140911505,161,5,9,9,3,56,21,264
140911506,179,34,13,5,0,4,14,249
140911507,178,26,0,2,0,2,14,222
140911508,208,26,12,14,2,22,7,291
140911509,207,19,8,5,4,14,10,267
140911510,224,11,10,5,0,11,11,272
140911601,7,0,0,0,0,2,5,14
140911602,18,19,0,1,0,6,1,45
140911603,3,0,0,0,0,0,1,4
140911604,7,0,0,0,0,5,0,12
140911605,61,2,0,0,0,9,2,74
140911606,25,11,0,1,1,3,0,41
140911607,5,0,0,0,0,0,5,10
140911608,137,21,3,24,0,53,11,249
140911609,129,15,4,15,1,42,25,231
140911610,82,28,2,7,0,51,5,175
140911701,2,3,0,0,0,0,11,16
140911702,2,0,0,0,0,3,5,10
140911703,9,11,0,0,0,13,3,36
140911704,1,3,0,0,0,7,4,15
140911705,4,1,0,1,0,0,0,6
140911706,230,71,13,9,0,30,22,375
140911707,155,25,7,4,1,35,5,232
140911708,196,31,3,3,5,49,12,299
140911709,217,14,18,5,2,72,7,335
140911710,149,14,16,9,0,100,10,298
140911711,162,33,25,18,0,159,21,418
140911712,140,11,8,6,0,137,9,311
140911713,248,92,13,13,2,69,13,450
140911714,160,5,7,27,0,231,3,433
140911715,98,13,1,6,0,88,35,241
140911801,7,5,0,1,0,10,5,28
140911802,5,7,0,0,0,3,0,15
140911803,11,3,1,1,0,12,0,28
140911804,67,18,2,6,0,14,8,115
140911805,51,0,1,2,0,6,6,66
140911806,113,35,24,12,2,277,7,470
140911807,79,21,3,13,1,105,16,238
140911808,189,31,18,34,1,129,14,416
140911809,166,21,14,13,1,180,6,401
140911810,36,23,9,2,0,115,4,189
140911901,37,0,0,4,0,15,0,56
140911902,30,3,0,0,0,0,6,39
140911903,1,1,0,0,0,0,0,2
140911904,13,2,0,0,0,0,0,15
140911905,11,0,1,1,1,4,0,18
140911906,192,50,13,34,2,136,2,429
140911907,113,52,8,12,0,56,12,253
140911908,220,68,11,42,2,228,13,584
140911909,197,24,12,9,0,15,2,259
140911910,190,34,5,8,1,18,3,259
140911911,273,83,15,7,1,17,10,406
140911912,41,127,10,3,0,6,4,191
140911913,191,32,8,36,3,66,9,345
140911914,144,45,7,2,1,63,44,306
140980101,6,4,0,0,0,12,11,33
140980102,17,3,0,0,0,12,6,38
140980103,33,24,0,0,0,0,0,57
140980104,23,16,0,0,0,2,10,51
140980105,13,4,1,0,0,11,18,47
140980106,18,3,0,0,0,6,5,32
140980107,17,2,0,1,0,0,18,38
140980108,176,0,3,4,0,0,3,186
140980109,236,29,6,6,1,3,15,296
140980110,250,7,0,4,0,1,14,276
140980111,208,6,4,3,1,4,5,231
140980112,200,32,11,5,1,1,2,252
140980113,242,37,11,8,4,1,9,312
140980114,209,26,2,2,0,3,11,253
140980115,243,21,3,3,0,0,2,272
140980116,245,22,16,5,2,2,9,301
140980117,284,36,4,8,3,0,13,348
140980201,10,6,0,0,1,4,19,40
140980202,36,0,0,0,0,32,0,68
140980203,78,1,0,3,0,0,19,101
140980204,45,5,1,1,0,2,23,77
140980205,37,5,0,0,0,6,21,69
140980206,18,2,0,0,0,2,5,27
140980207,18,15,0,0,0,14,0,47
140980208,259,13,6,4,1,3,9,295
140980209,183,8,7,8,0,10,3,219
140980210,262,28,3,9,1,0,9,312
140980211,306,21,1,8,0,3,6,345
140980301,19,0,0,0,0,0,25,44
140980302,26,16,0,0,0,16,16,74
140980303,16,6,0,0,0,3,4,29
140980304,243,16,2,11,0,7,15,294
140980305,297,25,3,15,0,0,6,346
140980306,309,30,3,8,7,0,11,368
140980307,208,17,9,2,0,3,7,246
140980308,292,31,2,11,3,2,7,348
140980309,203,28,1,0,0,1,2,235
140980310,197,12,0,4,0,2,6,221
140980311,247,13,1,9,0,7,9,286
140980401,21,0,0,0,0,6,27,54
140980402,48,0,0,0,0,10,31,89
140980403,24,0,0,0,0,13,24,61
140980404,19,0,0,0,0,0,32,51
140980405,21,38,0,0,0,1,0,60
140980406,46,32,1,0,0,2,14,95
140980407,203,23,1,2,0,1,2,232
140980408,228,13,1,2,1,4,18,267
140980409,101,25,4,4,1,0,9,144
140980501,17,18,0,0,0,6,1,42
140980502,63,8,0,0,2,10,3,86
140980503,23,2,1,0,0,0,0,26
140980504,12,2,1,2,0,8,4,29
140980505,107,10,3,3,0,17,7,147
140980506,134,20,7,2,0,1,19,183
140980507,34,0,0,0,0,31,5,70
140980508,20,5,0,1,0,3,3,32
140980509,48,17,0,1,0,1,17,84
140980510,267,26,3,20,1,22,13,352
140980511,246,32,6,3,3,3,7,300
140980512,290,41,3,14,1,0,1,350
140980513,225,36,3,2,6,0,5,277
140980514,188,17,9,8,3,0,11,236
140980515,223,14,11,1,0,1,4,254
140980516,200,51,38,13,0,0,7,309
140980517,279,66,7,3,2,2,2,361
140980601,25,9,0,1,0,18,5,58
140980602,66,19,1,0,0,4,17,107
140980603,45,25,0,0,0,5,6,81
140980604,45,5,0,1,0,71,3,125
140980605,34,30,0,1,0,71,3,139
140980606,50,13,0,5,0,120,12,200
140980607,75,1,4,17,1,152,7,257
140980608,93,16,9,2,3,63,33,219
140980609,35,21,9,3,6,103,4,181
140980701,27,15,0,1,0,55,1,99
140980702,49,10,0,1,0,10,17,87
140980703,46,5,5,1,0,10,10,77
140980704,69,37,0,0,0,0,2,108
140980705,20,4,0,0,0,1,3,28
140980706,30,14,1,0,0,36,16,97
140980707,55,43,0,5,0,98,21,222
140980708,48,6,1,6,1,159,6,227
140980801,49,4,3,2,0,36,17,111
140980802,49,19,5,0,1,0,1,75
140980803,67,15,0,0,0,5,16,103
140980804,72,14,0,1,0,21,28,136
140980805,20,4,0,0,0,2,11,37
140980806,71,12,0,0,0,8,30,121
140980807,166,38,11,7,0,83,46,351
140980808,265,18,10,7,1,27,18,346
140980809,193,25,2,7,1,8,11,247
140980810,147,28,2,2,6,2,4,191
140980811,106,14,3,2,0,4,15,144
140980901,46,24,0,0,0,1,1,72
140980902,145,38,0,1,0,0,12,196
140980903,60,9,0,1,1,0,39,110
140980904,196,33,2,2,0,0,5,238
140980905,225,17,5,5,0,0,2,254
140980906,262,32,6,11,0,2,9,322
140980907,253,44,5,2,0,1,8,313
140980908,243,13,6,5,4,3,4,278
140980909,256,28,7,5,0,1,3,300
140980910,213,21,2,1,0,0,10,247
140980911,118,11,0,1,0,1,1,132
140980912,357,23,6,5,1,1,20,413
140980913,265,29,3,3,1,1,4,306
140980914,258,31,5,0,4,3,17,318
140981001,12,5,0,1,0,1,1,20
140981002,17,17,0,0,0,0,0,34
140981003,172,24,0,0,0,0,18,214
140981004,51,2,0,0,0,4,20,77
140981005,45,9,0,2,0,8,3,67
140981006,38,21,0,0,0,12,4,75
140981007,56,39,0,0,0,0,2,97
140981008,63,7,3,0,0,0,21,94
140981009,166,19,6,5,0,0,6,202
140981010,197,23,8,19,26,1,7,281
140981011,305,31,1,18,1,0,5,361
140981012,216,18,4,7,1,3,4,253
140981013,277,22,2,13,3,2,15,334
140981014,240,21,5,3,1,3,12,285
140981101,86,1,1,6,4,31,11,140
140981102,87,11,1,0,2,6,21,128
140981103,22,4,5,0,0,13,11,55
140981104,22,3,0,0,0,6,18,49
140981105,32,19,4,0,0,7,20,82
140981106,97,23,0,0,0,9,22,151
140981107,66,33,0,0,0,0,17,116
140981108,38,22,0,0,0,3,22,85
140981109,249,29,5,11,1,1,19,315
140981110,194,16,8,11,1,3,4,237
140981111,267,24,10,3,2,0,3,309
140981201,70,6,1,2,0,3,25,107
140981202,86,24,0,0,0,2,25,137
140981203,112,10,0,5,0,6,25,158
140981204,130,12,3,0,1,14,57,217
140981205,35,0,0,0,0,2,30,67
140981206,96,7,0,0,0,0,5,108
140981207,261,14,0,16,0,0,4,295
140981208,259,20,3,5,2,0,9,298
140981209,184,17,5,10,3,0,9,228
140981210,191,16,2,2,1,1,4,217
140981211,174,14,3,2,3,2,3,201
140981212,210,10,1,2,0,0,5,228
140981301,49,3,0,0,0,6,28,86
140981302,48,5,0,0,0,7,32,92
140981303,41,13,0,1,0,16,18,89
140981304,42,24,0,0,0,3,37,106
140981305,35,7,7,0,0,1,15,65
140981306,29,10,3,0,0,1,1,44
140981307,14,5,0,0,0,0,34,53
140981308,32,9,0,0,0,0,71,112
140981309,42,21,0,0,0,4,4,71
140981310,64,20,0,0,0,0,16,100
140981311,228,25,3,6,0,5,9,276
140981312,325,29,4,8,2,1,16,385
140981313,162,19,1,2,1,0,2,187
140981401,57,14,0,0,0,0,25,96
140981402,42,1,0,0,0,1,26,70
140981403,44,4,0,0,0,1,54,103
140981404,55,20,0,2,2,1,14,94
140981405,53,32,0,0,0,6,6,97
140981406,40,1,0,0,0,23,1,65
140981407,38,29,0,0,0,2,10,79
140981408,31,18,0,0,0,0,1,50
140981409,129,17,0,6,0,0,2,154
140981410,264,16,0,1,0,0,7,288
140981501,298,28,2,12,0,7,2,349
140981502,295,21,1,13,0,1,4,335
140981503,347,34,12,6,1,0,9,409
140981504,280,14,4,11,0,1,12,322
140981505,227,17,6,11,0,2,1,264
140981506,210,9,4,10,1,3,4,241
140981507,285,44,6,7,5,1,2,350
140981508,236,22,3,1,0,0,3,265
140981509,312,16,3,10,0,1,14,356
140981510,329,24,14,13,2,3,7,392
140981511,275,27,7,17,1,3,7,337
140981512,164,22,5,48,1,20,12,272
140981513,352,23,7,5,1,1,11,400
140981514,313,27,8,7,2,1,5,363
140981515,244,33,11,1,5,0,8,302
140981601,247,15,4,5,2,1,4,278
140981602,354,10,7,1,1,1,16,390
140981603,192,23,0,6,0,2,2,225
140981604,202,18,2,7,0,0,5,234
140981605,386,36,9,8,2,3,22,466
140981606,156,16,2,3,1,2,44,224
140981607,219,8,4,4,1,0,4,240
140981608,193,17,4,1,0,0,2,217
140981609,399,41,11,13,1,9,14,488
140981610,368,86,12,7,3,4,13,493
140981611,343,83,18,39,12,4,15,514
140981612,344,128,43,12,19,4,16,566
140981613,184,55,47,6,3,1,6,302
140981614,195,72,25,3,16,0,11,322
140981615,173,61,15,2,15,0,48,314
140981701,420,11,1,2,0,1,5,440
140981702,279,35,3,8,8,1,8,342
140981703,292,40,14,20,1,2,11,380
140981704,205,32,6,11,0,6,2,262
140981705,388,58,15,5,1,2,19,488
140981706,230,27,10,8,5,0,1,281
140981707,201,28,7,16,4,0,15,271
140981708,290,27,3,0,3,2,8,333
140981709,245,10,2,8,0,0,3,268
140981710,261,19,9,4,1,1,2,297
140981711,316,29,3,5,6,0,4,363
140981712,413,23,8,7,1,0,10,462
140981713,268,23,5,1,4,0,10,311
140981801,395,57,11,10,0,1,6,480
140981802,392,41,7,13,2,0,10,465
140981803,444,16,10,12,1,0,11,494
140981804,426,40,15,28,3,3,5,520
140981805,365,24,16,5,0,0,8,418
140981806,290,40,5,2,2,0,9,348
140981807,312,32,10,8,6,1,2,371
140981808,320,17,12,4,0,0,9,362
140981809,448,29,12,15,1,0,2,507
140981810,432,53,16,13,6,3,11,534
140981811,317,36,4,3,5,1,6,372
140981812,293,31,18,7,1,0,10,360
140981813,301,32,5,12,0,0,12,362
140981901,197,13,3,18,1,1,0,233
140981902,581,20,3,15,0,0,11,630
140981903,322,22,4,7,1,2,7,365
140981904,226,9,2,1,0,0,5,243
140981905,206,15,1,11,0,0,6,239
140981906,219,17,1,2,0,0,6,245
140981907,213,13,6,4,2,1,5,244
140981908,243,18,1,4,0,1,6,273
140981909,210,18,4,3,1,0,15,251
140981910,222,19,10,1,9,0,4,265
140981911,293,22,2,4,10,1,14,346
140981912,323,52,6,2,3,0,9,395
140982001,114,10,1,1,0,0,7,133
140982002,225,58,14,5,3,0,6,311
140982003,276,99,42,3,29,2,9,460
140982004,169,63,15,8,15,3,24,297
140982005,137,79,18,5,9,0,2,250
140982006,316,68,23,11,12,2,12,444
140982007,242,59,30,0,0,0,4,335
140982008,352,67,19,1,3,0,16,458
140982009,204,21,2,2,1,0,8,238
140982010,284,53,9,2,3,1,11,363
140982011,181,58,30,0,10,0,8,287
140982012,205,91,17,8,5,1,16,343
140982013,216,96,42,1,21,11,36,423
140982014,228,142,29,23,26,3,23,474
140982015,153,66,28,5,44,0,11,307
140982016,254,111,28,5,23,8,22,451
140982017,309,90,29,5,15,0,20,468
140982018,343,143,27,2,17,4,27,563
140982019,89,55,11,4,44,1,9,213
140982020,196,79,19,2,7,7,24,334
140982021,230,126,43,1,13,4,6,423
140982022,209,99,80,1,9,10,4,412
140982101,261,20,2,5,2,1,4,295
140982102,159,13,0,3,0,0,3,178
140982103,410,55,9,3,2,0,12,491
140982104,260,41,15,1,1,2,5,325
140982105,228,25,12,1,1,3,4,274
140982106,198,34,28,2,3,1,5,271
140982107,230,62,53,0,4,0,10,359
140982108,345,47,9,3,4,0,18,426
140982109,337,50,19,0,3,7,14,430
140982110,312,36,10,6,1,1,9,375
140982111,316,11,6,1,2,1,11,348
140982112,237,16,3,1,1,0,4,262
140982113,271,9,0,5,0,0,4,289
140982114,325,33,13,2,1,0,8,382
140982201,392,47,16,17,1,0,14,487
140982202,394,41,12,11,2,1,3,464
140982203,336,19,7,18,2,1,4,387
140982204,177,8,4,7,0,0,3,199
140982205,388,16,7,4,1,0,9,425
140982206,355,14,2,1,2,2,7,383
140982207,326,24,8,17,0,0,3,378
140982208,292,24,4,5,0,0,7,332
140982209,261,25,2,8,1,1,13,311
140982210,345,20,0,9,1,1,9,385
140982211,290,17,1,0,1,1,0,310
140982212,214,30,9,7,3,0,6,269
140982301,354,35,9,3,13,0,11,425
140982302,257,29,5,1,2,0,6,300
140982303,227,20,4,4,0,1,9,265
140982304,404,33,3,7,2,3,10,462
140982305,169,31,12,1,5,1,2,221
140982306,262,33,14,2,6,0,39,356
140982307,191,18,3,0,0,0,1,213
140982308,324,32,4,3,0,0,7,370
140982309,252,25,1,5,0,0,8,291
140982310,252,23,4,8,1,1,2,291
140982311,257,26,1,10,0,0,4,298
140982312,405,25,4,1,1,0,12,448
140982313,319,33,2,12,3,0,13,382
140982314,216,21,1,3,2,1,4,248
140982401,273,57,18,3,9,0,27,387
140982402,210,68,17,3,30,4,21,353
140982403,137,40,9,5,24,0,26,241
140982404,315,88,17,6,8,0,18,452
140982405,351,62,30,8,8,3,24,486
140982406,357,103,72,5,17,0,26,580
140982407,186,120,16,5,17,1,10,355
140982408,201,60,11,1,9,1,15,298
140982409,309,108,42,5,17,0,13,494
140982410,292,43,46,3,10,4,10,408
140982411,358,117,54,3,16,2,40,590
140982412,314,34,12,6,2,2,17,387
140982413,319,50,16,2,0,1,8,396
140982414,341,28,10,5,14,1,24,423
140982415,220,77,11,1,34,1,11,355
140982416,283,58,57,4,8,2,13,425
140982417,303,65,11,6,25,1,15,426
140982418,228,32,3,0,5,1,18,287
140982419,166,28,16,7,8,1,5,231
140982420,353,39,1,0,2,0,23,418
140982421,249,27,8,3,7,2,6,302
140982501,289,27,9,2,8,4,4,343
140982502,370,35,9,4,3,0,11,432
140982503,284,20,8,11,4,4,11,342
140982504,276,18,1,2,2,1,1,301
140982505,362,23,6,6,0,0,5,402
140982506,358,20,6,4,1,0,6,395
140982507,323,15,1,6,2,0,9,356
140982508,324,41,8,9,1,1,13,397
140982509,231,19,5,7,7,0,2,271
140982510,237,11,3,1,3,0,10,265
140982511,405,24,5,13,0,1,14,462
140982512,389,24,9,11,0,0,2,435
140982601,281,50,7,4,5,0,7,354
140982602,284,17,4,4,2,1,25,337
140982603,441,31,4,13,2,0,4,495
140982604,366,26,8,4,0,0,16,420
140982605,278,19,2,8,0,0,1,308
140982606,242,24,2,2,1,0,4,275
140982607,321,26,0,3,0,0,6,356
140982608,294,20,0,0,0,0,3,317
140982609,256,15,2,11,0,2,9,295
140982610,246,6,0,1,0,0,4,257
140982611,255,19,0,1,0,0,1,276
140982612,274,15,0,3,0,0,2,294
140982613,172,12,1,4,1,0,8,198
140982701,366,1,1,2,0,0,6,376
140982702,373,1,8,3,2,3,12,402
140982703,357,1,11,3,7,1,17,397
140982704,224,1,4,5,4,1,9,248
140982705,264,0,5,16,5,2,6,298
140982706,253,0,14,6,2,2,7,284
140982707,332,1,12,9,1,3,9,367
140982708,310,0,4,7,2,3,2,328
140982801,377,24,5,5,1,1,10,423
140982802,319,33,11,11,1,0,6,381
140982803,183,25,4,4,10,1,8,235
140982804,185,18,7,2,10,0,23,245
140982805,205,21,0,3,1,0,1,231
140982806,226,14,0,14,0,0,2,256
140982807,208,25,4,5,2,1,9,254
140982808,179,4,2,4,6,0,16,211
140982809,269,21,9,1,2,0,10,312
140982810,252,15,3,2,0,1,16,289
140982811,182,20,1,3,1,0,8,215
140982812,267,17,0,12,0,2,5,303
140982901,243,25,4,4,0,1,3,280
140982902,277,33,9,7,1,0,2,329
140982903,139,16,1,2,5,0,9,172
140982904,210,20,5,2,0,1,2,240
140982905,188,19,3,2,0,0,11,223
140982906,230,26,0,3,3,1,8,271
140982907,136,22,2,2,2,0,5,169
140982908,161,26,8,0,0,2,10,207
140982909,181,22,4,8,0,1,2,218
140982910,254,24,6,10,1,2,8,305
140982911,223,28,4,8,4,0,7,274
140982912,211,23,2,6,1,0,1,244
140982913,255,36,6,10,0,0,6,313
140982914,306,30,3,8,1,3,14,365
141050101,81,13,1,2,0,1,3,101
141050102,34,15,0,0,0,2,4,55
141050103,122,31,0,2,0,6,12,173
141050104,34,7,0,0,0,4,22,67
141050105,20,5,0,0,0,3,7,35
141050106,79,19,0,1,1,5,31,136
141050107,56,11,0,0,0,0,22,89
141050108,85,1,6,5,2,11,34,144
141050109,123,22,0,0,1,3,19,168
141050110,73,19,0,4,0,0,13,109
141050111,52,15,1,0,0,1,8,77
141050112,183,7,5,4,4,0,7,210
141050113,195,23,0,5,0,3,3,229
141050114,257,35,3,9,1,7,27,339
141050201,26,2,0,0,0,3,16,47
141050202,16,1,2,0,0,0,2,21
141050203,54,14,0,0,0,0,21,89
141050204,33,1,1,0,0,4,19,58
141050205,71,3,2,0,0,1,37,114
141050206,56,17,0,0,0,0,16,89
141050207,27,8,0,0,0,5,21,61
141050208,65,30,0,0,0,0,8,103
141050209,48,7,1,3,0,0,9,68
141050210,132,5,0,3,0,0,2,142
141050211,230,20,3,1,1,0,5,260
141050212,209,13,2,0,0,2,6,232
141050213,193,21,3,3,4,0,4,228
141050214,246,18,2,9,2,1,19,297
141050215,293,14,3,3,4,2,8,327
141050216,345,20,2,9,3,1,16,396
141050217,296,28,1,12,1,1,5,344
141050301,17,19,0,0,0,0,8,44
141050302,40,17,0,2,0,2,6,67
141050303,55,28,0,0,0,3,14,100
141050304,23,4,0,0,0,0,3,30
141050305,101,31,0,3,0,1,7,143
141050306,42,7,0,0,0,0,21,70
141050307,38,9,0,1,0,2,22,72
141050308,143,15,2,3,0,0,5,168
141050309,357,29,8,11,3,1,14,423
141050310,261,16,7,8,0,1,12,305
141050311,153,17,6,2,3,2,3,186
141050312,224,15,5,3,0,0,5,252
141050313,330,35,6,9,1,1,13,395
141050314,311,41,7,3,0,5,5,372
141050315,321,29,6,14,0,2,10,382
141050316,282,18,9,3,2,2,8,324
141050401,13,2,0,0,0,0,13,28
141050402,50,4,1,0,2,6,26,89
141050403,21,7,0,0,0,0,20,48
141050404,55,0,0,0,1,1,48,105
141050405,44,13,0,0,0,7,9,73
141050406,49,13,0,1,0,5,14,82
141050407,63,1,0,2,0,1,16,83
141050408,27,3,9,0,0,9,6,54
141050409,39,6,0,1,0,2,13,61
141050410,93,23,1,3,0,1,23,144
141050411,22,6,5,0,0,0,4,37
141050412,42,0,0,1,0,0,49,92
141050413,28,6,0,0,0,0,7,41
141050414,136,4,2,7,0,1,6,156
141050415,240,15,2,4,0,0,10,271
141050416,74,3,10,2,0,3,3,95
141050501,43,15,1,2,0,0,7,68
141050502,99,16,1,1,1,6,11,135
141050503,242,21,4,1,0,6,16,290
141050504,166,13,0,1,0,2,49,231
141050505,297,16,5,14,0,0,8,340
141050506,240,24,26,14,0,1,4,309
141050507,230,24,2,0,0,2,2,260
141050508,285,20,5,1,2,2,7,322
141050509,208,15,1,0,0,0,2,226
141050510,286,22,12,7,0,0,4,331
141050511,193,24,6,3,3,0,2,231
141050512,220,27,8,14,2,2,7,280
141050513,135,6,9,3,3,0,0,156
141050514,384,25,6,6,3,0,2,426
141050515,244,26,11,10,1,11,5,308
141050601,67,5,0,0,0,3,27,102
141050602,79,20,1,2,0,5,7,114
141050603,55,11,0,2,0,4,32,104
141050604,113,2,0,0,1,20,23,159
141050605,81,14,0,8,0,5,27,135
141050606,168,25,3,4,0,1,2,203
141050607,180,13,4,4,2,0,2,205
141050608,292,12,2,6,2,3,8,325
141050609,290,30,11,20,4,1,12,368
141050610,341,40,6,3,2,0,7,399
141050611,309,15,8,9,2,2,15,360
141050612,369,27,14,27,1,0,7,445
141050613,98,5,0,7,0,3,8,121
141120101,16,0,0,0,0,2,1,19
141120102,39,1,0,0,0,0,10,50
141120103,46,20,0,1,0,0,1,68
141120104,94,8,1,4,7,3,31,148
141120105,42,22,0,7,1,4,2,78
141120106,83,9,1,2,0,3,19,117
141120107,24,5,0,0,0,20,10,59
141120108,37,6,0,3,0,2,12,60
141120109,195,32,2,5,2,3,6,245
141120110,188,7,4,7,4,11,10,231
141120111,128,11,4,5,3,1,0,152
141120112,287,20,5,15,1,4,14,346
141120113,196,24,4,10,39,2,13,288
141120114,82,19,2,1,1,0,4,109
141120115,175,36,11,38,1,1,3,265
141120201,172,36,1,5,3,1,15,233
141120202,23,2,0,0,0,2,5,32
141120203,20,5,0,0,0,0,0,25
141120204,19,7,0,0,0,0,0,26
141120205,19,2,0,0,0,0,1,22
141120206,51,3,0,0,0,1,0,55
141120207,128,19,0,16,0,0,8,171
141120301,34,15,0,0,0,9,20,78
141120302,88,0,0,9,0,30,13,140
141120303,38,13,0,0,1,1,0,53
141120304,184,44,2,16,0,13,34,293
141120305,70,3,0,0,0,0,17,90
141120306,119,19,0,2,3,4,10,157
141120307,68,0,0,1,0,0,2,71
141120308,36,2,0,0,0,2,8,48
141120309,68,12,0,18,0,0,4,102
141120310,197,30,3,10,1,16,3,260
141120311,186,26,3,17,0,5,2,239
141120312,247,21,1,11,2,2,12,296
141120313,223,25,3,4,1,0,4,260
141120314,66,32,3,3,1,55,5,165
141190101,253,46,2,9,4,6,17,337
141190102,73,28,0,2,1,5,30,139
141190103,50,10,0,0,0,3,19,82
141190104,17,5,0,0,0,1,13,36
141190105,25,8,0,0,0,0,8,41
141190106,200,16,6,14,2,0,5,243
141190107,187,15,8,6,0,1,6,223
141190108,322,15,7,5,0,1,3,353
141190109,366,24,9,10,3,0,6,418
141190110,152,9,2,4,1,0,11,179
141190111,253,13,16,14,5,1,4,306
141190112,318,24,7,16,0,0,9,374
141190113,237,18,2,3,2,1,4,267
141190114,274,14,1,1,1,0,3,294
141190115,316,14,12,5,3,0,3,353
141190201,13,0,0,0,0,0,9,22
141190202,21,8,0,0,0,15,5,49
141190203,14,0,0,1,0,3,20,38
141190204,16,7,0,0,0,0,0,23
141190205,54,9,0,0,0,0,6,69
141190206,8,9,0,0,0,3,0,20
141190207,4,0,0,0,0,0,4,8
141190208,4,0,0,0,0,0,2,6
141190209,23,13,1,1,0,6,25,69
141190210,15,5,0,0,0,7,20,47
141190211,26,3,0,2,2,3,26,62
141190212,144,4,1,5,1,0,2,157
141190213,313,5,9,13,2,2,11,355
141190214,238,7,5,0,4,3,3,260
141190215,211,12,11,5,1,1,3,244
141190301,107,14,1,1,1,3,14,141
141190302,88,9,0,0,0,4,38,139
141190303,67,4,0,0,0,10,36,117
141190304,36,0,0,1,0,6,13,56
141190305,30,8,0,0,0,1,25,64
141190306,285,10,5,6,2,0,16,324
141190307,283,18,4,8,0,1,14,328
141190308,281,13,9,17,1,0,13,334
141190309,95,18,0,1,0,0,6,120
141190310,230,16,4,3,1,0,3,257
141190311,221,11,5,1,0,0,6,244
141190312,196,10,4,1,1,1,6,219
141190313,207,5,1,4,1,0,2,220
141190314,400,6,3,5,3,4,10,431
141190315,312,13,3,1,5,1,17,352
141190316,330,16,4,4,2,6,15,377
141190401,13,3,0,0,1,0,10,27
141190402,30,2,2,2,0,5,6,47
141190403,18,34,0,0,0,0,2,54
141190404,26,8,1,0,0,7,32,74
141190405,20,0,0,0,0,0,33,53
141190406,33,13,0,0,0,2,33,81
141190407,51,0,0,0,0,4,39,94
141190408,54,33,3,0,0,0,16,106
141190409,118,3,0,0,0,2,21,144
141190410,362,4,5,1,0,2,8,382
141190411,371,7,6,3,0,1,8,396
141190412,248,12,7,9,1,0,8,285
141190413,343,23,9,10,6,2,12,405
141190414,288,11,2,8,3,0,9,321
141190415,233,23,8,4,0,0,6,274
141190416,202,13,9,3,0,1,0,228
141190417,205,10,4,10,0,2,6,237
141190418,379,32,10,10,3,0,8,442
141190419,273,13,9,7,5,1,3,311
141190420,255,15,5,4,0,0,3,282
141190501,82,13,0,1,1,2,28,127
141190502,14,1,0,0,0,0,14,29
141190503,63,0,1,0,0,2,45,111
141190504,71,15,0,0,1,3,54,144
141190505,38,5,0,0,0,0,10,53
141190506,32,7,0,0,0,0,25,64
141190507,11,4,0,0,0,0,15,30
141190508,36,3,0,0,0,0,2,41
141190509,16,3,0,0,0,0,35,54
141190510,16,7,0,1,0,0,6,30
141190511,269,13,6,7,4,1,8,308
141190512,269,12,9,3,0,3,12,308
141190513,217,8,6,2,2,0,2,237
141190514,285,8,3,1,1,1,4,303
141190515,238,14,3,2,2,1,5,265
141190601,326,20,2,5,0,3,6,362
141190602,327,21,2,6,0,0,8,364
141190603,292,25,10,10,2,2,13,354
141190604,241,21,9,3,1,0,4,279
141190605,361,36,3,3,1,4,9,417
141190606,357,25,8,9,1,1,4,405
141190607,300,22,6,5,8,1,11,353
141190608,218,21,9,13,10,1,9,281
141190609,252,21,8,10,8,2,6,307
141190610,235,12,2,5,0,1,8,263
141190611,272,19,7,7,1,1,5,312
141190612,274,18,8,5,2,1,8,316
141190613,222,15,6,0,4,1,15,263
141190614,156,9,9,2,3,0,5,184
141190615,202,11,2,2,1,1,2,221
141190616,229,19,5,4,0,0,1,258
141190617,215,18,0,0,0,0,0,233
141190618,248,22,5,9,5,0,5,294
141190619,275,10,3,11,2,1,3,305
141190620,267,19,4,9,1,0,2,302
141190621,268,10,3,10,0,0,8,299
141190701,291,14,1,12,0,2,4,324
141190702,291,23,7,7,3,0,11,342
141190703,427,41,7,26,1,2,16,520
141190704,343,41,11,13,2,2,11,423
141190705,322,14,11,3,1,1,6,358
141190706,353,20,11,22,7,1,14,428
141190707,301,18,8,4,8,2,8,349
141190708,290,18,5,8,0,2,8,331
141190709,283,41,7,6,0,1,6,344
141190710,343,24,4,5,3,0,7,386
141190711,225,19,19,12,1,0,5,281
141190712,253,6,4,9,1,1,1,275
141190713,255,25,2,3,0,0,2,287
141190714,206,14,14,9,0,2,2,247
141190801,244,22,2,20,0,6,3,297
141190802,208,14,2,8,1,1,3,237
141190803,190,12,2,10,2,32,10,258
141190804,233,28,2,7,3,8,7,288
141190805,235,24,6,0,6,2,9,282
141190806,210,9,2,1,0,2,2,226
141190807,221,13,4,5,1,2,1,247
141190808,331,19,6,6,2,1,8,373
141190809,320,42,6,7,5,3,13,396
141190810,326,24,9,4,9,1,13,386
141190811,296,42,7,4,2,0,11,362
141190812,313,30,7,5,6,0,10,371
141190813,291,34,8,8,16,2,7,366
141190814,292,27,4,6,3,1,6,339
141190815,386,21,0,0,0,0,13,420
141190816,236,14,3,5,4,0,7,269
141190817,229,13,0,2,0,0,8,252
141190901,242,10,3,5,1,0,4,265
141190902,275,17,3,1,3,2,8,309
141190903,169,7,4,2,1,0,4,187
141190904,240,11,8,15,2,0,4,280
141190905,238,13,4,3,7,1,5,271
141190906,220,17,2,6,2,0,3,250
141190907,195,17,1,4,0,0,1,218
141190908,231,17,2,4,0,1,9,264
141190909,242,21,10,8,4,0,10,295
141190910,158,19,18,2,3,0,9,209
141190911,288,14,4,2,0,0,13,321
141190912,352,17,13,24,2,4,3,415
141190913,182,18,11,1,3,2,5,222
141190914,307,18,8,4,1,0,9,347
141190915,220,22,4,3,8,1,5,263
141190916,303,12,4,15,0,0,2,336
141190917,339,23,8,8,1,4,7,390
141260101,43,1,0,3,0,10,8,65
141260102,44,12,1,4,0,10,11,82
141260103,41,35,0,2,0,3,1,82
141260104,51,7,0,0,0,0,5,63
141260105,12,2,0,0,0,4,1,19
141260106,32,2,0,0,0,10,2,46
141260107,44,5,0,1,0,12,2,64
141260108,52,11,0,1,0,0,5,69
141260109,116,34,1,8,0,22,8,189
141260201,45,3,0,0,0,0,4,52
141260202,9,1,0,0,0,1,1,12
141260203,25,7,0,0,0,0,0,32
141260204,60,4,1,2,1,2,0,70
141260205,23,0,0,0,0,0,4,27
141260206,204,22,0,2,1,1,16,246
141260207,34,8,0,4,0,0,3,49
141260208,92,27,0,4,2,0,1,126
141260301,16,1,0,3,0,1,1,22
141260302,3,0,0,0,0,2,1,6
141260303,111,34,4,7,2,37,10,205
141260304,236,19,3,4,0,28,33,323
141260305,46,7,5,11,0,8,13,90
141260306,40,24,2,3,0,3,11,83
141260307,181,36,18,28,0,29,3,295
141260308,246,27,12,14,0,30,20,349
141260309,162,25,21,3,1,73,5,290
141260310,122,32,25,6,0,62,12,259
141260311,248,60,13,7,3,48,12,391
141260312,231,9,85,10,1,99,8,443
141260313,211,8,5,15,1,39,11,290
141260314,282,27,9,7,0,18,4,347
141260401,94,8,11,8,3,22,10,156
141260402,35,12,0,0,0,1,0,48
141260403,34,7,1,2,1,14,3,62
141260404,102,9,0,4,1,21,7,144
141260405,40,3,5,7,3,12,13,83
141260406,134,33,11,15,0,57,7,257
141260501,17,16,0,0,0,3,1,37
141260502,96,13,2,3,0,2,6,122
141260503,6,1,0,0,0,0,10,17
141260504,96,8,0,3,0,9,11,127
141260505,84,24,0,2,0,2,4,116
141260506,59,8,0,6,0,0,5,78
141260507,103,12,0,27,0,0,1,143
141260508,229,15,0,24,2,4,2,276
141260509,304,15,0,16,0,4,8,347
141260510,219,7,0,14,0,3,2,245
141260511,237,17,3,1,1,1,3,263
141260512,347,21,3,2,5,1,9,388
141260513,137,8,0,7,0,2,7,161
141260514,193,18,1,8,0,3,6,229
141260515,118,5,1,1,1,2,3,131
141260516,202,2,3,10,0,4,2,223
141260517,145,12,0,1,4,1,2,165
141260518,123,9,0,7,0,0,2,141
141260601,64,26,0,0,0,3,5,98
141260602,26,5,0,0,0,7,4,42
141260603,111,9,6,7,0,54,8,195
141260604,107,15,6,3,0,37,12,180
141260605,124,58,2,27,0,23,4,238
141260606,7,2,0,0,0,0,1,10
141260607,133,14,1,12,0,31,11,202
141260608,183,21,30,3,1,55,28,321
141260609,159,19,27,7,0,129,10,351
141260610,176,42,15,30,0,83,18,364
141260611,35,25,7,2,0,17,1,87
141260701,152,22,30,6,0,69,21,300
141260702,211,43,15,11,1,49,15,345
141260703,158,34,24,5,3,44,8,276
141260704,199,27,11,8,0,25,5,275
141260705,250,90,21,7,1,36,6,411
141260706,211,13,44,16,5,69,9,367
141260707,190,11,21,6,0,37,9,274
141260708,247,24,16,12,1,54,16,370
141260709,191,17,17,4,1,78,9,317
141260710,135,12,14,8,1,38,1,209
141260711,188,28,21,4,1,19,5,266
141260712,255,28,7,22,2,9,7,330
141260713,88,9,9,13,4,52,1,176
141330101,21,2,0,1,0,0,15,39
141330102,98,2,0,0,0,2,12,114
141330103,123,8,2,1,0,1,5,140
141330104,117,5,1,1,1,1,12,138
141330105,265,14,3,8,1,5,14,310
141330106,23,8,0,2,0,1,7,41
141330107,40,9,1,3,1,1,4,59
141330108,208,19,1,1,1,5,18,253
141330109,80,4,0,4,0,0,5,93
141330110,258,9,3,12,5,2,9,298
141330111,310,12,2,5,1,0,11,341
141330112,228,9,6,6,1,1,24,275
141330201,160,28,4,18,1,29,9,249
141330202,73,11,2,0,1,8,5,100
141330203,60,8,0,3,0,8,18,97
141330204,264,14,3,13,2,13,9,318
141330205,69,2,0,4,0,3,1,79
141330206,72,0,2,8,1,12,3,98
141330207,120,15,0,4,2,19,3,163
141330208,201,32,9,4,7,88,4,345
141330209,112,13,4,8,9,74,22,242
141330210,61,1,1,11,1,20,18,113
141330211,178,17,7,23,1,34,13,273
141330212,170,19,5,12,0,21,23,250
141330213,337,22,18,17,3,45,27,469
141330214,202,19,9,19,2,27,10,288
141330215,55,22,2,5,0,8,3,95
141330216,179,11,10,7,1,14,12,234
141330301,79,15,1,6,1,21,5,128
141330302,123,4,3,5,0,18,7,160
141330303,65,11,0,0,0,3,2,81
141330304,136,0,0,3,1,3,21,164
141330305,118,20,1,8,2,17,1,167
141330306,92,6,4,7,1,27,10,147
141330307,330,56,12,16,6,93,14,527
141330308,123,35,5,11,6,43,10,233
141330309,208,35,6,9,1,22,4,285
141330401,24,3,0,0,0,0,13,40
141330402,44,3,0,1,0,5,11,64
141330403,46,9,0,27,0,0,6,88
141330404,60,13,0,1,0,16,9,99
141330405,127,8,4,7,0,18,24,188
141330406,54,8,1,5,0,6,9,83
141330407,69,18,1,2,0,0,13,103
141330408,128,33,0,2,0,4,4,171
141330409,356,39,6,15,11,35,27,489
141330410,132,4,12,8,2,71,2,231
141330411,171,24,14,5,4,28,31,277
141330501,308,9,4,1,1,3,14,340
141330502,208,16,5,3,15,1,23,271
141330503,210,21,8,7,8,4,12,270
141330504,201,13,1,1,0,0,7,223
141330505,234,14,0,9,3,2,3,265
141330506,299,19,11,7,7,2,13,358
141330507,250,39,8,2,3,2,2,306
141330508,241,32,18,2,12,4,5,314
141330509,226,27,5,6,10,2,7,283
141330510,340,26,4,10,12,4,12,408
141330511,238,28,5,8,1,3,9,292
141330512,313,4,3,7,0,6,19,352
141330513,241,15,2,7,1,1,2,269
141330514,120,9,2,6,0,1,6,144
141330515,349,26,2,6,1,2,3,389
141330516,243,12,3,4,0,3,5,270
141330517,219,13,2,1,0,1,2,238
141330601,281,21,8,4,1,1,11,327
141330602,385,26,6,7,1,5,7,437
141330603,275,15,3,12,4,5,12,326
141330604,236,22,4,8,0,15,3,288
141330605,248,14,2,7,1,2,3,277
141330606,173,24,7,11,0,17,27,259
141330607,270,9,1,2,1,3,3,289
141330608,231,22,4,17,0,2,9,285
141330609,236,50,10,0,5,0,3,304
141330610,270,42,4,5,4,0,44,369
141330611,187,4,7,4,1,1,0,204
141330612,159,5,1,7,1,1,18,192
141330613,306,20,2,13,2,7,7,357
141330614,290,17,3,22,2,4,11,349
141330615,224,21,12,9,2,3,8,279
141330616,231,19,2,4,1,2,8,267
141330617,195,27,9,5,0,4,21,261
141400101,38,1,5,0,0,2,0,46
141400102,37,0,0,0,0,0,23,60
141400103,101,5,0,7,0,3,21,137
141400104,39,0,1,1,0,3,0,44
141400105,29,0,0,0,0,0,13,42
141400106,17,0,0,0,0,4,6,27
141400107,26,0,0,0,0,3,3,32
141400108,45,1,0,0,2,0,11,59
141400109,288,8,6,6,0,4,3,315
141400110,181,10,5,8,1,0,13,218
141400111,232,22,5,3,0,3,4,269
141400112,243,6,7,8,0,3,8,275
141400113,63,5,3,1,0,4,10,86
141400201,38,20,4,0,0,0,1,63
141400202,97,13,0,1,0,1,12,124
141400203,49,5,0,1,0,2,17,74
141400204,89,23,0,0,1,0,4,117
141400205,30,6,0,0,0,1,0,37
141400206,82,13,0,5,1,7,10,118
141400207,24,1,0,0,0,1,9,35
141400208,59,5,0,1,0,0,14,79
141400209,44,4,0,2,0,0,5,55
141400210,23,0,0,0,0,0,17,40
141400211,173,5,8,2,0,2,9,199
141400212,226,13,6,14,0,2,7,268
141400213,96,8,5,6,0,3,1,119
141400301,335,14,4,4,0,1,4,362
141400302,384,13,7,15,1,0,12,432
141400303,214,14,5,6,0,0,3,242
141400304,200,19,3,8,0,0,3,233
141400305,307,15,8,5,1,3,2,341
141400306,269,21,8,7,0,1,1,307
141400307,271,20,2,1,1,0,4,299
141400308,325,20,7,4,1,1,7,365
141400309,207,8,0,3,2,0,2,222
141400310,269,13,11,5,5,1,7,311
141400311,224,19,11,1,4,0,8,267
141400312,249,12,3,3,1,1,4,273
141400313,124,9,4,7,4,2,1,151
141400401,214,18,7,2,7,3,9,260
141400402,228,10,3,3,3,0,0,247
141400403,181,11,7,24,6,0,3,232
141400404,204,29,2,5,4,0,5,249
141400405,211,29,9,1,24,2,11,287
141400406,240,39,6,2,10,1,10,308
141400407,328,23,5,8,2,0,4,370
141400408,312,15,3,9,0,0,17,356
141400409,348,20,2,2,0,0,5,377
141400410,227,14,0,2,0,0,5,248
141400411,177,34,10,8,0,0,2,231
141400412,306,22,5,19,1,0,10,363
141400413,270,23,4,4,1,2,5,309
141400501,67,22,0,0,0,2,44,135
141400502,85,1,0,2,0,8,17,113
141400503,35,2,0,0,0,0,11,48
141400504,41,0,0,0,0,0,50,91
141400505,54,3,0,0,0,0,20,77
141400506,50,22,2,0,0,1,17,92
141400507,10,0,0,0,0,0,9,19
141400508,307,46,27,6,2,22,24,434
141400509,284,23,33,13,3,52,11,419
141400510,97,5,4,1,0,1,4,112
141400511,312,17,5,7,1,2,7,351
141400512,219,15,7,3,0,2,4,250
141400513,193,11,4,6,0,1,9,224
141400514,275,21,4,4,1,0,12,317
141400515,262,21,9,5,0,0,2,299
141400516,268,23,6,11,0,0,11,319
141400517,186,15,1,5,1,3,9,220
141400518,188,13,5,4,0,1,7,218
141400519,199,13,4,2,0,2,17,237
141400520,368,16,4,9,4,2,25,428
141400601,13,2,0,0,0,0,6,21
141400602,28,3,1,0,0,0,23,55
141400603,19,1,0,0,0,0,13,33
141400604,85,14,0,0,0,1,11,111
141400605,63,10,0,1,0,0,29,103
141400606,46,6,0,1,0,1,26,80
141400607,42,2,0,1,0,1,36,82
141400608,43,1,0,3,0,4,24,75
141400609,25,1,0,0,0,2,16,44
141400610,369,22,2,17,4,1,7,422
141400611,235,18,4,4,1,3,7,272
141400612,193,32,0,3,0,1,5,234
141400613,112,16,4,4,9,3,8,156
141400614,245,21,7,5,1,4,7,290
141400615,145,11,2,4,0,0,4,166
141400616,365,30,5,9,1,2,6,418
141400617,183,13,5,1,1,2,13,218
141400618,184,13,8,3,1,0,5,214
141400619,320,15,4,5,0,0,10,354
141400701,238,6,6,2,0,0,3,255
141400702,334,14,7,10,2,3,11,381
141400703,239,10,9,4,2,2,6,272
141400704,194,8,6,4,3,1,4,220
141400705,359,34,8,10,0,4,1,416
141400706,354,24,9,10,3,1,5,406
141400707,192,9,4,0,0,1,4,210
141400708,174,25,9,0,3,1,6,218
141400709,216,19,1,6,0,1,5,248
141400710,342,20,6,30,0,2,10,410
141400711,323,29,3,5,4,1,8,373
141400712,212,24,7,4,6,6,23,282
141400713,325,11,4,4,2,0,4,350
141400714,276,5,4,3,0,1,4,293
141400715,269,13,5,4,2,1,1,295
141400716,310,17,11,4,6,2,11,361
141400717,116,3,3,9,1,1,4,137
141400718,344,12,7,1,4,0,4,372
141400719,285,10,2,9,0,1,4,311
141400720,272,42,0,14,0,21,2,351
141400801,157,3,0,2,2,3,41,208
141400802,94,7,0,0,0,1,81,183
141400803,137,5,0,3,0,2,53,200
141400804,173,3,1,0,0,0,20,197
141400805,62,1,0,0,0,0,10,73
141400806,38,3,0,0,0,1,10,52
141400807,74,2,0,0,0,1,8,85
141400808,75,4,0,1,0,2,32,114
141400809,283,8,5,16,3,0,5,320
141400810,238,6,0,2,0,0,0,246
141400811,203,9,3,1,0,0,4,220
141400812,339,10,9,6,0,0,8,372
141400813,257,20,13,5,0,1,2,298
141400814,208,9,5,5,0,2,4,233
141400815,239,9,2,5,0,1,2,258
141400816,238,23,5,3,1,0,6,276
141400817,261,25,9,7,4,0,12,318
141400818,298,10,3,6,0,0,5,322
141400819,259,14,6,10,0,6,3,298
141400820,341,31,3,7,0,5,6,393
141400821,176,8,1,7,1,0,6,199
141400901,63,1,0,0,0,0,5,69
141400902,29,0,0,0,0,0,15,44
141400903,68,5,0,0,2,0,32,107
141400904,129,3,0,0,2,0,51,185
141400905,54,5,0,0,0,0,7,66
141400906,82,15,0,0,0,0,44,141
141400907,38,0,0,0,0,3,30,71
141400908,271,12,3,4,3,1,6,300
141400909,288,24,4,9,2,0,4,331
141400910,245,11,3,4,0,1,7,271
141400911,341,18,20,6,5,3,9,402
141400912,206,17,3,6,0,1,2,235
141400913,269,15,11,6,9,1,14,325
141400914,293,8,2,9,0,1,1,314
141400915,367,15,6,9,1,4,6,408
141400916,179,5,2,1,2,0,5,194
141401001,69,4,0,1,1,1,69,145
141401002,66,5,1,0,0,2,32,106
141401003,66,0,0,0,0,5,39,110
141401004,45,0,0,0,0,0,42,87
141401005,39,1,0,0,0,0,27,67
141401006,106,23,5,0,0,9,7,150
141401007,71,5,3,7,1,13,10,110
141401008,179,4,0,3,2,2,12,202
141401009,215,13,2,6,1,0,4,241
141401010,267,10,6,2,2,4,3,294
141401011,260,10,3,7,2,1,4,287
141401012,357,21,5,6,2,0,5,396
141401013,156,4,2,1,5,0,16,184
141401014,208,8,3,3,0,0,0,222
141401015,277,16,4,4,0,2,6,309
141401016,337,22,11,7,1,2,7,387
141401017,272,9,6,11,1,3,7,309
141401101,136,39,1,33,0,54,0,263
141401102,212,18,9,13,3,35,3,293
141401103,351,11,7,3,4,1,13,390
141401104,208,7,7,1,3,3,7,236
141401105,286,21,7,7,1,0,5,327
141401106,190,9,6,7,2,2,3,219
141401107,207,12,2,4,7,0,11,243
141401108,448,14,3,7,6,1,4,483
141401109,239,3,3,11,0,0,2,258
141401110,281,28,5,14,0,2,5,335
141401111,236,17,4,3,7,1,7,275
141401112,213,12,7,3,0,0,4,239
141401113,283,24,7,1,2,2,12,331
141401114,254,10,10,5,14,1,13,307
141401115,196,20,16,1,11,1,15,260
141401116,193,33,11,0,13,3,4,257
141401117,182,31,11,4,17,1,11,257
141401118,323,50,32,2,8,4,11,430
141401119,305,23,10,8,11,0,11,368
141401120,348,41,8,4,4,3,6,414
141401121,328,46,7,11,0,0,2,394
141401201,198,26,1,18,0,23,8,274
141401202,172,12,7,4,1,25,8,229
141401203,235,8,1,2,1,1,3,251
141401204,227,4,3,6,2,0,7,249
141401205,330,13,1,6,0,0,2,352
141401206,333,10,0,6,1,0,3,353
141401207,286,18,10,2,3,1,5,325
141401208,267,38,5,3,3,1,9,326
141401209,255,17,5,1,1,1,5,285
141401210,323,13,7,2,4,0,13,362
141401211,353,26,6,4,0,0,6,395
141401212,296,22,5,2,2,0,2,329
141401213,253,9,0,3,2,1,7,275
141401214,209,8,12,3,6,2,15,255
141401215,217,21,23,5,14,3,22,305
141401216,204,42,6,0,13,0,16,281
141401217,267,33,28,42,7,2,32,411
141401218,187,28,7,4,10,1,8,245
141401219,217,18,5,4,1,0,9,254
141401301,209,25,33,6,24,1,15,313
141401302,217,26,10,0,15,2,14,284
141401303,198,17,20,5,15,1,13,269
141401304,245,8,3,6,17,2,10,291
141401305,267,10,11,3,3,1,10,305
141401306,238,24,7,3,7,0,5,284
141401307,188,10,7,4,5,0,13,227
141401308,171,18,12,2,5,0,21,229
141401309,233,10,1,1,5,0,8,258
141401310,222,20,10,2,4,0,6,264
141401311,239,16,7,1,5,1,11,280
141401312,223,18,5,6,3,0,10,265
141401313,281,17,4,2,1,0,4,309
141401314,200,0,16,5,3,5,15,244
141401315,304,10,5,7,1,0,7,334
141401316,259,13,9,5,3,0,6,295
141401317,308,13,6,27,1,0,4,359
141401318,227,2,6,11,4,0,7,257
141401401,312,12,5,4,8,2,45,388
141401402,252,23,1,5,0,0,6,287
141401403,232,8,2,3,3,3,4,255
141401404,261,15,20,5,7,1,17,326
141401405,277,17,9,3,6,0,15,327
141401406,185,10,10,1,4,0,19,229
141401407,228,16,44,3,20,1,5,317
141401408,149,8,7,6,3,0,5,178
141401409,177,6,6,1,2,1,4,197
141401410,178,18,3,5,2,0,10,216
141401411,236,16,3,8,2,0,7,272
141401412,307,5,1,1,0,0,1,315
141401413,377,19,4,14,3,1,5,423
141401414,386,14,0,2,0,0,2,404
141401415,306,4,1,1,0,0,4,316
141401416,305,15,3,6,1,0,7,337
141401417,251,14,11,1,3,0,3,283
141401418,293,11,4,7,0,1,11,327
141401419,265,6,0,0,0,0,6,277
141401420,198,8,8,0,1,0,2,217
141401421,216,12,5,4,1,1,13,252
141401422,189,2,0,2,1,0,0,194
141401423,251,9,5,6,0,0,7,278
141401501,73,13,0,0,0,1,12,99
141401502,55,7,0,0,0,5,8,75
141401503,64,6,1,0,2,8,37,118
141401504,74,12,0,0,0,2,29,117
141401505,77,12,0,0,0,4,26,119
141401506,49,5,0,0,0,0,19,73
141401507,216,9,4,10,0,2,12,253
141401508,170,9,3,7,0,2,2,193
141401509,243,8,5,9,4,1,7,277
141401510,300,18,4,0,4,2,3,331
141401511,274,15,8,2,4,0,5,308
141401512,329,15,1,6,6,0,13,370
141401513,421,31,8,21,2,0,7,490
141401514,110,2,1,9,4,1,10,137
141401515,97,9,0,2,1,1,7,117
141401601,37,0,0,0,0,0,56,93
141401602,56,6,0,0,0,0,52,114
141401603,48,49,0,0,0,0,51,148
141401604,11,1,0,0,0,0,23,35
141401605,84,16,0,0,0,1,27,128
141401606,75,13,0,0,0,7,22,117
141401607,207,9,1,3,1,0,9,230
141401608,354,34,8,9,4,3,6,418
141401609,239,8,5,4,2,3,12,273
141401610,347,18,7,10,0,0,9,391
141401611,343,21,2,7,0,1,7,381
141401612,225,16,1,5,0,0,1,248
141401613,186,15,2,0,0,3,2,208
141401614,260,2,2,1,1,1,11,278
141401615,204,0,2,4,3,2,1,216
141401701,56,23,0,0,0,0,6,85
141401702,60,6,0,0,0,0,18,84
141401703,38,0,0,0,0,0,14,52
141401704,23,1,0,0,0,0,49,73
141401705,81,7,0,0,0,2,32,122
141401706,49,3,0,1,1,5,32,91
141401707,20,2,0,0,0,0,9,31
141401708,69,10,0,0,0,7,48,134
141401709,101,4,0,9,0,1,4,119
141401710,64,13,0,4,1,3,25,110
141401711,344,25,3,5,1,0,14,392
141401712,200,6,2,6,1,0,4,219
141401713,169,14,7,1,9,0,3,203
141401714,359,28,9,11,4,2,10,423
141401715,264,16,3,8,0,0,11,302
141401716,208,9,1,2,1,2,0,223
141401717,248,13,3,2,1,0,1,268
141401718,63,2,0,0,0,0,2,67
141401719,245,15,1,6,1,1,8,277
141401720,194,4,2,4,8,7,7,226
141401801,216,16,0,2,0,0,3,237
141401802,242,21,2,5,1,0,1,272
141401803,227,12,3,6,0,2,5,255
141401804,218,6,1,0,0,1,5,231
141401805,224,15,0,3,0,0,8,250
141401806,243,23,2,3,2,2,3,278
141401807,204,28,3,1,1,0,6,243
141401808,290,9,6,1,3,0,26,335
141401809,267,16,9,1,7,1,16,317
141401810,210,18,12,2,5,0,6,253
141401811,249,12,4,3,3,2,7,280
141401812,227,12,1,1,0,0,3,244
141401901,355,30,5,26,1,0,10,427
141401902,220,16,10,5,1,0,5,257
141401903,163,17,5,3,1,2,8,199
141401904,182,26,1,0,1,0,11,221
141401905,137,2,0,9,1,1,3,153
141401906,216,18,12,9,4,1,6,266
141401907,201,13,6,1,2,0,9,232
141401908,205,8,4,0,0,0,3,220
141401909,257,16,5,25,0,2,8,313
141401910,399,24,8,24,1,2,2,460
141401911,217,17,2,0,0,1,2,239
141470101,27,2,84,1,0,2,4,120
141470102,172,38,2,72,0,5,5,294
141470103,168,39,0,14,0,4,1,226
141470104,309,25,7,14,1,4,23,383
141470105,342,16,6,8,7,1,7,387
141470106,231,13,1,1,0,0,3,249
141470107,268,14,1,13,0,0,5,301
141470108,148,1,0,0,0,0,0,149
141470109,353,22,1,19,0,0,3,398
141470110,344,20,3,11,0,0,1,379
141470111,260,12,1,0,0,0,4,277
141470112,234,19,1,1,0,0,8,263
141470113,198,17,7,1,4,0,7,234
141470114,277,21,1,4,3,0,6,312
141470201,155,17,2,4,0,42,33,253
141470202,451,52,5,39,3,27,30,607
141470203,49,14,0,1,0,3,12,79
141470204,205,28,2,10,0,9,25,279
141470205,277,28,1,6,2,8,32,354
141470206,57,9,0,1,0,4,12,83
141470207,285,12,4,15,2,4,8,330
141470208,237,23,3,16,2,3,17,301
141470209,210,11,1,6,1,2,2,233
141470210,336,10,3,18,0,2,2,371
141470211,223,15,9,11,14,2,10,284
141470212,200,16,0,3,1,1,3,224
141470213,190,11,4,8,0,0,5,218
141470301,29,3,0,4,0,5,0,41
141470302,44,50,5,10,0,5,3,117
141470303,126,10,1,3,1,31,3,175
141470304,121,8,4,15,1,152,17,318
141470305,79,45,4,4,0,69,23,224
141470306,23,3,0,2,0,1,1,30
141470307,144,7,5,7,0,6,7,176
141470308,320,37,1,13,0,4,24,399
141470309,246,12,5,11,0,27,42,343
141470310,287,26,3,18,0,34,21,389
141470311,184,4,9,14,1,189,20,421
141470312,141,10,8,13,0,46,4,222
141470313,115,3,24,8,0,126,9,285
141470314,124,5,58,5,2,138,0,332
141470401,53,9,0,0,0,1,10,73
141470402,39,4,3,3,0,48,10,107
141470403,60,1,0,0,0,1,24,86
141470404,12,0,0,0,0,4,24,40
141470405,166,7,4,2,1,1,3,184
141470406,138,10,2,1,1,2,14,168
141470407,309,20,3,10,5,0,9,356
141470408,330,33,1,22,9,2,19,416
141470409,175,10,6,4,2,0,7,204
141470410,228,18,1,2,0,0,0,249
141470411,238,32,4,2,20,0,2,298
141470412,342,40,4,5,1,0,14,406
141470413,173,5,0,1,3,1,4,187
141470501,30,4,0,0,0,2,8,44
141470502,28,28,0,0,0,0,0,56
141470503,43,7,0,0,0,1,23,74
141470504,49,4,0,0,0,3,42,98
141470505,21,19,0,0,0,6,19,65
141470506,11,4,0,0,0,4,20,39
141470507,106,9,12,1,0,0,2,130
141470508,195,23,3,3,1,0,8,233
141470601,129,33,10,9,3,46,30,260
141470602,70,37,0,3,2,55,4,171
141470603,132,27,26,15,2,74,52,328
141470604,112,1,12,4,0,141,9,279
141470605,89,6,7,7,1,83,5,198
141470606,150,16,6,15,2,114,9,312
141470607,120,45,7,16,1,48,1,238
141470608,154,54,1,31,0,76,32,348
141470609,110,8,2,11,2,70,28,231
141470610,158,19,5,19,1,43,17,262
141470701,27,4,2,2,0,86,8,129
141470702,12,9,0,1,0,36,2,60
141470703,17,1,0,0,0,19,3,40
141470704,47,2,0,2,0,5,48,104
141470705,2,0,0,0,0,4,1,7
141470706,25,2,0,0,0,14,4,45
141470707,30,4,1,6,1,74,1,117
141470708,35,2,1,2,0,78,4,122
141470709,59,34,4,3,1,71,7,179
141470710,95,17,5,14,1,139,6,277
141470711,90,55,8,14,3,115,35,320
141470712,61,131,12,17,0,154,3,378
141470713,45,6,4,7,0,87,6,155
141470714,150,70,7,4,0,77,9,317
141470801,257,30,8,17,1,18,17,348
141470802,314,19,6,23,0,1,5,368
141470803,331,45,3,79,0,1,5,464
141470804,228,5,1,1,0,0,0,235
141470805,459,22,7,9,1,0,13,511
141470806,378,23,6,0,2,1,6,416
141470807,285,16,10,12,3,2,3,331
141470808,274,19,4,6,2,0,16,321
141470809,252,22,3,5,3,2,9,296
141470810,168,23,7,0,6,2,7,213
141470811,228,22,18,6,2,0,9,285
141470812,327,24,7,21,1,8,12,400
141470813,256,33,13,10,11,1,7,331
141470814,244,18,3,1,1,0,2,269
141470815,222,26,5,1,6,0,6,266
141470816,202,17,13,3,24,1,46,306
141470817,122,18,6,2,16,0,18,182
141470901,291,13,0,10,1,0,12,327
141470902,370,3,1,5,3,0,4,386
141470903,380,6,8,7,5,7,14,427
141470904,202,6,7,5,0,2,2,224
141470905,217,0,6,14,0,2,10,249
141470906,321,13,4,14,8,2,9,371
141470907,169,14,4,3,5,0,3,198
141470908,293,22,10,3,0,2,9,339
141470909,207,20,10,2,8,0,7,254
141470910,199,13,2,6,0,0,6,226
141470911,188,17,3,3,0,0,6,217
141470912,339,27,9,12,0,4,6,397
141470913,376,29,17,17,0,2,11,452
141470914,236,15,11,1,3,2,16,284
141470915,258,11,8,9,1,2,7,296
141470916,229,25,1,4,0,2,3,264
141470917,183,12,6,5,0,0,9,215
141470918,204,10,2,3,1,3,9,232
141470919,262,8,3,8,0,4,1,286
141471001,216,18,9,5,0,5,7,260
141471002,268,12,8,12,0,7,7,314
141471003,180,21,1,3,1,2,2,210
141471004,219,22,2,3,0,4,3,253
141471005,315,23,17,7,10,6,11,389
141471006,219,34,11,5,10,2,10,291
141471007,221,25,7,3,4,2,18,280
141471008,350,24,10,9,1,3,14,411
141471009,248,25,9,9,1,0,3,295
141471010,374,29,9,9,0,1,5,427
141471011,421,21,5,2,0,1,12,462
141471012,258,7,3,2,0,0,9,279
141471013,284,21,14,15,0,2,2,338
141471014,399,38,10,34,1,3,3,488
141471015,410,21,1,9,1,1,7,450
141540101,31,4,0,0,0,0,6,41
141540102,39,6,0,1,0,1,5,52
141540103,97,21,0,4,0,7,14,143
141540104,80,20,0,0,0,4,4,108
141540105,21,3,0,1,0,1,2,28
141540106,6,2,0,0,0,1,3,12
141540107,32,5,0,0,0,2,8,47
141540201,47,5,0,0,0,0,0,52
141540202,5,0,0,0,0,0,1,6
141540203,27,2,0,0,0,3,4,36
141540204,53,18,0,1,0,1,12,85
141540205,28,11,0,0,0,0,6,45
141540206,24,11,1,1,0,0,0,37
141540207,32,6,0,1,0,6,11,56
141540208,36,5,0,0,0,2,8,51
141540209,152,19,0,9,0,1,6,187
141540210,169,31,0,4,0,1,4,209
141540211,264,14,0,24,1,2,12,317
141540212,90,13,1,3,0,17,2,126
141610101,28,5,0,0,0,0,17,50
141610102,35,0,0,1,1,5,46,88
141610103,47,1,0,0,0,1,39,88
141610104,66,4,5,9,7,17,19,127
141610105,59,13,0,2,0,6,11,91
141610106,24,16,0,0,0,5,1,46
141610107,31,6,0,2,0,18,20,77
141610108,30,7,0,0,0,13,7,57
141610109,37,4,0,0,0,0,24,65
141610110,61,23,0,5,0,1,16,106
141610111,37,17,0,0,1,11,44,110
141610112,240,10,10,5,1,0,28,294
141610113,293,23,3,6,3,5,21,354
141610114,165,6,4,1,3,6,3,188
141610115,155,13,2,9,0,1,3,183
141610116,256,17,3,4,2,1,7,290
141610117,327,22,14,2,5,4,16,390
141610201,48,5,0,0,0,1,69,123
141610202,44,9,0,0,0,7,21,81
141610203,21,1,0,0,0,0,13,35
141610204,21,22,1,2,0,2,10,58
141610205,19,0,1,1,0,10,4,35
141610206,35,6,0,0,0,7,36,84
141610207,206,20,1,5,0,0,11,243
141610208,236,15,6,7,0,0,3,267
141610209,273,29,7,8,4,1,9,331
141610210,208,17,4,8,2,0,4,243
141610211,234,14,10,8,1,3,5,275
141610212,195,11,7,5,0,1,7,226
141610213,214,28,5,5,3,0,3,258
141610214,226,15,4,3,2,0,19,269
141610215,208,16,9,6,0,31,12,282
141610216,223,21,4,7,2,13,8,278
141610301,92,4,0,0,0,2,33,131
141610302,40,5,0,0,0,4,25,74
141610303,42,27,0,0,0,4,15,88
141610304,62,5,1,0,0,2,13,83
141610305,116,3,1,2,1,8,53,184
141610306,240,28,4,1,1,2,4,280
141610307,321,28,9,15,0,2,6,381
141610308,193,12,11,13,3,2,10,244
141610309,191,43,4,6,0,0,1,245
141610310,305,26,6,6,4,0,5,352
141610311,177,15,13,7,7,5,5,229
141610312,149,14,6,2,1,0,3,175
141610313,163,9,2,4,1,0,2,181
141610401,52,16,0,0,0,1,14,83
141610402,33,17,0,0,0,0,2,52
141610403,24,3,0,0,0,0,19,46
141610404,32,2,0,0,0,0,22,56
141610405,65,0,1,0,0,0,30,96
141610406,51,19,0,0,0,1,5,76
141610407,83,6,0,1,0,0,42,132
141610408,17,10,0,0,0,0,7,34
141610409,51,12,0,1,0,2,5,71
141610410,55,7,0,0,0,0,20,82
141610411,89,16,4,1,8,3,1,122
141610412,241,28,7,10,4,0,9,299
141610413,228,16,2,4,0,0,5,255
141610501,24,21,0,0,0,0,0,45
141610502,24,7,0,0,0,1,9,41
141610503,88,39,0,0,0,3,7,137
141610504,24,10,0,0,0,0,11,45
141610505,47,4,1,1,0,0,34,87
141610506,224,13,0,3,0,1,5,246
141610507,336,24,9,8,0,0,11,388
141610508,187,7,2,1,1,2,8,208
141610509,211,7,0,8,3,1,7,237
141610510,201,18,5,1,6,1,17,249
141610511,228,16,4,2,0,4,16,270
141610512,195,15,9,2,1,2,7,231
141610601,203,6,0,3,0,0,21,233
141610602,216,15,0,12,0,0,8,251
141610603,334,14,2,3,3,1,3,360
141610604,295,22,6,9,8,2,1,343
141610605,179,9,18,13,5,12,10,246
141610606,317,26,8,6,3,2,5,367
141610607,265,29,5,4,0,5,5,313
141610608,202,16,2,7,1,0,12,240
141610609,222,14,2,2,0,0,9,249
141610610,250,23,6,4,4,3,7,297
141610611,220,22,5,3,3,0,10,263
141610612,253,20,8,3,1,1,16,302
141610613,265,13,4,11,0,1,2,296
141610614,204,11,2,2,0,0,9,228
141610701,240,14,3,2,2,0,3,264
141610702,173,22,0,7,3,5,6,216
141610703,310,25,4,6,7,0,13,365
141610704,143,15,13,0,20,0,12,203
141610705,147,11,0,2,2,1,8,171
141610706,269,9,3,6,0,1,9,297
141610707,213,17,10,12,3,0,5,260
141610708,292,21,9,3,1,1,19,346
141610709,303,20,10,3,4,0,13,353
141610710,240,15,7,6,0,0,4,272
141610711,198,11,8,0,1,1,11,230
141610712,350,35,8,8,0,0,8,409
141610713,299,25,6,3,1,0,9,343
141610714,246,25,2,8,0,0,15,296
141610715,376,25,6,5,0,0,13,425
141610801,213,23,0,0,1,1,12,250
141610802,120,8,3,5,0,0,3,139
141610803,188,12,6,5,4,0,5,220
141610804,181,9,9,3,4,1,2,209
141610805,159,22,11,4,2,1,3,202
141610806,175,20,1,7,1,1,1,206
141610807,281,26,9,5,0,1,7,329
141610808,204,17,8,9,0,1,2,241
141610809,172,16,6,10,0,1,9,214
141610810,300,23,12,8,1,4,3,351
141610811,181,11,5,1,3,0,9,210
141610812,188,21,8,3,16,2,12,250
141610813,194,26,5,4,12,0,17,258
141610814,257,28,9,3,8,1,11,317
141610815,210,20,4,10,1,0,4,249
141610816,192,13,5,0,5,1,5,221
141610817,317,29,14,8,2,3,12,385
141610901,213,11,0,0,2,0,4,230
141610902,287,36,4,13,4,1,9,354
141610903,255,13,7,10,0,1,6,292
141610904,237,25,5,4,0,0,5,276
141610905,258,18,4,7,5,1,5,298
141610906,278,22,1,2,0,0,5,308
141610907,234,15,4,2,1,0,0,256
141610908,211,21,3,2,0,1,2,240
141610909,236,13,7,2,1,0,6,265
141610910,208,24,11,5,5,2,9,264
141610911,266,12,3,8,2,0,1,292
141610912,240,13,2,1,4,0,6,266
141610913,270,23,4,2,1,2,4,306
141610914,214,17,6,6,4,0,4,251
141610915,308,29,8,5,7,0,11,368
141610916,197,21,7,1,6,0,15,247
141610917,214,27,3,4,0,0,7,255
141610918,331,26,8,5,1,1,9,381
141610919,233,16,4,7,4,0,6,270
141610920,213,19,7,0,0,0,3,242
141610921,334,31,7,10,3,1,8,394
141610922,283,12,0,0,0,0,5,300
141610923,219,20,0,7,0,0,7,253
141611001,236,30,6,2,9,1,7,291
141611002,270,30,7,4,16,1,13,341
141611003,255,47,8,2,5,0,5,322
141611004,235,49,10,1,10,0,7,312
141611005,229,19,6,4,38,1,16,313
141611006,280,32,8,1,7,1,15,344
141611007,347,32,6,1,1,0,13,400
141611008,241,16,2,8,0,0,6,273
141611009,202,20,2,14,7,0,0,245
141611010,173,15,1,2,6,0,10,207
141611011,185,13,5,1,14,1,12,231
141611012,322,12,4,2,1,0,14,355
141611013,202,12,5,8,26,2,13,268
141611014,207,22,11,2,5,2,12,261
141611015,192,4,12,4,3,0,4,219
141611016,239,20,8,11,4,2,10,294
141611017,348,28,3,7,0,0,12,398
141611018,284,21,6,5,0,1,9,326
141611019,286,17,5,29,4,1,9,351
141611020,248,7,1,5,0,0,4,265
141611021,238,14,3,5,0,2,1,263
141611101,361,39,7,17,1,18,12,455
141611102,207,22,2,3,0,0,3,237
141611103,166,5,2,5,0,1,3,182
141611104,299,21,3,3,0,0,6,332
141611105,218,9,5,3,0,5,11,251
141611106,244,34,19,13,1,2,2,315
141611107,219,28,1,4,4,0,9,265
141611108,197,15,6,5,6,2,5,236
141611109,163,19,5,13,3,0,3,206
141611110,218,18,0,9,1,2,8,256
141611111,359,24,4,16,3,2,3,411
141611112,313,22,4,9,1,2,10,361
141611113,257,29,9,3,11,2,7,318
141611114,239,25,1,6,1,0,7,279
141611115,219,12,5,8,0,0,2,246
141611116,305,12,5,4,0,1,9,336
141611117,220,11,3,4,0,0,2,240
141680101,46,3,0,2,0,12,12,75
141680102,52,6,3,0,0,21,11,93
141680103,26,5,0,0,0,1,0,32
141680104,15,5,0,1,0,8,2,31
141680105,17,12,0,0,0,6,7,42
141680106,45,19,0,1,0,5,10,80
141680107,35,7,0,0,0,5,20,67
141680108,89,17,0,2,1,3,19,131
141680109,26,14,0,0,0,2,3,45
141680110,97,48,0,5,0,0,6,156
141680111,203,22,4,2,1,2,5,239
141680112,267,31,4,3,0,0,5,310
141680113,142,12,2,1,3,2,20,182
141680114,302,26,1,5,5,1,17,357
141680201,46,9,0,2,0,1,8,66
141680202,82,6,1,2,2,5,12,110
141680203,25,21,0,2,0,1,3,52
141680204,157,14,9,4,0,29,5,218
141680205,153,25,7,2,0,10,11,208
141680206,190,38,1,0,0,1,9,239
141680207,256,17,1,5,2,3,9,293
141680208,282,41,6,10,0,1,10,350
141680209,207,12,4,9,0,2,8,242
141680210,192,18,4,4,0,0,3,221
141680211,248,22,4,8,2,0,4,288
141680212,233,6,2,0,1,3,3,248
141680213,218,13,6,6,0,1,2,246
141680214,189,17,2,11,1,3,1,224
141680301,27,3,0,2,0,8,3,43
141680302,61,0,1,1,0,44,2,109
141680303,94,25,0,1,0,76,8,204
141680304,32,2,0,3,1,17,7,62
141680305,57,7,0,1,0,11,9,85
141680306,26,0,0,0,0,3,12,41
141680307,52,4,1,0,0,6,15,78
141680308,19,4,0,0,0,7,7,37
141680309,51,12,1,0,0,3,17,84
141680310,53,1,0,0,0,7,29,90
141680311,311,29,0,6,1,3,4,354
141680312,218,16,4,7,0,28,49,322
141680313,301,21,1,26,1,6,3,359
141750101,35,10,0,1,0,0,0,46
141750102,27,12,0,0,0,1,3,43
141750103,53,11,0,0,0,5,12,81
141750104,27,6,0,0,0,3,2,38
141750105,54,25,0,1,0,0,5,85
141750106,22,0,2,0,0,11,1,36
141750107,76,17,0,0,0,14,10,117
141750108,42,14,0,1,0,8,6,71
141750109,50,24,0,0,0,3,5,82
141750110,227,46,2,4,0,0,14,293
141750111,184,21,1,6,6,3,15,236
141750112,102,7,0,1,3,15,35,163
141750113,218,41,6,13,4,26,15,323
141750114,229,49,1,15,0,31,10,335
141750201,155,63,1,3,0,24,20,266
141750202,151,1,3,3,0,59,31,248
141750203,64,14,1,0,2,12,14,107
141750204,88,41,1,3,0,16,8,157
141750205,44,24,0,0,0,6,24,98
141750206,61,3,0,0,1,8,13,86
141750207,32,5,0,0,0,6,11,54
141750208,66,18,0,0,0,0,4,88
141750209,138,34,0,6,1,7,11,197
141750210,54,8,0,0,0,6,5,73
141750211,64,24,0,0,0,0,16,104
141750212,209,26,6,15,2,3,7,268
141750213,247,28,4,21,0,6,17,323
141750214,244,32,5,6,0,5,5,297
141750215,253,20,10,14,1,18,5,321
141750216,190,24,3,9,4,3,7,240
141750217,200,24,1,8,6,2,10,251
141750218,337,39,2,15,2,17,21,433
141750219,1,2,0,0,0,0,0,3
141820101,48,10,2,0,0,4,22,86
141820102,53,0,0,1,0,0,12,66
141820103,45,5,0,6,0,6,16,78
141820104,41,9,3,1,0,0,4,58
141820105,57,0,0,0,0,0,17,74
141820106,85,0,0,0,0,1,21,107
141820107,70,12,0,0,0,7,15,104
141820108,77,3,5,0,0,7,30,122
141820109,46,2,0,0,0,11,15,74
141820110,122,14,1,1,0,16,44,198
141820111,190,14,2,5,4,3,6,224
141820112,228,18,7,3,3,5,17,281
141820113,250,9,6,2,6,2,16,291
141820114,146,12,4,2,2,1,11,178
141820115,188,10,0,3,1,2,11,215
141820116,334,28,5,5,3,2,2,379
141820117,218,13,4,8,0,0,7,250
141820118,262,18,2,5,0,0,9,296
141820119,288,18,5,4,12,0,5,332
141820120,318,15,1,3,1,3,10,351
141820121,218,11,3,0,0,1,12,245
141820201,61,2,0,0,0,1,39,103
141820202,106,9,0,0,0,1,2,118
141820203,88,25,0,0,0,4,9,126
141820204,37,14,0,0,0,3,2,56
141820205,31,3,0,0,0,3,4,41
141820206,245,12,6,13,1,5,10,292
141820207,232,15,7,4,0,4,4,266
141820208,194,18,1,2,2,1,19,237
141820209,265,33,8,4,1,2,8,321
141820210,264,22,8,3,0,3,6,306
141820211,267,26,5,5,2,2,20,327
141820212,165,10,0,6,2,2,26,211
141820213,323,17,5,2,2,3,10,362
141820214,164,25,7,1,2,0,9,208
141820301,58,25,0,2,0,18,12,115
141820302,18,2,0,0,0,0,11,31
141820303,69,5,1,2,0,8,23,108
141820304,41,14,0,0,0,2,21,78
141820305,30,0,0,0,0,2,4,36
141820306,55,2,0,0,0,8,18,83
141820307,308,29,1,6,1,7,12,364
141820308,229,23,4,7,1,1,15,280
141820309,174,29,0,1,1,2,17,224
141820310,370,28,5,13,1,2,15,434
141820401,35,19,0,0,0,8,14,76
141820402,109,51,0,0,1,22,15,198
141820403,79,18,5,7,1,16,8,134
141820404,31,8,0,0,0,5,3,47
141820405,34,5,0,0,0,17,12,68
141820406,58,22,0,0,0,6,31,117
141820407,40,30,0,0,0,0,29,99
141820408,112,0,0,6,1,2,10,131
141820409,241,11,4,12,4,10,8,290
141820410,220,4,5,3,1,1,4,238
141820411,323,14,9,10,4,6,11,377
141820412,212,16,0,5,0,0,9,242
141820413,279,13,8,3,5,8,11,327
141820414,208,16,2,5,0,0,6,237
141820415,316,15,1,6,0,1,22,361
141820501,26,0,0,0,0,4,24,54
141820502,27,12,0,0,0,6,24,69
141820503,8,20,0,0,0,4,2,34
141820504,20,10,3,0,0,0,7,40
141820505,65,11,0,1,0,5,29,111
141820506,24,3,0,0,0,1,32,60
141820507,15,56,0,0,0,0,3,74
141820508,32,20,0,0,1,3,16,72
141820509,200,19,6,9,3,0,2,239
141820510,164,1,3,6,0,0,2,176
141820511,305,13,6,5,0,1,12,342
141820512,238,28,1,4,2,0,2,275
141820513,226,18,0,4,0,0,9,257
141820514,206,17,3,2,3,3,14,248
141820515,257,22,4,7,3,1,7,301
141820516,226,14,0,2,0,0,7,249
141820517,162,15,6,3,0,1,2,189
141820518,370,24,3,3,1,0,17,418
141820519,151,12,5,1,0,0,5,174
141820520,218,21,2,2,0,1,5,249
141820521,218,13,7,4,1,3,12,258
141820601,27,11,0,0,0,0,50,88
141820602,46,17,0,0,1,3,37,104
141820603,27,12,0,0,0,1,22,62
141820604,36,0,0,0,0,0,12,48
141820605,41,8,0,0,0,0,30,79
141820606,6,0,0,0,0,7,16,29
141820607,329,34,3,5,2,4,25,402
141820608,203,24,4,1,1,1,13,247
141820609,414,19,1,14,1,1,4,454
141820610,246,19,2,5,0,0,6,278
141820611,201,11,6,3,2,2,0,225
141820612,304,16,5,8,1,2,2,338
141820613,225,13,3,8,2,0,3,254
141820614,136,20,44,2,5,1,8,216
141820615,309,24,5,6,7,2,12,365
141820616,202,21,4,4,0,0,8,239
141820617,209,10,2,4,0,1,7,233
141820618,123,5,0,7,2,0,3,140
141820619,113,16,1,2,0,5,9,146
141820701,25,6,0,0,0,1,9,41
141820702,76,14,0,1,0,1,4,96
141820703,46,12,0,0,1,1,16,76
141820704,26,0,0,0,0,0,12,38
141820705,48,5,0,1,0,4,10,68
141820706,35,10,0,0,1,3,6,55
141820707,123,18,0,2,0,1,20,164
141820708,50,4,1,0,0,4,35,94
141820709,45,3,0,1,1,0,5,55
141820710,41,17,0,0,0,3,7,68
141820711,226,23,2,3,2,1,8,265
141820712,132,19,0,1,3,1,8,164
141820713,179,27,7,1,1,0,4,219
141820714,214,37,4,4,4,2,15,280
141820715,310,30,4,5,3,0,20,372
141820716,245,21,3,6,0,4,3,282
141820801,210,12,2,5,0,0,8,237
141820802,229,14,5,1,0,0,6,255
141820803,268,17,2,7,0,0,9,303
141820804,222,16,10,4,1,1,3,257
141820805,319,23,7,11,2,0,7,369
141820806,314,13,3,4,0,4,7,345
141820807,208,19,4,1,1,3,6,242
141820808,177,17,1,4,0,0,5,204
141820809,331,27,2,5,4,1,8,378
141820810,313,32,20,5,7,0,7,384
141820811,213,54,7,3,20,3,9,309
141820812,130,9,13,2,17,3,12,186
141820901,290,18,1,0,0,2,5,316
141820902,328,11,4,8,0,0,4,355
141820903,275,6,2,2,1,0,4,290
141820904,226,21,3,4,1,1,4,260
141820905,214,17,7,3,2,0,1,244
141820906,238,20,9,4,0,3,10,284
141820907,224,9,6,5,0,0,0,244
141820908,356,21,1,6,1,0,8,393
141820909,302,14,3,6,1,2,13,341
141820910,353,25,7,7,1,1,10,404
141820911,300,23,15,0,1,0,15,354
141821001,215,42,4,2,7,2,18,290
141821002,304,23,11,5,4,0,11,358
141821003,193,9,4,3,2,0,5,216
141821004,283,11,1,8,0,0,11,314
141821005,154,7,0,2,0,0,5,168
141821006,206,14,3,1,0,1,7,232
141821007,278,24,1,2,3,0,2,310
141821008,176,6,6,5,8,1,17,219
141821009,279,14,5,5,7,3,12,325
141821010,304,17,2,2,0,2,5,332
141821101,146,1,2,6,0,6,7,168
141821102,234,11,14,4,6,1,3,273
141821103,158,20,9,3,11,0,4,205
141821104,222,37,11,0,14,0,16,300
141821105,189,16,8,4,3,0,7,227
141821106,256,21,4,4,0,0,10,295
141821107,189,21,2,2,3,0,6,223
141821108,245,11,3,2,0,0,1,262
141821109,380,26,2,11,0,0,9,428
141821110,346,20,18,7,0,2,7,400
141821201,212,5,2,7,0,0,5,231
141821202,183,7,8,4,3,1,4,210
141821203,272,15,6,1,22,0,10,326
141821204,322,12,5,3,0,5,11,358
141821205,230,21,3,1,0,2,6,263
141821206,323,16,4,7,0,2,8,360
141821207,280,24,6,8,4,0,14,336
141821208,203,17,1,11,1,3,9,245
141821209,193,9,3,5,0,1,5,216
141821210,200,14,0,12,0,1,5,232
141821211,244,11,0,4,0,0,2,261
141821301,315,22,4,8,0,3,11,363
141821302,297,32,4,9,2,1,10,355
141821303,232,19,15,3,1,0,6,276
141821304,284,19,8,8,7,3,16,345
141821305,201,26,7,3,3,2,15,257
141821306,246,18,5,3,0,0,9,281
141821307,280,31,5,2,4,0,11,333
141821308,113,13,0,0,0,0,1,127
141821309,161,17,6,3,0,0,7,194
141821310,180,19,2,3,0,1,1,206
141821311,241,16,7,3,0,0,7,274
141821312,247,22,1,2,0,0,2,274
180070101,308,25,2,14,1,1,4,355
180070102,162,5,0,1,1,0,8,177
180070103,243,9,2,3,0,0,6,263
180070104,210,11,2,2,5,4,8,242
180070105,245,27,4,3,3,0,5,287
180070106,294,33,2,4,5,3,11,352
180070107,178,18,0,2,1,0,2,201
180070108,233,20,1,6,0,1,13,274
180070109,260,13,2,5,1,0,6,287
180070110,213,11,0,0,1,0,6,231
180070111,221,15,0,1,0,0,0,237
180070112,243,9,2,5,0,2,4,265
180070113,307,23,4,1,2,0,6,343
180070114,225,17,0,1,0,0,4,247
180070115,272,12,1,3,0,0,7,295
180070116,268,8,1,5,0,0,3,285
180070117,247,27,1,0,2,0,10,287
180070118,223,3,2,2,0,1,14,245
180070119,242,18,3,0,0,2,0,265
180070120,227,13,1,2,1,4,6,254
180070121,246,8,3,0,0,0,10,267
180070122,242,15,1,2,0,0,3,263
180070123,233,8,0,4,0,0,4,249
180070124,262,10,0,1,2,1,10,286
180070125,267,13,0,0,0,0,7,287
180070201,74,10,0,0,0,0,7,91
180070202,53,3,0,1,0,0,0,57
180070203,91,10,0,3,1,0,7,112
180070204,92,9,0,0,2,2,5,110
180070205,70,3,0,1,0,1,12,87
180070206,73,15,1,0,0,0,5,94
180070207,68,7,0,0,1,3,3,82
180070208,76,12,0,1,0,3,5,97
180070209,69,4,0,0,0,0,0,73
180070210,19,2,0,0,0,2,1,24
180070211,59,6,0,0,0,0,2,67
180070212,76,1,0,1,0,1,8,87
180070213,262,5,0,0,0,0,4,271
180070214,365,15,0,0,0,0,2,382
180070215,262,8,0,1,0,0,2,273
180070216,146,14,0,2,0,0,8,170
180070217,150,4,0,1,0,1,3,159
180070218,146,3,0,0,0,0,0,149
180070301,215,34,0,1,0,1,31,282
180070302,36,4,0,0,0,0,3,43
180070303,33,0,0,0,0,0,4,37
180070304,114,6,0,0,0,0,6,126
180070305,112,0,1,2,0,0,31,146
180070401,26,0,0,0,0,0,1,27
180070501,38,7,0,0,0,0,0,45
180070502,18,2,0,0,0,0,2,22
180070503,9,0,0,0,0,1,1,11
180070504,27,6,0,0,0,0,0,33
180070505,26,1,0,0,0,1,5,33
180070506,39,1,0,0,0,0,8,48
180070601,141,9,0,1,0,1,13,165
180070602,104,8,0,1,0,0,2,115
180070701,56,5,0,0,1,0,3,65
180070702,101,10,0,1,1,4,9,126
180070801,6,2,0,0,0,3,2,13
180070802,11,0,0,0,0,0,1,12
180140101,118,26,0,5,0,1,4,154
180140102,131,33,0,0,1,0,2,167
180140103,147,29,0,1,1,2,7,187
180140201,49,10,0,0,0,3,5,67
180140202,12,8,0,0,0,0,0,20
180140203,8,3,0,0,0,0,0,11
180140301,58,9,0,0,2,1,2,72
180140302,28,4,0,0,0,1,2,35
180140303,42,19,0,1,0,6,1,69
180140401,55,12,0,1,0,5,5,78
180140402,14,3,0,0,0,1,4,22
180140501,0,0,0,0,0,0,1,1
180140502,0,0,0,0,0,0,1,1
180210101,350,3,31,1,5,3,17,410
180210102,240,4,36,4,24,1,21,330
180210103,328,4,51,2,8,2,39,434
180210104,287,5,7,3,7,1,27,337
180210105,247,36,20,2,4,4,10,323
180210106,299,36,7,2,7,3,23,377
180210107,217,41,5,9,16,5,11,304
180210108,195,28,17,1,14,2,3,260
180210109,250,85,24,1,24,1,13,398
180210110,194,36,16,8,8,1,28,291
180210111,215,10,1,1,7,0,7,241
180210112,133,7,5,1,8,1,6,161
180210113,411,40,16,5,6,2,15,495
180210114,348,41,20,3,2,2,13,429
180210115,403,24,41,26,17,3,25,539
180210116,223,56,10,0,0,0,11,300
180210117,385,74,31,8,20,1,27,546
180210118,308,56,12,3,10,0,14,403
180210201,346,50,18,6,6,14,23,463
180210202,240,17,13,1,0,0,5,276
180210203,302,94,18,3,3,0,8,428
180210204,211,26,14,2,5,0,5,263
180210205,249,73,20,1,0,0,19,362
180210206,274,54,17,2,3,1,0,351
180210207,310,57,36,1,4,0,8,416
180210208,338,65,21,0,4,0,5,433
180210209,270,34,6,1,3,1,3,318
180210210,282,58,27,2,26,1,31,427
180210211,251,49,31,1,4,0,10,346
180210212,229,26,27,1,22,1,6,312
180210213,200,53,26,11,5,0,3,298
180210214,415,124,30,2,15,1,16,603
180210215,282,89,5,10,10,1,8,405
180210216,275,86,12,2,33,1,9,418
180210217,332,98,40,13,24,0,11,518
180210218,149,34,14,2,25,0,26,250
180210301,251,4,1,3,1,1,1,262
180210302,238,9,13,11,1,0,4,276
180210303,421,44,17,12,3,1,11,509
180210304,436,9,1,2,0,0,3,451
180210305,371,7,1,1,0,1,2,383
180210306,244,5,0,0,0,0,3,252
180210307,223,2,0,0,0,0,1,226
180210308,271,2,3,3,0,0,2,281
180210309,287,9,0,2,0,0,3,301
180210310,269,3,1,0,0,0,4,277
180210311,222,7,1,0,1,0,2,233
180210312,193,14,0,1,0,0,3,211
180210313,171,3,1,0,0,1,1,177
180210314,286,16,1,3,3,0,4,313
180210315,334,24,2,1,1,0,9,371
180210316,271,18,2,2,0,1,15,309
180210317,388,18,1,2,0,0,8,417
180210318,201,28,12,5,1,0,15,262
180210319,240,33,11,2,0,2,13,301
180210320,287,37,18,3,0,2,10,357
180210321,212,15,0,0,0,0,9,236
180210401,405,61,1,8,0,5,10,490
180210402,216,15,3,1,0,1,2,238
180210403,478,33,2,12,0,1,7,533
180210404,337,18,0,2,0,0,2,359
180210405,237,7,2,1,1,0,6,254
180210406,364,10,2,0,0,0,3,379
180210407,342,16,1,7,1,1,8,376
180210408,238,26,0,1,0,3,5,273
180210409,293,20,1,3,0,0,4,321
180210410,284,19,1,1,0,0,7,312
180210411,448,35,5,3,1,0,9,501
180210412,196,15,2,1,3,0,4,221
180210413,244,12,3,2,0,0,4,265
180210414,307,47,8,2,0,2,5,371
180210415,233,4,1,3,2,0,3,246
180210416,243,40,20,2,7,0,5,317
180210417,239,18,0,0,0,0,3,260
180210418,217,27,21,7,0,0,7,279
180210419,145,49,25,0,0,0,6,225
180210420,157,45,18,2,2,3,2,229
180210421,340,43,61,22,1,0,35,502
180210422,203,22,1,2,0,0,4,232
180210501,237,66,29,5,3,1,7,348
180210502,192,44,5,3,1,0,12,257
180210503,355,70,50,4,17,0,14,510
180210504,281,32,17,0,3,1,7,341
180210505,161,9,9,1,14,0,10,204
180210506,264,17,8,3,1,0,17,310
180210507,296,42,14,3,0,0,6,361
180210508,162,23,7,0,0,0,1,193
180210509,234,27,2,0,1,1,9,274
180210510,223,18,2,3,3,0,13,262
180210511,233,34,5,8,4,2,13,299
180210512,401,49,29,10,6,3,15,513
180210513,282,23,14,4,2,1,11,337
180210514,203,15,1,4,0,1,12,236
180210515,166,16,1,2,1,0,16,202
180210516,141,16,6,2,0,0,6,171
180210601,192,18,3,3,4,3,7,230
180210602,188,8,4,1,1,0,4,206
180210603,243,17,3,2,0,1,19,285
180210604,343,13,8,2,0,0,14,380
180210605,305,14,2,3,0,1,6,331
180210606,518,27,5,5,4,0,3,562
180210607,255,34,1,0,0,0,5,295
180210608,233,5,1,0,0,1,5,245
180210609,320,10,3,0,5,1,3,342
180210610,252,23,2,0,0,0,1,278
180210611,191,14,2,1,2,0,3,213
180210612,303,9,0,2,0,0,2,316
180210613,313,15,0,1,0,0,1,330
180210614,303,21,2,2,1,0,6,335
180210615,215,11,0,1,1,0,6,234
180210616,258,9,4,0,4,0,5,280
180210701,287,15,0,0,0,0,6,308
180210702,199,18,2,1,0,0,5,225
180210703,342,19,1,2,1,0,11,376
180210704,327,16,0,1,1,0,5,350
180210705,281,10,1,0,0,0,2,294
180210706,198,1,1,0,0,2,14,216
180210707,405,30,1,1,0,1,7,445
180210708,489,17,5,3,1,0,9,524
180210709,285,27,3,1,0,0,6,322
180210710,325,7,0,5,0,0,4,341
180210711,403,10,0,0,0,0,12,425
180210712,280,14,0,0,0,0,3,297
180210713,291,6,0,0,0,0,0,297
180210714,253,8,0,3,0,0,2,266
180210715,253,10,2,2,0,0,9,276
180210716,216,18,0,0,0,0,0,234
180210801,175,38,5,0,0,0,2,220
180210802,240,10,5,6,1,1,4,267
180210803,260,24,17,7,7,0,6,321
180210804,182,21,29,1,4,0,7,244
180210805,246,31,16,6,2,1,8,310
180210806,258,40,12,0,14,2,4,330
180210807,206,26,25,5,2,0,3,267
180210808,172,29,6,6,6,0,10,229
180210809,347,48,11,10,6,1,19,442
180210810,326,35,23,11,7,0,10,412
180210811,403,33,5,7,3,0,11,462
180210812,150,10,1,2,0,0,8,171
180210813,181,9,0,3,0,0,7,200
180210901,163,29,17,4,30,3,19,265
180210902,181,53,6,1,11,2,7,261
180210903,264,51,30,10,16,2,10,383
180210904,231,49,6,8,7,3,28,332
180210905,223,10,10,1,9,7,5,265
180210906,385,42,17,2,10,1,21,478
180210907,402,39,64,3,7,4,9,528
180210908,380,54,18,2,19,0,31,504
180210909,301,84,22,4,35,0,20,466
180210910,283,51,12,2,21,1,6,376
180210911,153,26,21,4,14,1,19,238
180210912,338,44,21,18,10,3,43,477
180210913,213,22,6,2,5,1,14,263
180210914,248,31,27,3,11,0,11,331
180210915,229,17,9,2,5,1,14,277
180211001,225,10,1,2,4,1,7,250
180211002,279,15,2,1,4,0,11,312
180211003,291,0,0,4,0,1,0,296
180211004,305,8,1,19,0,2,4,339
180211005,229,3,0,8,0,2,4,246
180211006,430,18,1,2,0,0,5,456
180211007,311,20,2,5,1,5,18,362
180211101,291,26,0,13,0,41,28,399
180211102,23,5,0,1,0,1,3,33
180211103,144,15,1,7,1,14,10,192
180211104,101,64,7,8,0,24,41,245
180211105,140,18,0,5,2,15,5,185
180211106,288,28,4,8,1,9,9,347
180211107,283,18,0,7,0,1,10,319
180211108,202,23,0,1,0,0,5,231
180211109,252,25,1,3,0,1,8,290
180211110,214,16,1,11,0,21,15,278
180211201,26,1,0,2,1,4,17,51
180211202,44,0,0,2,1,13,6,66
180211203,34,0,0,3,1,5,2,45
180211204,46,2,0,0,1,10,11,70
180211205,173,6,0,0,0,4,22,205
180211206,141,16,1,1,0,1,13,173
180211207,139,3,0,0,0,0,12,154
180211208,302,16,5,4,0,4,9,340
180211209,366,10,3,3,1,2,14,399
180211210,319,7,0,0,0,0,13,339
180211211,260,4,0,0,0,0,0,264
180211212,323,18,1,0,1,1,2,346
180211213,98,5,0,5,1,2,3,114
180211301,299,32,2,4,0,8,11,356
180211302,169,16,0,3,0,21,14,223
180211303,48,9,0,0,0,1,2,60
180211304,16,0,0,0,0,0,15,31
180211305,115,4,0,4,3,9,2,137
180211306,183,14,1,5,1,7,12,223
180211307,212,11,1,2,0,10,54,290
180211401,5,0,0,0,0,0,0,5
180211402,10,0,0,0,0,0,0,10
180211501,243,10,2,0,1,0,5,261
180211502,211,29,2,1,1,1,2,247
180211503,112,10,1,0,3,0,5,131
180211504,127,12,1,0,0,0,2,142
180211505,276,16,0,2,3,1,5,303
180211506,193,9,1,1,0,0,1,205
180211507,196,11,2,0,1,0,10,220
180211508,205,6,2,0,0,1,1,215
180211509,183,5,0,0,0,4,1,193
180211510,170,9,3,0,4,0,2,188
180211511,352,25,6,1,0,0,8,392
180211512,236,25,3,0,1,1,2,268
180211513,222,29,2,1,0,0,10,264
180211514,232,14,0,0,1,0,1,248
180211515,196,11,0,0,0,0,2,209
180211516,393,8,1,1,1,0,4,408
180211601,155,12,1,0,0,0,1,169
180211602,193,2,0,0,0,1,6,202
180211603,330,17,7,0,1,0,4,359
180211604,399,16,3,1,3,0,8,430
180211605,155,5,0,0,1,0,1,162
180211606,191,18,1,0,0,0,10,220
180211607,220,25,4,0,0,1,6,256
180211608,226,4,0,1,0,0,3,234
180211609,276,20,39,3,3,0,18,359
180211610,176,15,1,4,0,0,3,199
180211611,266,26,2,0,0,0,8,302
180211612,199,10,0,1,1,0,3,214
180211613,217,10,1,1,0,1,4,234
180211614,261,5,2,2,0,1,3,274
180211615,313,14,2,5,2,0,15,351
180211616,324,11,0,3,0,0,19,357
180211701,273,6,3,0,11,1,11,305
180211702,275,6,1,3,3,0,2,290
180211703,332,8,3,3,1,1,8,356
180211704,288,20,7,2,7,1,11,336
180211705,208,14,1,0,0,2,2,227
180211706,370,8,2,1,0,0,10,391
180211707,244,49,11,3,0,1,10,318
180211708,240,3,0,3,1,0,7,254
180211709,244,7,1,2,0,0,1,255
180211710,297,8,0,0,1,1,6,313
180211711,276,15,4,1,2,2,6,306
180211712,204,5,2,0,1,0,5,217
180211713,245,16,3,2,0,0,2,268
180211714,210,10,0,0,0,0,4,224
180211715,244,12,0,0,0,1,4,261
180211716,203,12,0,0,0,0,1,216
180211717,212,7,0,2,0,0,3,224
180211718,367,19,0,0,0,0,6,392
180211801,410,20,5,4,4,1,8,452
180211802,272,12,2,0,0,1,4,291
180211803,367,27,0,0,5,0,8,407
180211804,451,32,0,10,3,1,17,514
180211805,211,10,1,2,1,3,4,232
180211806,214,8,0,4,0,1,6,233
180211807,369,8,2,3,1,3,15,401
180211808,355,5,0,0,0,0,0,360
180211809,492,20,1,4,1,0,11,529
180211810,258,34,0,1,0,2,4,299
180211811,326,27,1,3,1,2,5,365
180211812,415,36,1,0,0,0,19,471
180211813,401,32,2,6,1,0,4,446
180211901,212,53,3,2,0,0,13,283
180211902,247,11,6,3,2,2,7,278
180211903,229,28,7,1,0,0,17,282
180211904,198,37,12,1,0,0,9,257
180211905,245,5,0,0,0,0,4,254
180211906,221,10,0,1,0,0,2,234
180211907,189,12,0,0,0,0,4,205
180211908,328,4,1,4,0,0,5,342
180211909,257,46,6,0,4,0,10,323
180211910,126,25,6,1,1,0,9,168
180211911,253,22,8,4,5,3,10,305
180211912,400,18,32,2,5,0,5,462
180211913,179,13,0,2,0,0,2,196
180211914,208,12,0,0,0,0,5,225
180211915,261,12,0,3,4,1,13,294
180211916,221,22,3,0,1,0,7,254
180211917,173,11,28,0,2,0,8,222
180211918,262,11,2,1,1,1,3,281
180212001,287,18,3,9,3,1,25,346
180212002,377,23,2,14,4,3,8,431
180212003,426,70,26,10,1,1,14,548
180212004,259,6,0,1,0,0,9,275
180212005,221,9,5,0,3,0,4,242
180212006,313,24,1,2,0,0,3,343
180212007,294,20,10,3,3,1,11,342
180212008,269,65,5,0,1,1,15,356
180212009,246,16,3,3,8,0,12,288
180212010,284,11,3,4,2,0,4,308
180212011,347,12,3,2,2,0,6,372
180212012,273,13,5,0,1,0,0,292
180212013,316,23,4,2,5,0,3,353
180212101,294,34,4,4,1,1,8,346
180212102,212,17,4,2,0,0,8,243
180212103,308,15,2,0,2,0,6,333
180212104,313,25,19,0,0,0,14,371
180212105,148,17,6,1,1,0,6,179
180212106,363,16,0,0,0,2,10,391
180212107,330,23,0,1,2,0,12,368
180212108,344,25,7,0,0,0,10,386
180212109,241,14,12,4,2,0,12,285
180212110,334,10,5,0,1,0,5,355
180212111,324,13,1,0,1,0,3,342
180212112,328,1,1,0,0,0,9,339
180212201,165,9,4,0,1,0,6,185
180212202,241,10,4,0,0,0,1,256
180212203,351,4,0,1,0,0,4,360
180212204,443,6,0,0,0,0,8,457
180212205,289,3,0,0,0,0,4,296
180212206,278,12,0,1,1,0,5,297
180212207,472,22,1,1,0,0,5,501
180212208,244,16,1,8,2,0,1,272
180212209,367,8,0,0,0,0,12,387
180212210,301,18,5,1,1,1,8,335
180212211,348,11,0,0,0,2,8,369
180212212,462,18,1,6,0,2,2,491
180212301,426,8,1,0,0,1,10,446
180212302,367,18,0,0,3,0,3,391
180212303,388,16,1,3,0,0,3,411
180212304,314,27,0,2,0,0,2,345
180212305,363,20,0,0,0,1,3,387
180212306,270,9,0,6,0,0,15,300
180212307,318,6,0,1,0,0,6,331
180212308,292,10,0,0,0,0,3,305
180212309,306,19,0,0,0,1,2,328
180212310,341,15,3,0,2,0,7,368
180212311,374,13,3,3,0,0,17,410
180212312,387,20,6,4,0,2,12,431
180212313,399,14,4,0,0,3,16,436
180212314,114,3,0,0,0,2,5,124
180280101,395,27,2,2,1,10,21,458
180280102,182,33,1,3,1,8,19,247
180280103,293,31,2,5,1,3,10,345
180280201,21,9,0,0,0,0,3,33
180280202,26,2,0,0,0,0,9,37
180280301,510,25,2,7,0,2,38,584
180280302,15,7,0,0,0,1,1,24
180280303,84,6,0,0,0,0,2,92
180280304,5,6,0,0,0,0,1,12
180280305,18,2,0,0,0,2,3,25
180280306,36,0,0,0,0,0,0,36
180280307,39,2,0,0,0,0,0,41
180280308,170,1,0,0,0,2,18,191
180280309,352,38,0,3,2,1,5,401
180280310,265,25,1,4,0,0,6,301
180280311,311,27,1,3,0,4,20,366
180280312,517,32,10,4,0,1,4,568
180280401,230,27,1,5,2,13,7,285
180280402,21,2,0,0,0,0,1,24
180280403,45,0,0,0,0,0,2,47
180280404,6,2,0,0,0,0,0,8
180280405,133,8,0,0,1,2,14,158
180280406,142,11,0,4,0,1,3,161
180280407,123,8,0,0,0,1,6,138
180280408,75,4,0,1,0,0,1,81
180280409,93,5,0,2,0,3,7,110
180280410,36,2,0,0,0,0,1,39
180280411,63,3,0,1,0,2,1,70
180280412,159,3,0,3,0,0,7,172
180280413,126,14,0,1,0,2,7,150
180280501,19,2,0,0,0,3,8,32
180280502,22,0,0,0,0,0,3,25
180280503,17,0,0,0,1,0,4,22
180280601,25,0,0,0,0,0,7,32
180280602,4,1,0,0,0,0,1,6
180280603,22,3,0,0,0,0,0,25
180280604,83,17,0,0,0,0,3,103
180280605,12,10,0,0,0,0,2,24
180280606,20,8,0,0,0,0,2,30
180280701,64,4,0,0,2,0,1,71
180280702,146,13,0,0,0,1,0,160
180280703,23,2,0,0,0,0,0,25
180280704,16,0,0,0,0,0,0,16
180280705,21,1,0,0,0,8,3,33
180280706,23,4,0,0,0,0,1,28
180280707,16,6,0,0,0,0,0,22
180350101,279,9,1,3,1,0,6,299
180350102,191,3,1,4,0,0,5,204
180350103,332,26,3,4,0,3,4,372
180350104,280,30,6,6,1,0,13,336
180350105,302,22,4,1,0,0,20,349
180350106,153,23,5,0,7,2,11,201
180350107,183,12,3,2,0,0,14,214
180350108,162,26,3,4,6,2,11,214
180350109,218,14,7,2,5,2,11,259
180350110,201,10,1,8,0,1,6,227
180350111,268,14,2,1,0,1,14,300
180350112,209,7,2,5,1,3,13,240
180350113,218,12,6,5,0,0,3,244
180350114,6,0,0,0,0,0,1,7
180350115,218,1,0,5,0,0,4,228
180350116,192,12,1,11,0,0,11,227
180350201,34,0,0,0,0,0,1,35
180350301,50,6,0,2,0,4,4,66
180350302,33,4,0,3,0,2,1,43
180350303,41,14,1,0,0,2,0,58
180350401,16,5,0,0,0,0,0,21
180350402,33,4,0,0,0,1,6,44
180350501,110,17,0,2,0,4,11,144
180350502,78,15,0,0,0,1,4,98
180350503,12,0,0,0,0,0,0,12
180350601,28,10,0,0,0,0,0,38
180350602,25,15,0,0,0,0,1,41
180350603,111,9,0,0,0,0,4,124
180350701,41,6,0,0,0,0,0,47
180350702,19,10,0,0,0,1,1,31
180350801,21,0,0,0,0,0,3,24
180350802,72,6,0,0,0,0,0,78
180350901,18,2,0,0,0,0,0,20
180350902,30,2,0,0,0,0,1,33
180351001,16,8,0,0,0,0,1,25
180351002,6,4,0,0,0,0,2,12
180351101,141,20,0,0,3,4,18,186
180351102,36,4,1,1,0,2,2,46
180351201,44,3,0,0,0,0,4,51
180351202,15,2,0,0,0,1,2,20
180351203,23,0,0,1,0,3,3,30
180351301,70,2,0,0,0,0,7,79
180351302,24,7,0,0,0,0,0,31
180351303,74,10,0,0,0,1,3,88
180351401,146,23,0,0,1,1,14,185
180351402,39,8,0,0,0,0,11,58
180351501,302,19,0,7,4,3,4,339
180351502,278,29,0,4,0,4,7,322
180351503,29,1,0,0,0,1,1,32
180351504,29,10,0,1,0,1,3,44
180351505,23,7,0,0,1,0,0,31
180351506,108,3,0,0,0,0,15,126
180351507,9,3,0,0,0,0,0,12
180351508,26,13,0,0,0,0,0,39
180351509,27,14,0,0,0,0,1,42
180351510,217,11,5,3,2,4,7,249
180351511,194,27,1,1,0,0,4,227
180351601,20,14,0,0,0,0,3,37
180351602,17,4,0,0,0,0,0,21
180351701,12,1,0,0,0,0,2,15
180351702,11,2,0,0,0,1,2,16
180351801,350,15,0,0,0,0,4,369
180351802,352,25,2,7,0,2,8,396
180351803,180,12,1,1,0,0,50,244
180351804,204,13,1,4,5,1,6,234
180351805,284,23,1,0,1,0,6,315
180351806,171,11,0,1,4,1,7,195
180351807,299,8,0,0,0,0,11,318
180351808,334,18,0,1,0,0,0,353
180351809,269,23,6,6,0,3,10,317
180351810,292,22,1,4,1,0,10,330
180351811,173,24,1,3,0,4,1,206
180351901,114,16,0,1,0,0,2,133
180351902,217,7,4,8,5,2,7,250
180351903,338,15,1,2,0,0,6,362
180351904,326,16,5,7,0,3,9,366
180351905,289,15,2,3,2,0,9,320
180351906,192,20,1,3,2,1,3,222
180351907,172,12,2,2,1,0,8,197
180351908,127,14,3,5,0,0,2,151
180351909,196,9,2,1,1,0,4,213
180351910,210,9,1,1,0,0,4,225
180351911,172,23,11,2,6,1,11,226
180351912,261,12,5,6,8,1,17,310
180351913,259,13,1,11,1,0,18,303
180420101,235,22,1,2,0,3,10,273
180420102,322,33,2,13,5,6,5,386
180420103,199,28,2,8,13,1,12,263
180420104,358,23,4,2,0,26,17,430
180420105,193,11,4,4,0,6,13,231
180420106,222,31,1,3,1,6,16,280
180420107,283,31,7,8,4,17,16,366
180420108,282,24,1,9,7,9,15,347
180420109,230,18,1,7,0,0,14,270
180420201,8,0,0,0,0,1,8,17
180420202,67,15,0,0,0,2,2,86
180420203,8,0,0,0,0,0,1,9
180420204,36,9,0,0,0,0,5,50
180420301,106,2,0,2,0,1,21,132
180420302,24,5,0,0,0,0,2,31
180420303,27,1,0,0,0,1,6,35
180420304,129,12,0,4,2,5,20,172
180420305,53,3,0,1,0,1,0,58
180420306,54,0,0,0,0,0,3,57
180420307,149,18,0,0,0,1,2,170
180420308,16,0,0,0,0,0,3,19
180420401,43,3,0,0,0,1,4,51
180420402,14,0,0,2,0,2,5,23
180420403,46,10,0,0,0,0,0,56
180420404,21,0,0,0,0,0,0,21
180420405,24,0,0,0,0,0,0,24
180420501,86,8,0,0,0,4,5,103
180420502,67,15,0,0,0,2,2,86
180420503,68,8,0,0,0,3,7,86
180420504,146,16,0,0,0,0,4,166
180420505,34,2,0,1,0,2,0,39
180420506,190,18,1,0,2,0,4,215
180420507,152,18,0,10,0,6,4,190
180420601,2,1,0,0,0,0,0,3
180420602,11,0,0,0,0,0,0,11
180420603,0,0,0,0,0,0,1,1
180490101,231,4,0,4,0,3,4,246
180490102,241,20,1,2,0,1,6,271
180490103,389,25,3,3,2,5,9,436
180490104,359,29,1,2,0,4,13,408
180490105,185,15,11,1,4,1,8,225
180490106,167,21,2,2,1,0,4,197
180490107,263,33,3,6,5,3,4,317
180490108,199,9,15,1,7,2,11,244
180490109,302,23,1,7,0,11,17,361
180490110,310,42,6,4,28,6,11,407
180490111,177,18,6,2,5,2,5,215
180490112,195,19,9,5,6,0,1,235
180490113,367,23,0,8,0,2,16,416
180490114,201,7,1,3,0,0,1,213
180490115,190,20,1,4,0,3,7,225
180490116,375,25,2,3,1,4,12,422
180490117,295,30,0,3,1,2,6,337
180490118,165,3,0,3,0,0,6,177
180490201,30,1,0,0,0,0,2,33
180490202,128,21,0,2,2,10,6,169
180490203,58,2,0,0,0,0,13,73
180490204,21,5,0,0,0,0,0,26
180490205,16,5,0,0,0,0,0,21
180490206,9,3,0,0,0,0,0,12
180490207,215,14,0,1,0,0,0,230
180490301,280,25,1,4,0,8,16,334
180490302,6,4,0,0,0,0,0,10
180490303,25,4,0,0,0,0,7,36
180490304,35,7,0,0,0,2,0,44
180490305,35,1,0,0,0,0,0,36
180490306,179,9,0,0,0,1,0,189
180490307,90,10,0,0,0,0,9,109
180490308,254,35,0,3,3,6,13,314
180490401,70,12,1,1,0,1,10,95
180490402,70,1,0,0,0,2,0,73
180490403,25,10,0,2,1,3,6,47
180490404,34,0,0,0,0,0,0,34
180490405,32,3,0,0,0,0,2,37
180490501,66,6,0,0,0,1,5,78
180490502,16,4,0,0,0,1,1,22
180490503,4,2,0,0,0,0,0,6
180490601,16,5,0,0,0,1,0,22
180490602,11,1,0,0,0,0,0,12
180490603,16,3,0,0,0,0,0,19
180490701,552,60,1,2,0,5,27,647
180490702,110,1,0,1,0,1,18,131
180490703,145,12,0,1,0,2,6,166
180490704,212,9,0,1,0,8,7,237
180490705,16,0,0,0,0,1,2,19
180490801,43,0,0,0,0,0,7,50
180490802,61,9,0,0,0,0,1,71
180490901,9,0,0,0,0,0,0,9
180490902,45,6,0,0,0,0,3,54
180490903,16,2,0,0,0,0,0,18
180490904,19,1,0,0,0,0,0,20
180491001,116,4,0,0,0,0,3,123
180491002,43,2,0,0,0,0,1,46
180491003,14,1,0,0,0,1,1,17
180491101,17,5,0,0,0,1,7,30
180560101,235,16,4,6,2,2,31,296
180560102,215,17,2,0,4,1,8,247
180560103,313,10,2,1,0,0,12,338
180560104,311,24,3,4,1,1,18,362
180560105,161,22,0,1,3,1,3,191
180560106,155,14,2,0,0,0,15,186
180560107,154,9,7,7,7,0,29,213
180560108,140,5,3,2,1,2,16,169
180560109,155,26,3,5,20,4,15,228
180560110,95,12,1,1,0,1,10,120
180560201,83,9,0,3,0,9,9,113
180560202,34,5,0,3,0,8,4,54
180560301,70,3,0,0,1,3,6,83
180560302,18,22,0,0,0,0,0,40
180560303,15,1,0,0,0,4,3,23
180560401,39,0,1,0,0,0,16,56
180560402,15,0,0,0,0,2,0,17
180560403,12,0,0,0,0,0,3,15
180560404,6,0,0,0,0,0,4,10
180560501,9,0,0,0,0,2,12,23
180560502,9,4,0,0,0,0,3,16
180560503,17,1,0,0,0,0,0,18
180560504,4,0,0,0,0,0,0,4
180560601,5,2,0,0,0,0,6,13
180560602,2,0,0,0,0,0,9,11
180560603,3,0,0,0,0,2,9,14
180560604,10,2,0,0,0,1,7,20
180560605,2,1,0,0,0,1,1,5
180630101,418,36,3,6,3,13,12,491
180630102,353,32,1,4,2,9,15,416
180630103,226,31,0,0,0,0,5,262
180630104,252,19,0,0,0,1,13,285
180630201,184,13,4,3,1,7,4,216
180630202,332,32,4,7,2,22,19,418
180630203,30,2,0,0,0,0,49,81
180630204,129,5,0,0,0,7,13,154
180630205,194,26,1,0,0,0,4,225
180630206,226,30,0,1,0,0,0,257
180630301,137,5,0,3,0,3,17,165
180630302,20,8,0,0,0,0,0,28
180630303,64,1,0,0,0,1,8,74
180630304,31,3,0,0,0,0,1,35
180630401,121,13,0,1,0,0,7,142
180630402,32,2,0,1,0,5,7,47
180630403,6,0,0,0,0,0,2,8
180630404,21,1,0,0,0,4,3,29
180630405,3,3,0,0,0,1,1,8
180630406,37,5,0,0,0,0,0,42
180630407,6,0,0,0,0,0,0,6
180630408,8,0,0,0,0,0,1,9
180630501,36,0,0,0,0,0,6,42
180630502,43,12,0,0,0,0,0,55
180630503,54,4,0,0,0,0,1,59
180630504,16,0,0,0,0,1,1,18
180630601,26,6,0,0,0,0,0,32
180630602,27,1,0,0,0,2,3,33
180630603,8,1,0,0,0,0,1,10
180630701,134,24,0,0,0,0,4,162
180630702,30,13,0,0,0,0,2,45
180630703,52,4,0,0,0,0,0,56
180630704,95,2,0,0,1,5,6,109
180630705,79,12,0,2,2,0,11,106
180630706,38,1,0,0,0,0,0,39
180630801,27,5,0,0,0,0,0,32
180630802,75,2,0,0,0,1,2,80
180630803,53,2,0,0,0,2,3,60
180630804,110,16,0,0,0,0,0,126
180630805,71,6,0,0,0,5,8,90
180630806,129,13,0,1,0,0,5,148
180630901,1,4,0,0,0,1,0,6
180700101,249,10,3,6,4,2,7,281
180700102,248,19,14,2,10,2,19,314
180700103,277,26,3,2,2,0,7,317
180700104,205,18,2,2,2,0,10,239
180700105,225,2,1,2,1,1,2,234
180700106,267,22,9,3,6,1,4,312
180700107,259,19,3,1,2,1,10,295
180700108,220,19,11,1,6,1,7,265
180700109,212,10,2,4,0,1,9,238
180700110,230,15,5,3,1,1,5,260
180700111,313,8,11,7,0,0,1,340
180700112,217,10,1,0,1,2,5,236
180700113,206,2,0,0,0,0,3,211
180700114,241,12,4,0,0,0,13,270
180700115,278,16,1,1,5,0,7,308
180700116,192,7,0,0,0,1,9,209
180700117,221,13,2,0,0,0,12,248
180700118,86,4,0,0,0,1,2,93
180700201,169,10,1,2,1,16,4,203
180700202,162,13,1,7,2,16,6,207
180700203,142,7,0,2,0,4,9,164
180700204,91,2,0,8,0,15,20,136
180700205,29,2,0,0,0,7,5,43
180700206,31,3,0,0,0,0,4,38
180700207,27,0,0,0,0,0,0,27
180700208,5,3,0,0,0,0,0,8
180700209,51,2,0,0,0,0,3,56
180700210,3,0,0,0,0,9,0,12
180700301,185,2,0,2,0,0,17,206
180700302,107,1,0,0,0,2,17,127
180700303,40,2,0,0,0,1,3,46
180700401,28,5,1,0,0,0,5,39
180700402,40,3,0,0,0,0,3,46
180700403,22,13,0,0,0,0,1,36
180700404,24,4,0,1,0,0,1,30
180700501,60,4,0,0,0,2,1,67
180700502,37,0,0,0,0,0,0,37
180700503,10,0,0,0,0,0,3,13
180700601,25,6,0,0,0,0,1,32
180700602,12,2,0,0,0,3,4,21
180700603,31,0,0,0,0,0,0,31
180700701,30,7,0,0,0,1,0,38
180700702,7,1,0,0,0,1,1,10
180700703,13,3,0,0,0,0,0,16
180700801,56,4,0,0,0,0,1,61
180700802,46,4,0,1,0,0,4,55
180700803,57,3,0,3,0,7,2,72
180700804,76,5,1,0,0,3,1,86
180700901,50,3,0,0,1,0,10,64
180700902,58,6,0,0,0,1,1,66
180701001,29,0,0,0,0,1,4,34
180701002,53,2,0,2,1,3,0,61
180701003,110,16,1,1,0,0,1,129
180701004,40,9,1,0,0,1,0,51
180701005,111,8,0,0,0,0,0,119
180701101,83,3,0,0,0,0,0,86
180701102,103,3,0,0,0,0,5,111
180701201,184,10,0,2,2,5,9,212
180701202,67,4,0,2,0,1,1,75
180701203,50,1,0,1,1,0,16,69
180701204,95,10,0,0,0,0,4,109
180701301,103,4,0,0,0,2,8,117
180701302,32,12,0,0,0,0,1,45
180701303,164,18,0,5,0,0,7,194
180701304,17,3,0,0,0,0,0,20
180701401,105,2,0,0,0,2,25,134
180701402,92,0,1,0,0,0,1,94
180701403,121,7,0,1,0,3,10,142
180701404,71,1,3,1,0,7,18,101
180701501,62,4,0,0,0,2,0,68
180701502,67,4,0,0,1,3,3,78
180701503,111,0,1,0,0,1,13,126
180701504,13,3,0,0,0,0,1,17
180701505,32,2,0,0,0,0,0,34
180701506,326,4,0,0,0,0,0,330
180701507,276,10,0,2,0,0,12,300
180701508,355,20,0,1,0,0,5,381
180701509,343,23,0,1,0,0,4,371
180701601,77,6,2,1,0,2,3,91
180701602,40,0,0,0,0,0,0,40
180701603,57,2,2,0,0,0,4,65
180701604,59,4,0,2,0,0,6,71
180701605,61,0,0,0,0,0,1,62
180701606,70,2,0,0,0,6,4,82
180701607,85,2,0,0,0,2,4,93
180701701,62,0,0,0,0,3,10,75
180701702,16,0,0,0,0,2,4,22
180701703,62,2,0,0,0,0,6,70
180701704,22,3,0,0,0,0,2,27
180701801,65,4,1,0,0,3,4,77
180701802,73,6,0,1,1,2,4,87
180701803,81,2,1,10,0,30,2,126
180701901,5,0,0,0,0,0,1,6
180701902,142,6,0,1,2,9,16,176
180701903,6,0,0,0,0,0,0,6
180701904,13,0,0,0,0,0,0,13
180701905,14,0,0,0,0,0,0,14
180701906,0,4,0,0,0,0,0,4
180701907,4,2,0,0,0,0,0,6
180701908,3,0,0,0,0,0,0,3
180701909,25,0,0,0,0,0,0,25
180702001,161,7,1,1,2,0,5,177
180702002,204,18,2,2,1,1,3,231
180702003,179,18,1,1,0,0,1,200
180702004,322,26,0,0,0,1,1,350
180702005,278,30,0,2,0,0,5,315
180702006,285,7,20,10,0,2,21,345
180702007,243,23,4,4,1,1,5,281
180702008,342,22,5,5,3,1,14,392
180702009,263,15,9,2,8,1,12,310
180702010,210,13,2,2,0,0,12,239
180702011,210,22,8,3,10,3,16,272
180702012,232,32,5,3,11,7,14,304
180702013,244,23,6,1,10,2,2,288
180702014,192,14,5,1,12,0,15,239
180702015,190,20,1,1,8,1,5,226
180702016,194,59,7,0,3,9,11,283
180702101,182,12,0,0,0,0,1,195
180702102,19,4,0,1,0,0,0,24
180702103,367,11,1,1,0,4,1,385
180702104,314,10,2,4,0,0,14,344
180702105,302,9,6,0,0,1,15,333
180702106,229,12,1,1,0,0,13,256
180702107,86,4,0,0,0,1,1,92
180702108,177,9,0,3,0,0,2,191
180702109,292,8,0,2,0,0,9,311
180702110,220,8,0,2,1,0,3,234
180702111,218,12,2,4,0,0,13,249
180702112,254,3,0,0,0,0,2,259
180702113,348,7,0,4,0,0,1,360
180702114,207,22,1,7,0,1,2,240
180702115,327,9,2,1,0,0,6,345
180702116,304,27,0,3,0,0,1,335
180702117,228,8,0,3,0,0,5,244
180702201,356,15,0,1,0,0,6,378
180702202,337,6,0,2,0,1,17,363
180702203,248,10,6,7,0,1,10,282
180702204,364,15,3,6,0,1,7,396
180702205,147,4,0,1,0,1,2,155
180702206,331,14,1,0,0,2,6,354
180702207,221,15,1,1,0,0,3,241
180702208,235,7,0,2,0,0,9,253
180702209,202,7,1,1,1,0,6,218
180702210,402,12,0,0,0,0,15,429
180702211,21,2,0,0,0,0,0,23
180702212,371,13,0,3,1,2,13,403
180702213,317,4,2,0,0,0,6,329
180702214,247,10,1,0,0,0,19,277
180702215,346,5,0,0,0,0,4,355
180702216,277,11,0,6,0,1,4,299
180702217,236,12,5,0,2,0,2,257
180702218,306,15,0,7,0,0,1,329
180770101,196,9,0,3,0,2,2,212
180770102,155,13,1,3,5,16,14,207
180770103,307,34,1,5,1,6,9,363
180770104,294,41,0,4,0,3,13,355
180770105,201,20,1,4,0,11,14,251
180770106,210,15,0,1,0,6,24,256
180770201,168,11,2,5,0,2,13,201
180770202,82,2,1,2,0,2,20,109
180770203,68,6,0,0,0,1,1,76
180770204,91,10,1,0,1,5,1,109
180770205,61,2,2,0,0,8,13,86
180770206,13,2,0,0,0,0,0,15
180770207,14,0,0,0,0,0,2,16
180770208,146,13,0,1,0,1,5,166
180770301,164,6,0,1,0,5,7,183
180770302,56,8,0,2,0,0,3,69
180770401,23,10,0,0,1,0,1,35
180770402,75,10,0,0,0,0,0,85
180770501,23,0,0,0,0,0,2,25
180770502,32,1,0,1,0,1,0,35
180770503,5,0,0,0,0,0,3,8
180770601,0,0,0,0,0,0,1,1
180770602,1,0,0,0,0,0,0,1
180770603,0,0,0,0,0,0,1,1
180840101,335,41,3,7,0,52,37,475
180840102,212,25,9,3,1,169,33,452
180840103,222,44,1,4,0,2,2,275
180840104,176,29,2,1,2,1,9,220
180840105,222,11,0,3,4,8,11,259
180840106,243,6,2,3,2,7,5,268
180840107,310,16,1,8,4,3,14,356
180840108,272,15,0,8,0,0,13,308
180840109,225,19,8,4,36,5,12,309
180840110,212,14,6,1,27,11,18,289
180840111,235,29,1,3,4,10,19,301
180840112,297,8,6,2,14,7,9,343
180840113,203,57,0,0,0,9,17,286
180840114,291,23,1,0,0,1,15,331
180840115,298,17,1,2,0,8,2,328
180840116,311,14,1,1,0,14,8,349
180840117,125,25,1,0,0,99,11,261
180840118,421,29,4,19,0,5,14,492
180840201,282,24,0,7,2,1,15,331
180840202,14,0,0,0,0,0,0,14
180840203,68,11,2,8,0,118,6,213
180840204,116,11,2,4,0,15,7,155
180840205,228,30,1,11,0,17,4,291
180840206,7,1,0,1,0,3,0,12
180840301,70,2,0,1,0,1,9,83
180840302,12,3,0,0,0,0,0,15
180840303,6,0,0,0,0,1,3,10
180840304,10,6,0,0,0,0,0,16
180840305,6,4,0,0,0,0,3,13
180840306,34,2,0,0,0,2,16,54
180840401,3,0,0,0,0,1,6,10
180840402,4,0,0,0,0,0,1,5
180840403,24,2,0,0,0,157,3,186
180840404,8,0,0,1,0,2,2,13
180840501,28,16,0,0,0,3,3,50
180840502,33,3,0,0,0,0,4,40
180840503,25,7,0,0,0,0,1,33
180840601,19,0,0,0,0,2,8,29
180840602,15,0,0,0,0,0,0,15
180840603,19,6,0,0,0,0,4,29
180840701,26,1,0,0,0,3,0,30
180840702,10,0,0,0,1,4,4,19
180840703,10,0,2,1,0,41,3,57
180840801,6,0,0,0,0,0,6,12
180840802,17,1,0,0,0,0,1,19
180840901,23,1,0,0,0,1,2,27
180840902,23,9,0,0,0,0,3,35
180840903,32,5,1,0,0,1,1,40
180841001,171,14,0,2,2,1,6,196
180841002,193,7,0,3,0,2,17,222
180841003,170,4,0,2,0,1,17,194
180841004,80,7,5,0,0,0,1,93
180841005,38,12,0,0,0,0,37,87
180841006,13,2,0,0,0,0,0,15
180841007,75,8,0,0,0,3,8,94
180841008,17,17,0,0,0,2,2,38
180841009,8,0,0,0,0,1,5,14
180841101,256,14,3,7,1,0,17,298
180841102,62,0,0,0,0,3,3,68
180841103,28,5,0,0,0,1,8,42
180841104,81,9,0,0,0,0,3,93
180841105,136,2,0,0,0,0,37,175
180841106,18,0,0,1,1,3,4,27
180841107,14,0,0,0,0,0,3,17
180841108,33,5,0,0,0,0,2,40
180841109,306,14,6,1,0,0,10,337
180841201,225,24,1,9,2,3,24,288
180841202,45,4,0,0,0,0,3,52
180841203,122,2,0,0,0,0,0,124
180841204,37,6,0,0,0,0,0,43
180841205,2,0,0,0,0,0,0,2
180841206,0,0,0,0,0,0,1,1
180841207,0,0,0,0,0,0,1,1
180910101,303,13,0,10,0,1,6,333
180910102,219,21,2,3,6,1,11,263
180910103,166,8,4,2,2,4,17,203
180910104,226,15,0,4,4,1,5,255
180910105,296,13,0,4,2,1,5,321
180910106,298,15,0,0,0,0,7,320
180910107,272,13,0,2,1,2,4,294
180910108,243,18,8,2,1,5,6,283
180910109,207,16,2,3,3,0,11,242
180910110,449,20,5,4,0,2,2,482
180910201,192,8,0,3,1,2,3,209
180910202,101,0,0,1,0,13,9,124
180910203,230,12,4,2,0,9,7,264
180910204,133,2,0,2,0,0,4,141
180910205,17,3,0,0,0,0,1,21
180910206,130,6,0,0,0,2,5,143
180910207,166,7,0,0,0,0,8,181
180910208,192,10,1,4,2,3,5,217
180910209,257,12,1,3,1,6,9,289
180910210,135,16,3,11,0,6,10,181
180910211,120,4,0,1,0,3,11,139
180910212,59,6,0,0,0,1,4,70
180910301,148,15,3,3,0,0,10,179
180910302,93,1,0,0,0,1,5,100
180910303,104,5,0,0,0,0,11,120
180910304,31,0,0,0,0,2,4,37
180910305,63,0,0,0,1,0,4,68
180910401,132,28,0,1,0,0,4,165
180910402,83,3,0,0,0,5,2,93
180910403,67,0,0,0,0,0,6,73
180910404,63,3,0,0,0,0,4,70
180910405,114,9,0,0,0,3,5,131
180910406,33,1,0,0,0,2,3,39
180910407,22,1,0,0,0,0,2,25
180910501,15,0,0,0,0,0,3,18
180910502,19,0,0,0,0,2,6,27
180910503,72,4,0,0,0,6,4,86
180910504,37,2,0,0,0,6,7,52
180910505,11,0,0,0,1,1,0,13
180910506,14,3,0,0,0,0,0,17
180910601,10,3,0,0,0,0,2,15
180910602,7,2,0,0,0,0,0,9
180910603,12,7,0,0,0,0,1,20
180910701,180,16,0,1,0,1,4,202
180910702,49,6,0,0,0,0,0,55
180910703,103,4,0,0,0,0,13,120
180910704,127,6,0,0,0,0,12,145
180910705,38,2,0,0,0,0,3,43
180910706,248,17,0,2,0,3,6,276
180910801,36,0,0,0,0,0,4,40
180910802,197,7,0,1,0,0,18,223
180910803,250,19,0,1,0,3,23,296
180910804,155,14,0,0,0,0,17,186
180910805,47,7,0,0,0,1,3,58
180910806,113,2,0,0,0,0,17,132
180910901,3,0,0,0,0,0,0,3
180910902,1,0,0,0,0,0,0,1
180910903,0,0,0,0,0,0,1,1
180980101,232,39,1,4,1,5,3,285
180980102,255,40,1,5,1,0,4,306
180980103,364,63,2,15,1,30,15,490
180980104,204,14,0,1,2,11,14,246
180980105,163,30,2,3,4,0,6,208
180980106,243,68,0,3,0,2,10,326
180980107,232,21,0,3,1,6,31,294
180980201,100,6,0,0,0,1,13,120
180980202,60,14,0,1,0,5,2,82
180980203,181,29,0,2,0,0,7,219
180980301,71,16,0,0,0,1,15,103
180980302,121,19,1,0,0,1,9,151
180980303,47,0,0,0,0,2,8,57
180980304,71,2,0,0,0,5,11,89
180980401,6,13,0,0,0,0,2,21
180980402,25,1,0,0,0,0,1,27
180980403,52,2,0,1,0,0,2,57
180980501,19,1,0,0,1,1,8,30
180980502,18,2,0,0,0,0,12,32
180980503,18,2,0,0,0,2,2,24
181050101,244,24,1,2,0,0,9,280
181050102,247,6,0,2,0,2,6,263
181050103,289,18,1,2,1,1,9,321
181050104,297,16,1,4,2,3,10,333
181050105,185,22,0,3,1,3,11,225
181050106,352,26,3,14,1,2,10,408
181050107,423,45,2,2,0,1,10,483
181050108,123,8,5,3,1,2,10,152
181050109,275,36,4,2,8,1,11,337
181050110,290,28,2,3,9,0,8,340
181050111,150,20,2,5,5,3,2,187
181050112,248,15,2,11,0,2,6,284
181050113,345,16,5,11,1,2,6,386
181050114,349,21,3,1,0,3,7,384
181050115,190,17,6,0,12,0,11,236
181050201,14,2,1,1,0,1,2,21
181050202,74,13,2,10,1,7,2,109
181050203,44,0,0,0,0,1,6,51
181050204,323,26,0,0,1,3,14,367
181050301,4,0,0,0,0,0,0,4
181050302,49,12,0,0,0,1,2,64
181050401,15,0,0,0,0,0,0,15
181050402,6,0,0,0,0,0,1,7
181050501,12,0,0,0,0,0,5,17
181050502,21,1,0,0,1,1,1,25
181050503,12,0,0,0,0,0,0,12
181050601,27,2,0,1,0,1,5,36
181050602,19,4,0,0,0,0,2,25
181050603,14,0,0,0,0,0,0,14
181050701,9,0,0,0,0,0,12,21
181050702,7,5,0,0,0,0,2,14
181050801,21,0,1,6,0,0,3,31
181050802,21,9,0,0,1,1,1,33
181050803,31,1,0,0,0,3,65,100
181050804,3,0,0,0,0,0,7,10
181050805,188,10,0,0,0,0,0,198
181050806,6,0,0,0,0,0,0,6
181050901,245,70,1,3,0,0,12,331
181050902,12,5,0,0,0,0,1,18
181050903,19,1,0,0,0,0,0,20
181050904,258,51,5,3,1,1,11,330
181051001,3,5,0,0,0,0,0,8
181051002,3,8,0,0,0,0,0,11
181051003,82,7,0,1,0,3,8,101
181051101,384,45,1,6,2,2,14,454
181051102,15,5,0,0,0,0,6,26
181051103,17,3,0,0,0,2,4,26
181051104,10,5,0,0,0,0,0,15
181051201,30,0,0,0,0,4,10,44
181051202,49,1,1,1,0,2,4,58
181051203,27,11,0,1,0,0,1,40
181051204,82,7,1,3,1,8,12,114
181051301,77,10,0,0,0,0,7,94
181051302,24,0,0,0,0,0,0,24
181051303,4,3,0,0,0,4,1,12
181051304,48,11,2,2,0,7,4,74
181051305,25,1,0,0,0,2,0,28
181051306,2,0,0,0,0,3,0,5
181051401,5,0,0,0,0,0,0,5
181051402,6,5,0,0,0,0,0,11
181051403,7,3,0,0,0,0,0,10
181051404,2,0,0,0,0,0,0,2
181051501,9,8,0,0,0,0,0,17
181051502,1,0,0,0,0,0,0,1
181051503,3,6,0,0,0,0,0,9
181051601,83,5,0,0,0,0,5,93
181051602,22,3,0,1,0,1,3,30
181051603,20,1,0,0,0,0,1,22
181051604,18,1,0,0,0,0,2,21
181051605,23,8,0,0,0,0,1,32
181051701,5,0,0,0,0,0,0,5
181051702,5,2,0,0,0,0,0,7
181051801,33,6,0,0,0,0,2,41
181051802,9,1,0,0,0,0,1,11
181051901,12,8,0,0,0,0,0,20
181051902,21,0,0,0,0,0,0,21
181052001,2,2,0,0,0,0,0,4
181052002,4,3,0,0,0,0,1,8
181052003,5,1,0,0,0,0,1,7
181052101,176,6,0,0,0,0,1,183
181052102,432,27,5,2,1,1,11,479
181052103,263,16,4,4,0,1,10,298
181052104,223,12,3,3,0,0,9,250
181052105,260,36,7,3,13,3,30,352
181052106,287,27,10,5,7,1,16,353
181052107,367,31,3,4,0,2,12,419
181052108,266,35,9,8,29,0,17,364
181052109,206,18,2,13,0,1,15,255
181052110,180,18,2,0,0,2,10,212
181052111,303,25,4,6,0,1,11,350
181052112,441,47,3,5,2,0,4,502
181052113,351,21,2,6,0,1,15,396
181052114,245,13,0,0,1,0,3,262
181120101,269,8,0,0,0,0,0,277
181120102,77,2,0,0,0,0,15,94
181120103,61,2,0,0,1,1,17,82
181120104,324,29,1,0,1,1,5,361
181120105,208,11,2,7,1,5,6,240
181120106,322,14,0,0,0,0,7,343
181120107,274,11,1,5,0,2,10,303
181120108,326,14,1,3,0,0,2,346
181120109,202,8,1,4,0,0,4,219
181120110,166,17,0,1,2,1,5,192
181120111,176,22,2,0,0,1,1,202
181120112,203,11,1,2,1,1,4,223
181120113,157,19,5,5,2,0,5,193
181120114,338,27,7,4,1,0,7,384
181120201,24,1,0,0,0,0,5,30
181120202,69,10,0,2,0,1,0,82
181120203,48,2,0,0,0,4,2,56
181120204,30,3,0,0,0,1,2,36
181120205,32,7,0,0,0,1,4,44
181120206,38,2,2,0,0,3,4,49
181120207,23,5,0,0,0,5,0,33
181120208,14,1,0,0,0,0,0,15
181120209,26,5,0,0,0,4,3,38
181120210,43,3,0,2,0,3,7,58
181120211,4,1,0,0,0,0,0,5
181120212,118,5,0,0,1,0,1,125
181120301,17,0,0,0,0,0,0,17
181120302,7,0,0,0,0,0,1,8
181120303,18,0,0,0,0,0,0,18
181120304,4,0,0,0,0,0,0,4
181120401,44,7,0,0,0,0,5,56
181120402,19,8,0,0,0,0,0,27
181120403,46,3,0,0,0,0,2,51
181120404,155,14,1,4,1,3,13,191
181120405,35,1,0,0,0,0,4,40
181120406,8,2,0,1,0,1,0,12
181120407,21,0,0,1,0,0,0,22
181120408,6,4,0,0,0,0,0,10
181120409,17,1,0,0,0,0,0,18
181120410,22,0,0,0,0,0,1,23
181120411,10,6,0,0,0,0,0,16
181120501,2,3,0,0,0,0,0,5
181120502,28,5,0,1,0,0,6,40
181120503,20,0,0,0,0,6,1,27
181120504,5,1,0,0,0,0,0,6
181120601,27,3,1,1,0,0,0,32
181120602,41,2,0,0,0,1,0,44
181120603,7,0,0,0,0,0,4,11
181120604,14,6,0,0,0,0,1,21
181120701,308,8,1,0,0,4,34,355
181120702,96,6,0,0,0,0,9,111
181120703,18,2,0,0,0,0,0,20
181120704,46,2,0,0,0,0,0,48
181120705,24,1,0,0,0,0,2,27
181120706,10,3,0,0,0,0,0,13
181120707,12,5,0,0,0,0,0,17
181120708,11,1,2,1,1,5,6,27
181120709,0,2,0,0,0,0,0,2
181120710,34,2,0,0,0,3,6,45
181120801,53,4,0,0,1,0,21,79
181120802,50,6,0,0,0,1,5,62
181120803,72,9,0,1,0,2,0,84
181120804,75,5,0,0,0,6,5,91
181120805,15,2,0,0,0,5,3,25
181120806,293,14,2,12,1,0,4,326
181120807,288,16,3,7,1,3,1,319
181120808,471,17,0,12,0,2,6,508
181120809,243,9,0,7,0,2,12,273
181120810,382,11,0,5,2,0,1,401
181120901,200,5,0,1,1,2,3,212
181120902,235,15,1,4,0,1,8,264
181120903,209,12,0,11,2,0,10,244
181120904,186,15,7,3,7,0,11,229
181120905,229,29,2,3,1,0,10,274
181120906,186,18,2,7,6,1,10,230
181120907,283,19,3,6,2,3,10,326
181120908,298,25,3,10,0,7,11,354
181120909,236,11,3,0,1,1,7,259
181120910,244,11,3,4,3,2,10,277
181120911,274,17,2,2,2,1,5,303
181120912,205,10,1,3,2,1,3,225
181120913,474,12,0,2,0,0,18,506
181120914,214,7,0,2,1,0,6,230
181190101,232,3,0,2,0,6,18,261
181190102,240,3,0,0,0,0,0,243
181190103,326,6,0,1,6,0,0,339
181190104,486,16,0,2,1,1,5,511
181190105,307,20,1,0,0,0,6,334
181190106,148,10,0,0,0,0,1,159
181190107,190,8,0,0,0,0,0,198
181190108,256,17,1,0,1,0,3,278
181190109,394,16,0,3,0,0,0,413
181190110,161,11,0,2,0,0,1,175
181190111,205,11,0,2,0,1,3,222
181190112,73,8,0,0,0,0,0,81
181190113,123,7,0,1,1,0,9,141
181190114,186,3,0,0,1,0,6,196
181190115,370,16,2,2,9,2,10,411
181190116,256,16,0,4,0,0,4,280
181190117,184,10,0,0,0,0,13,207
181190201,10,4,0,0,0,0,0,14
181190202,14,0,0,0,0,0,2,16
181190301,89,19,1,2,0,1,4,116
181190302,100,3,0,0,0,0,1,104
181190303,7,0,0,0,0,0,0,7
181190401,149,36,1,11,3,0,12,212
181190402,16,5,0,0,0,0,0,21
181190403,19,0,0,0,0,0,2,21
181190404,27,2,0,0,0,0,2,31
181190501,4,1,0,0,0,0,0,5
181190502,20,5,0,1,0,1,0,27
181190601,200,15,0,0,1,1,3,220
181190602,12,1,0,0,0,0,0,13
181190701,15,1,0,0,0,0,0,16
181190702,40,6,0,0,0,0,2,48
181190703,9,0,0,0,0,0,0,9
181190801,7,0,0,0,0,0,3,10
181190802,23,2,0,1,0,1,2,29
181190901,133,10,0,0,0,3,20,166
181190902,7,4,0,0,0,0,0,11
181190903,10,1,0,0,0,0,5,16
181190904,3,1,0,0,0,0,0,4
181190905,13,5,0,0,0,0,0,18
181191001,39,6,0,1,0,0,1,47
181191002,28,2,0,0,0,0,0,30
181191003,19,2,0,0,0,2,0,23
181191101,12,1,0,0,0,0,5,18
181191102,11,1,0,0,0,0,7,19
181191103,14,0,0,0,0,0,0,14
181191201,17,7,0,0,0,0,0,24
181191202,11,7,0,0,0,0,0,18
181191203,13,3,0,0,0,0,0,16
181191301,1,5,0,0,0,0,0,6
181191401,121,1,0,2,0,3,13,140
181191402,204,4,1,0,0,1,5,215
181191403,346,12,3,1,1,1,1,365
181191404,121,7,0,2,0,0,3,133
181191405,387,8,0,1,0,0,9,405
181191406,210,17,0,2,0,1,14,244
181191407,319,16,1,28,4,2,3,373
181191501,216,1,0,0,0,1,3,221
181191502,157,6,0,2,0,1,0,166
181191503,328,16,6,0,1,0,4,355
181191504,267,18,8,3,4,0,4,304
181191505,302,30,9,11,9,2,9,372
181191506,161,21,6,8,39,1,9,245
181191507,191,11,0,1,1,1,2,207
181191508,259,11,1,1,0,0,3,275
181191509,189,3,1,4,0,0,3,200
181191510,221,14,4,4,0,0,1,244
181191511,275,54,9,4,31,1,10,384
181191512,205,22,4,4,3,0,9,247
181191513,217,22,2,2,5,0,11,259
181191514,69,9,0,0,1,0,16,95
181191515,289,20,2,0,3,0,11,325
181191516,159,11,7,5,5,0,11,198
181191517,111,13,7,1,19,2,6,159
181191518,163,20,2,1,13,2,9,210
181191519,351,18,6,4,7,0,13,399
181191520,358,16,16,1,3,1,10,405
181191521,248,10,2,1,0,0,3,264
181191522,197,10,1,4,1,0,3,216
181191523,183,16,5,2,0,1,2,209
181260101,294,16,0,5,0,1,27,343
181260102,294,23,8,7,10,6,9,357
181260103,240,21,1,0,2,3,2,269
181260104,336,27,7,4,0,3,13,390
181260105,365,19,0,8,0,9,7,408
181260106,376,39,4,2,1,4,3,429
181260107,378,47,1,3,1,2,13,445
181260108,368,24,0,5,0,0,9,406
181260109,263,24,0,3,1,1,10,302
181260201,50,2,0,0,0,0,5,57
181260202,309,12,1,8,0,4,10,344
181260203,7,6,0,0,0,1,4,18
181260301,135,13,0,1,0,0,1,150
181260302,35,0,3,0,0,0,9,47
181260401,40,1,2,0,0,1,4,48
181260402,31,7,0,0,0,0,0,38
181260501,299,30,0,3,0,2,13,347
181260502,103,9,0,2,1,4,9,128
181260601,110,12,0,1,0,0,0,123
181260602,18,4,0,0,0,0,1,23
181260603,7,1,0,0,0,0,0,8
181260701,348,32,0,0,0,1,2,383
181260702,63,2,0,1,0,0,12,78
181260703,131,12,0,1,0,0,11,155
181260801,59,3,2,0,0,3,10,77
181260802,34,5,0,0,0,2,8,49
181260901,280,45,1,6,4,8,9,353
181260902,356,29,0,13,3,9,12,422
181260903,81,8,0,1,2,7,6,105
181260904,60,5,0,0,0,1,3,69
181330101,205,4,1,1,1,4,12,228
181330102,130,15,2,5,6,11,11,180
181330103,139,20,1,11,7,24,6,208
181330104,24,8,0,0,0,0,0,32
181330201,40,61,5,4,1,137,15,263
181330202,58,21,6,9,1,124,6,225
181330203,66,15,1,4,0,6,15,107
181330204,122,19,1,5,0,22,3,172
181330205,64,2,0,3,0,2,6,77
181330206,156,62,7,6,4,80,48,363
181330207,162,74,10,2,0,49,4,301
181330208,186,104,10,3,0,70,13,386
181330209,84,13,9,4,1,175,7,293
181330210,81,30,16,5,0,130,6,268
181330211,32,31,44,10,1,141,20,279
181330212,106,39,0,6,0,47,102,300
181330213,90,87,3,7,0,26,5,218
181330214,347,25,2,5,1,8,18,406
181330215,70,27,2,4,0,42,27,172
181330216,18,0,0,0,0,5,1,24
181330301,249,43,0,0,0,7,11,310
181330302,139,7,0,0,0,19,22,187
181330303,26,2,0,0,0,4,15,47
181330304,21,4,0,0,0,0,2,27
181330305,2,3,0,0,0,0,1,6
181330401,177,12,0,0,1,4,28,222
181330402,33,3,0,0,0,6,7,49
181330403,76,8,0,0,0,3,3,90
181330501,246,59,5,4,1,21,8,344
181330502,244,14,1,8,1,72,11,351
181330503,50,0,0,1,0,6,0,57
181330504,66,7,0,0,1,9,17,100
181330505,46,0,0,1,0,10,1,58
181330506,72,1,0,3,0,5,13,94
181330507,61,12,1,1,0,58,8,141
181330601,1,0,0,0,0,0,0,1
181330602,0,2,0,0,0,0,0,2
181330603,1,0,0,0,0,0,0,1
181400101,261,20,1,4,0,2,7,295
181400102,203,18,1,4,1,6,12,245
181400103,247,8,1,6,0,10,20,292
181400104,240,11,1,1,1,2,15,271
181400105,259,16,0,3,1,4,14,297
181400106,327,17,0,1,5,1,5,356
181400107,256,17,1,15,3,1,13,306
181400108,247,17,0,2,0,3,11,280
181400109,267,19,0,12,0,4,4,306
181400110,294,18,2,2,1,1,29,347
181400201,79,20,0,0,0,0,1,100
181400202,89,8,0,1,0,10,10,118
181400203,422,18,1,6,1,14,18,480
181400204,40,2,0,2,0,2,6,52
181400205,5,1,0,0,0,1,2,9
181400206,178,7,1,0,0,3,2,191
181400301,28,1,0,0,0,1,10,40
181400302,37,0,0,0,0,4,7,48
181400303,17,0,0,0,0,1,1,19
181400401,13,0,0,0,0,0,2,15
181400402,19,0,0,0,0,0,2,21
181400403,15,1,0,0,0,0,0,16
181400404,22,2,0,0,0,0,0,24
181400405,54,0,0,0,0,4,2,60
181400501,26,8,0,0,0,0,1,35
181400502,15,1,0,0,0,0,0,16
181400503,12,0,0,0,0,0,0,12
181400504,17,0,0,0,0,0,0,17
181400601,58,4,0,0,0,1,0,63
181400602,70,1,0,0,0,0,0,71
181400603,2,9,0,0,0,0,0,11
181400604,7,0,0,0,0,0,0,7
181400701,41,3,0,0,0,0,0,44
181400702,21,1,0,0,0,6,3,31
181400703,60,0,0,1,0,6,7,74
181400704,12,1,0,0,0,1,0,14
181400801,10,0,0,0,0,2,7,19
181400802,31,6,0,0,0,1,2,40
181400803,71,3,0,2,0,0,11,87
181400804,22,1,0,0,0,0,3,26
181400805,36,0,0,0,0,0,2,38
181400806,17,0,0,0,0,0,5,22
181400807,6,1,0,0,0,0,0,7
181400808,1,1,0,0,0,1,0,3
181400809,11,1,0,0,0,1,1,14
181400901,9,1,0,0,0,1,3,14
181400902,40,1,0,0,0,0,0,41
181400903,39,0,0,1,0,0,2,42
181470101,279,26,0,0,0,0,16,321
181470102,285,26,5,3,0,3,5,327
181470103,254,40,2,5,0,2,11,314
181470104,225,29,3,2,8,0,1,268
181470105,257,40,5,7,6,4,10,329
181470106,332,22,4,6,2,6,19,391
181470107,224,15,2,5,1,3,9,259
181470201,50,4,0,2,1,3,2,62
181470202,56,3,0,0,0,2,5,66
181470203,34,1,0,1,0,0,4,40
181470204,20,3,0,0,0,0,0,23
181470205,166,13,0,3,1,0,8,191
181470206,226,30,2,7,2,5,8,280
181470207,185,12,2,2,1,11,7,220
181470301,13,6,0,0,0,0,0,19
181470302,18,0,0,5,1,3,14,41
181470303,11,0,0,0,0,0,10,21
181470304,18,0,0,0,0,0,8,26
181470401,20,0,0,0,0,5,1,26
181470402,13,3,0,0,0,0,6,22
181470403,11,0,0,0,0,0,0,11
181470501,10,0,0,0,0,0,0,10
181470502,25,2,0,0,0,0,0,27
181470503,6,0,0,0,0,0,0,6
181470601,4,1,0,0,0,0,1,6
181470602,11,11,0,0,0,0,1,23
181470603,9,0,0,0,0,0,0,9
181470604,2,0,0,0,0,0,0,2
181470701,18,6,0,0,0,0,0,24
181470702,5,1,0,0,0,0,2,8
181470703,4,2,0,0,0,0,0,6
181470801,168,33,1,3,0,2,10,217
181470802,164,30,0,4,0,5,19,222
181470803,17,0,0,0,0,0,5,22
181470804,16,6,0,0,2,1,1,26
181470901,8,3,0,0,0,0,0,11
181470902,27,16,0,0,0,0,0,43
181470903,26,11,0,0,0,0,0,37
181471001,14,1,0,0,0,1,2,18
181471002,12,5,0,0,0,0,0,17
181471003,14,2,0,0,0,0,2,18
181471004,4,2,0,0,0,0,0,6
181471101,7,1,0,0,0,0,0,8
181471102,8,0,0,0,0,0,0,8
181471103,1,1,0,0,0,0,0,2
181471201,104,5,2,9,4,5,8,137
181471202,20,5,0,1,0,0,0,26
181471203,9,0,0,1,0,1,0,11
181471204,115,5,3,4,3,1,5,136
181540101,407,31,0,4,2,6,17,467
181540102,347,21,1,5,0,2,3,379
181540103,229,32,1,0,2,1,5,270
181540201,54,9,1,0,0,0,2,66
181540202,304,23,0,0,0,2,10,339
181540203,217,11,0,0,0,1,13,242
181540204,6,4,0,0,0,0,1,11
181540301,2,0,0,0,0,0,0,2
181540302,3,1,0,0,0,0,2,6
181540401,63,6,0,0,0,0,0,69
181540402,37,2,0,0,0,0,0,39
181540501,2,1,0,0,0,0,0,3
181540502,4,0,0,0,0,0,0,4
181540601,31,0,0,0,0,0,1,32
181540602,11,1,0,0,0,0,1,13
181540603,18,6,0,0,0,0,0,24
181540701,232,32,2,1,0,5,12,284
181540702,126,23,0,1,0,1,7,158
181540703,123,16,0,0,1,7,11,158
181540704,232,22,3,5,1,6,18,287
181540801,12,4,0,0,0,1,3,20
181540802,13,1,0,1,0,1,3,19
181540901,0,1,0,0,0,0,0,1
181610101,195,21,3,1,0,1,4,225
181610102,225,22,0,4,0,0,5,256
181610103,199,23,0,4,0,1,7,234
181610104,228,20,4,2,5,3,11,273
181610105,283,15,1,2,0,0,9,310
181610106,340,23,2,0,0,6,6,377
181610107,207,11,1,1,1,5,9,235
181610108,153,5,1,3,1,6,16,185
181610201,94,6,0,0,0,0,0,100
181610202,116,4,0,0,0,0,11,131
181610203,72,12,0,0,0,1,4,89
181610204,59,2,0,1,0,3,3,68
181610205,26,0,0,0,0,6,9,41
181610206,104,2,0,1,0,0,1,108
181610301,92,3,0,0,0,0,11,106
181610302,2,0,0,0,0,0,1,3
181610303,31,0,0,0,0,0,0,31
181610304,2,0,0,0,0,0,7,9
181610401,153,15,1,0,0,0,5,174
181610402,78,0,0,0,0,0,8,86
181610403,12,1,0,0,0,0,2,15
181610404,53,3,0,0,0,2,0,58
181610405,226,21,1,2,2,2,15,269
181610501,28,10,0,0,0,1,1,40
181610502,26,5,0,0,0,0,3,34
181610503,32,5,0,0,0,0,0,37
181610504,291,38,1,6,0,3,5,344
181610505,308,50,1,3,2,8,15,387
181610601,288,18,2,5,1,5,13,332
181610602,73,31,0,0,0,0,2,106
181610603,89,20,4,0,0,0,0,113
181610604,12,2,0,0,0,4,0,18
181610605,130,15,0,0,0,1,13,159
181610606,55,2,0,0,0,0,3,60
181610607,231,14,1,1,1,5,12,265
181680101,56,0,0,0,0,0,1,57
181680102,245,14,0,7,3,0,4,273
181680103,261,26,3,3,0,0,11,304
181680104,286,24,7,1,2,1,12,333
181680105,220,35,5,1,2,0,13,276
181680106,281,7,3,2,0,5,9,307
181680107,294,13,4,0,0,1,2,314
181680108,286,14,3,2,0,0,9,314
181680109,286,15,3,3,0,0,8,315
181680110,249,14,2,2,0,1,2,270
181680201,91,5,0,0,1,3,4,104
181680202,60,10,1,4,1,7,14,97
181680301,30,16,0,4,1,0,1,52
181680302,27,11,0,0,0,5,2,45
181680303,15,2,0,0,0,2,6,25
181680401,10,7,0,0,0,0,0,17
181680402,15,1,0,0,0,5,3,24
181680403,13,10,0,0,0,1,4,28
181680501,36,2,0,0,0,4,0,42
181680502,9,0,0,0,0,0,0,9
181680601,7,0,0,0,0,1,3,11
181680602,11,8,0,0,0,0,4,23
181680603,71,45,0,1,0,1,16,134
181680604,23,0,0,0,0,0,5,28
181680701,254,18,5,4,4,0,3,288
181680702,415,23,6,3,0,0,9,456
181680703,420,14,4,7,0,1,4,450
181680704,251,18,4,23,3,0,4,303
181680705,561,19,1,14,0,3,13,611
181680706,352,11,1,1,2,5,8,380
181680707,201,13,0,2,2,6,14,238
181680708,1,0,0,0,0,0,2,3
181680709,0,0,0,0,0,0,2,2
181680710,9,0,0,0,0,0,5,14
181680711,121,21,1,1,0,1,11,156
181680712,369,21,1,7,0,0,4,402
181680713,269,34,8,6,4,2,7,330
181680714,180,8,2,1,0,0,5,196
181680715,236,26,3,4,1,2,2,274
181680716,249,4,5,5,2,2,3,270
181680717,206,11,4,1,0,1,5,228
181680718,382,23,2,0,2,5,3,417
181680719,303,4,5,0,0,0,2,314
181680720,257,15,6,6,5,2,5,296
181680721,237,10,12,6,2,1,4,272
181680722,422,22,4,5,0,0,9,462
181680723,224,14,5,2,0,0,6,251
181680724,217,17,12,2,1,0,2,251
181680725,422,18,4,14,1,2,4,465
181680726,3,1,0,0,0,0,0,4
181680727,223,30,0,7,0,0,37,297
181680801,54,6,0,0,0,1,0,61
181680802,15,0,0,0,0,3,0,18
181680803,2,4,0,0,0,0,0,6
181680804,15,1,0,0,0,1,0,17
181680901,7,0,0,0,0,2,0,9
181680902,2,0,0,0,0,0,0,2
181680903,8,3,0,1,0,1,1,14
181680904,5,0,0,0,0,1,3,9
181681001,2,3,0,0,0,0,0,5
181681002,57,4,3,3,3,4,5,79
181681003,27,5,0,0,0,1,0,33
181681101,5,4,0,0,0,2,1,12
181681102,5,5,0,1,0,3,3,17
181681103,78,22,3,0,1,0,2,106
181681201,88,2,0,0,0,4,12,106
181681202,5,3,0,0,0,1,21,30
181681203,14,0,0,0,0,0,1,15
181681204,4,0,0,0,0,0,4,8
181681301,10,2,0,0,0,0,0,12
181681302,39,9,0,1,0,2,0,51
181681303,142,23,0,5,5,0,17,192
181681304,9,0,0,0,0,2,0,11
181681305,70,10,0,4,1,5,16,106
181681306,156,21,0,1,0,1,7,186
181681307,449,22,1,2,1,0,4,479
181681401,201,15,1,3,2,0,6,228
181681402,58,15,0,0,0,3,13,89
181681403,22,13,0,0,0,0,0,35
181681404,58,2,0,0,0,0,1,61
181681501,53,7,0,0,0,0,2,62
181681502,6,0,0,0,0,0,0,6
181681601,176,16,1,3,2,11,7,216
181681602,109,3,0,1,0,0,0,113
181681603,16,4,0,0,0,0,6,26
181681604,8,1,0,0,0,0,0,9
181681701,332,12,8,2,0,1,16,371
181681702,267,34,1,4,15,0,10,331
181681703,303,52,12,2,15,2,7,393
181681704,219,28,3,4,4,0,6,264
181681705,210,14,1,2,2,1,6,236
181681706,255,46,5,1,17,1,7,332
181681707,300,33,5,6,1,0,15,360
181681708,368,26,6,1,4,1,10,416
181681709,275,29,1,8,5,1,10,329
181681710,332,15,2,7,0,10,5,371
181681711,173,6,0,10,0,0,6,195
181681712,274,12,0,1,0,0,3,290
181681713,269,21,1,0,1,0,0,292
181681714,254,20,0,0,0,0,2,276
181750101,211,22,0,1,2,3,18,257
181750102,190,19,0,3,0,4,13,229
181750103,224,23,1,4,0,3,13,268
181750104,285,29,1,8,1,0,8,332
181750105,324,27,0,6,1,3,27,388
181750106,288,25,3,7,1,3,14,341
181750107,340,27,4,6,2,2,19,400
181750108,73,6,0,0,0,0,0,79
181750201,12,1,0,0,0,0,0,13
181750202,18,0,0,0,0,0,1,19
181750203,13,0,0,0,0,0,6,19
181750204,30,0,0,0,0,0,0,30
181750301,10,1,0,0,0,0,4,15
181750302,26,2,0,0,0,3,8,39
181750303,24,4,0,0,0,2,1,31
181750401,26,4,0,0,0,0,3,33
181750402,40,1,0,0,0,0,11,52
181750403,56,6,0,0,0,0,5,67
181750501,98,20,0,0,0,2,8,128
181750502,6,3,0,0,0,0,0,9
181750503,18,1,0,0,0,0,0,19
181750601,53,3,0,0,0,2,11,69
181750602,40,5,0,0,0,0,9,54
181750603,8,2,0,0,0,1,2,13
181750604,9,1,0,0,0,0,2,12
181750605,21,2,0,0,0,0,7,30
181750701,3,0,0,0,0,0,1,4
181750702,8,0,0,0,0,0,0,8
181750801,9,4,0,0,0,0,9,22
181750802,7,1,0,0,0,0,1,9
220070101,331,52,7,6,4,3,10,413
220070102,403,89,8,11,11,2,8,532
220070103,265,50,0,6,2,0,18,341
220070104,202,24,0,3,1,0,4,234
220070201,24,49,3,18,1,4,8,107
220070202,37,26,0,0,0,0,3,66
220070203,48,6,0,0,0,9,0,63
220070204,94,6,0,0,0,0,1,101
220070205,32,4,0,0,0,0,0,36
220070206,74,2,0,0,0,1,0,77
220070207,80,0,0,0,0,0,3,83
220070208,256,53,4,8,1,0,22,344
220070209,122,42,0,1,0,2,5,172
220070301,32,0,0,0,0,0,0,32
220070302,68,1,0,0,0,0,0,69
220070303,29,0,0,0,0,0,0,29
220070304,98,11,0,0,0,0,8,117
220070401,42,2,0,3,0,0,3,50
220070402,29,6,0,0,0,0,0,35
220070403,28,1,1,0,0,0,1,31
220070404,20,21,0,0,0,0,0,41
220070501,100,10,0,2,0,0,0,112
220070502,188,4,0,2,0,0,44,238
220070503,159,9,5,7,0,2,6,188
220070504,58,6,0,0,0,1,7,72
220070505,58,7,3,4,0,0,5,77
220070506,261,64,0,8,4,1,15,353
220070507,180,18,4,7,12,0,18,239
220070508,340,23,0,6,0,0,21,390
220070509,322,28,3,10,2,3,22,390
220070601,53,16,0,1,0,1,41,112
220070602,76,7,0,1,0,0,24,108
220070603,86,11,4,0,1,0,1,103
220070604,52,6,0,1,0,2,0,61
220070701,276,63,3,28,0,0,18,388
220070702,325,94,8,5,5,1,34,472
220070703,133,10,1,0,0,0,7,151
220070704,213,25,4,2,3,0,7,254
220070705,371,39,2,11,4,2,12,441
220070706,260,45,2,16,0,2,24,349
220070707,219,14,0,0,0,0,4,237
220070708,367,30,5,13,2,1,29,447
220070801,89,14,0,0,0,1,4,108
220070802,51,4,0,0,0,0,6,61
220070803,55,33,0,1,0,0,0,89
220070804,35,5,3,0,0,1,9,53
220070805,15,2,0,0,0,0,1,18
220070806,32,4,0,2,0,2,4,44
220070807,227,35,0,6,1,3,31,303
220070901,271,35,0,1,1,3,10,321
220070902,225,30,0,2,0,1,18,276
220070903,84,2,1,0,0,0,2,89
220070904,190,13,2,1,2,0,7,215
220070905,310,42,0,11,1,1,26,391
220140101,6,0,0,0,0,0,0,6
220140102,72,0,0,0,0,4,1,77
220140103,163,10,0,0,0,0,2,175
220140201,5,0,0,0,0,0,0,5
220140202,18,8,0,0,0,0,0,26
220140203,24,6,0,0,1,1,2,34
220140301,9,4,0,3,0,4,4,24
220140302,4,0,0,0,0,0,4,8
220140303,8,0,0,0,1,2,8,19
220140304,4,0,0,0,1,0,4,9
220140305,38,0,0,0,0,0,0,38
220140306,24,4,0,0,0,1,8,37
220140307,264,24,1,1,2,1,25,318
220140308,253,39,1,2,2,0,12,309
220140401,298,25,1,5,1,11,16,357
220140402,171,19,0,0,0,1,7,198
220140403,56,4,0,0,0,0,14,74
220140404,66,3,0,1,0,6,4,80
220140405,265,23,1,1,1,1,7,299
220140406,93,0,0,3,0,9,9,114
220140407,69,7,0,0,0,1,0,77
220140408,254,20,1,8,0,3,5,291
220140409,166,29,0,1,0,0,8,204
220140410,281,26,0,1,1,0,4,313
220140411,188,8,1,1,0,0,8,206
220140412,317,9,1,2,0,1,21,351
220140501,275,13,4,8,3,4,13,320
220140502,362,30,1,3,0,0,19,415
220140503,288,11,0,3,0,0,15,317
220140504,301,17,4,4,1,2,19,348
220140505,158,16,0,4,0,0,12,190
220140601,307,14,2,3,2,5,28,361
220140602,216,18,1,1,0,5,4,245
220140603,235,24,1,3,0,3,9,275
220140604,377,13,4,1,2,2,21,420
220140605,163,5,1,1,1,0,7,178
220140701,31,0,0,0,0,0,9,40
220140702,105,0,0,0,0,4,8,117
220140703,51,20,0,2,0,4,13,90
220140704,251,29,0,3,0,2,13,298
220140705,215,26,1,3,1,14,8,268
220140801,67,0,0,1,0,7,8,83
220140802,52,5,0,0,0,5,2,64
220140803,77,1,0,0,1,2,7,88
220140804,21,4,0,0,0,0,3,28
220140805,91,2,0,0,0,0,5,98
220140901,16,6,1,0,0,2,2,27
220140902,24,2,0,0,0,0,0,26
220210101,33,1,0,0,0,2,6,42
220210102,43,3,1,0,0,2,8,57
220210201,45,15,3,0,0,0,6,69
220210202,34,1,0,0,0,0,2,37
220210301,18,0,0,0,0,0,9,27
220210302,52,0,0,0,0,0,2,54
220210303,33,2,0,0,0,0,1,36
220210401,62,4,0,0,0,0,2,68
220210402,10,0,0,0,0,0,9,19
220210403,152,4,0,7,0,5,0,168
220210501,47,0,0,0,0,0,1,48
220210502,113,4,0,2,1,0,10,130
220210503,166,8,0,0,0,3,0,177
220210504,202,13,1,0,0,0,7,223
220210505,225,13,1,1,0,2,2,244
220210506,253,10,5,29,2,1,6,306
220210507,309,24,0,1,0,0,4,338
220210508,343,17,0,0,0,0,10,370
220210601,150,0,0,1,0,0,13,164
220210602,47,0,0,1,0,0,1,49
220210603,89,0,0,0,0,1,4,94
220210604,122,0,0,0,0,0,6,128
220210605,243,3,0,121,0,0,8,375
220210606,137,0,0,0,0,0,2,139
220210607,259,3,7,10,3,3,15,300
220210608,270,15,3,7,0,1,6,302
220210701,274,8,0,69,2,1,7,361
220210702,152,10,0,0,0,0,4,166
220210703,139,14,0,0,1,0,0,154
220210704,440,53,5,16,1,0,6,521
220210705,216,32,8,13,3,3,17,292
220210706,170,7,2,1,0,0,6,186
220210707,175,12,4,0,0,0,0,191
220210708,325,56,4,11,5,0,2,403
220210709,308,19,4,5,0,0,5,341
220210710,100,17,6,8,1,2,8,142
220210711,210,44,2,5,0,0,7,268
220210712,152,21,1,6,2,0,6,188
220210713,329,21,15,11,6,1,10,393
220210714,228,38,9,10,4,0,9,298
220210715,159,16,2,0,0,0,7,184
220210716,173,28,14,0,3,0,5,223
220210717,148,26,6,4,1,1,1,187
220210718,216,23,1,1,0,0,4,245
220210719,383,18,2,0,1,0,12,416
220210720,178,20,2,17,0,0,8,225
220210721,237,10,1,3,0,0,4,255
220210722,111,6,0,0,0,0,2,119
220210723,164,15,0,1,0,0,4,184
220210801,358,24,4,28,6,2,8,430
220210802,261,7,0,8,0,1,13,290
220210803,291,13,3,3,1,0,9,320
220210804,267,19,6,10,3,1,7,313
220210805,131,9,0,2,0,0,14,156
220210806,269,19,3,1,0,0,14,306
220210807,224,20,12,0,3,0,16,275
220210808,310,18,6,4,0,0,11,349
220210809,240,19,3,1,8,0,3,274
220210810,197,8,2,0,1,2,7,217
220210811,228,11,0,4,1,0,5,249
220210812,205,9,0,3,0,1,8,226
220210813,237,8,0,1,0,0,7,253
220210814,279,9,2,6,1,2,4,303
220210815,200,6,0,9,1,6,6,228
220210816,199,6,1,2,0,1,0,209
220210901,19,0,0,0,0,1,5,25
220210902,33,5,0,0,0,0,0,38
220210903,46,0,1,0,0,0,25,72
220211001,38,0,0,0,0,0,0,38
220211002,47,2,0,0,0,0,2,51
220211003,34,1,0,0,0,0,0,35
220211101,48,0,0,0,1,0,18,67
220211102,18,0,0,0,0,0,22,40
220211103,38,0,0,0,0,0,19,57
220211201,39,0,0,0,0,0,14,53
220211202,64,6,0,1,0,0,3,74
220211301,30,7,1,0,0,0,1,39
220211302,45,14,0,0,0,0,6,65
220211401,32,1,0,0,0,0,10,43
220211402,34,5,0,0,0,0,17,56
220211501,205,21,7,4,7,0,4,248
220211502,178,21,8,2,12,0,20,241
220211503,162,32,8,2,7,3,6,220
220211504,282,22,5,8,2,2,4,325
220211505,266,29,5,4,2,1,4,311
220211506,711,39,8,39,3,3,38,841
220211507,212,16,4,3,4,0,6,245
220211508,393,11,7,3,0,0,9,423
220211509,267,13,3,3,0,0,10,296
220211510,287,20,1,0,0,0,15,323
220211511,348,24,4,2,0,1,5,384
220211512,246,6,4,12,0,0,28,296
220211513,129,10,6,0,16,1,11,173
220211601,245,2,2,6,0,0,5,260
220211602,266,13,12,3,2,1,4,301
220211603,158,3,7,8,3,4,9,192
220211604,192,16,2,5,1,0,3,219
220211605,308,9,2,4,2,0,1,326
220211606,170,5,2,2,0,0,3,182
220211607,207,100,17,2,11,0,1,338
220211608,256,43,11,2,0,0,12,324
220211609,188,4,1,0,1,0,5,199
220211610,274,15,1,2,3,1,11,307
220211611,287,16,0,4,1,1,4,313
220211612,180,12,2,3,1,1,8,207
220211613,256,14,10,0,0,0,7,287
220211614,246,11,0,8,0,0,23,288
220211615,239,8,0,11,0,0,4,262
220211616,202,41,12,0,0,0,5,260
220211617,182,8,1,7,0,2,5,205
220211618,322,12,1,20,1,1,4,361
220211701,138,24,23,3,2,0,13,203
220211702,154,20,5,4,15,0,2,200
220211703,229,28,0,2,0,0,9,268
220211704,138,22,22,2,10,3,12,209
220211705,166,20,15,5,5,2,20,233
220211706,273,17,6,1,0,0,8,305
220211707,259,11,10,2,2,1,2,287
220211708,172,11,6,14,1,1,9,214
220211709,335,13,3,1,3,0,30,385
220211710,302,2,6,5,7,0,9,331
220211711,195,87,70,58,0,0,3,413
220211712,274,17,3,36,1,1,2,334
220211713,253,14,2,2,0,0,1,272
220211714,327,14,4,6,4,2,13,370
220211715,176,17,2,1,0,0,9,205
220211716,222,9,19,6,2,1,10,269
220211717,176,1,1,4,1,1,27,211
220211718,240,20,1,1,1,0,2,265
220280101,265,0,0,0,0,0,12,277
220280102,429,39,3,5,1,0,6,483
220280103,251,30,6,4,4,0,1,296
220280104,291,15,2,8,3,2,5,326
220280105,375,41,3,4,1,4,4,432
220280106,286,9,6,5,0,2,13,321
220280107,261,33,5,1,4,0,4,308
220280108,218,35,1,1,0,3,9,267
220280109,276,24,2,2,1,0,2,307
220280110,280,14,2,0,0,0,1,297
220280111,179,23,2,1,2,0,9,216
220280112,248,27,6,4,1,3,10,299
220280113,305,14,5,1,2,0,2,329
220280114,326,27,12,5,2,0,9,381
220280115,314,17,6,0,0,0,8,345
220280116,318,12,0,0,1,0,7,338
220280117,358,16,9,15,3,4,11,416
220280118,290,18,1,1,1,0,1,312
220280201,162,4,0,0,0,0,1,167
220280202,62,1,0,0,0,0,0,63
220280203,167,13,1,0,0,0,3,184
220280301,99,13,6,15,7,4,7,151
220280302,141,2,0,0,0,0,4,147
220280303,44,6,0,0,0,0,4,54
220280304,54,5,0,0,0,1,0,60
220280305,67,6,0,0,0,0,3,76
220280306,203,19,0,0,0,0,6,228
220280307,277,23,0,1,0,2,4,307
220280308,226,10,0,0,0,0,8,244
220280309,336,32,11,36,0,2,8,425
220280310,310,36,2,9,0,6,12,375
220280311,313,17,3,7,4,0,10,354
220280401,41,0,0,0,0,0,0,41
220280402,28,0,0,0,0,0,0,28
220280403,41,8,0,0,0,0,0,49
220280501,105,7,0,0,0,3,9,124
220280502,18,1,0,0,0,0,0,19
220280503,39,0,0,0,0,0,4,43
220360101,259,34,0,1,0,0,23,317
220360102,290,28,0,0,0,2,13,333
220360103,113,9,2,1,0,0,1,126
220360104,178,17,5,5,0,1,6,212
220360105,313,37,1,14,1,0,8,374
220360106,374,17,3,9,20,2,16,441
220360107,230,38,4,3,29,1,13,318
220360108,250,25,1,2,0,0,1,279
220360109,173,9,0,5,0,0,25,212
220360110,285,33,0,7,1,0,7,333
220360111,215,14,0,2,0,1,4,236
220360112,281,13,8,1,1,1,17,322
220360113,280,22,1,2,2,0,3,310
220360114,222,22,3,1,0,0,5,253
220360201,57,1,0,0,0,1,2,61
220360202,77,5,0,2,0,0,1,85
220360203,69,4,0,0,0,0,0,73
220360204,26,5,0,0,0,0,0,31
220360301,2,0,0,0,0,0,0,2
220360302,154,5,0,1,0,0,7,167
220360303,30,1,0,0,0,0,0,31
220360304,143,0,0,0,0,0,0,143
220360305,63,4,0,0,0,0,2,69
220360401,21,2,0,0,0,0,16,39
220360402,16,6,0,0,0,0,1,23
220360403,78,0,0,0,0,1,21,100
220360404,17,0,0,0,0,0,12,29
220360405,113,13,0,0,4,0,14,144
220360406,23,1,0,0,0,0,10,34
220360501,15,6,0,0,0,2,2,25
220360502,33,0,0,0,0,0,0,33
220360601,30,5,0,0,0,0,2,37
220360602,25,1,0,0,0,0,0,26
220360603,107,12,0,5,0,1,0,125
220360604,34,3,0,1,0,3,2,43
220360701,29,0,0,0,0,0,0,29
220360702,25,0,0,0,0,1,2,28
220360801,16,0,0,0,0,0,0,16
220360802,4,1,0,0,0,0,0,5
220360803,6,5,0,0,0,0,2,13
220360804,7,1,0,0,0,0,0,8
220360805,2,4,0,0,0,0,0,6
220360901,380,59,8,5,34,2,14,502
220360902,143,12,0,0,0,0,1,156
220360903,4,0,0,0,0,0,0,4
220360904,25,4,0,0,0,0,2,31
220360905,23,3,0,2,0,0,1,29
220360906,186,37,3,4,2,0,8,240
220360907,323,6,1,0,1,0,29,360
220390101,107,11,0,28,1,0,13,160
220390102,50,3,3,2,0,9,12,79
220390103,14,3,0,1,0,2,1,21
220390104,14,4,0,0,0,0,0,18
220390105,137,23,0,4,0,0,12,176
220390106,270,24,0,3,1,1,12,311
220390107,222,17,1,0,0,0,8,248
220390108,133,27,1,5,0,1,2,169
220390109,289,18,2,3,1,3,16,332
220390110,215,20,4,0,2,0,4,245
220390111,214,16,0,4,0,0,13,247
220390201,31,6,0,0,0,0,0,37
220390202,34,0,0,0,0,0,13,47
220390203,32,0,1,0,0,0,5,38
220390204,50,5,0,0,0,1,1,57
220390301,26,3,0,0,0,0,0,29
220390302,9,0,0,0,0,0,0,9
220390303,43,7,0,0,0,0,7,57
220390304,34,7,0,0,0,0,1,42
220390305,94,1,0,0,0,3,0,98
220430101,251,20,0,5,0,0,2,278
220430102,204,11,3,3,0,1,2,224
220430103,298,27,2,69,1,0,2,399
220430104,222,17,2,1,0,4,9,255
220430105,236,21,0,1,0,2,6,266
220430106,257,18,3,4,0,0,2,284
220430201,139,0,2,8,0,0,6,155
220430202,81,2,0,0,0,3,20,106
220430203,98,11,0,0,0,0,11,120
220430204,45,0,1,0,0,0,26,72
220430205,348,25,0,21,0,0,0,394
220430301,12,4,0,2,0,0,1,19
220430302,144,1,0,0,0,0,0,145
220430303,114,0,0,0,1,1,2,118
220430304,170,1,0,0,0,0,6,177
220430305,221,15,3,1,1,2,29,272
220430401,18,7,0,0,0,0,1,26
220430402,77,4,0,0,0,0,1,82
220430403,35,2,0,0,0,0,1,38
220430501,31,0,0,0,0,0,0,31
220430502,58,7,0,0,0,0,3,68
220430503,18,1,0,0,0,1,5,25
220490101,237,24,4,1,2,0,12,280
220490102,261,14,3,3,0,2,7,290
220490103,297,18,2,0,0,2,22,341
220490104,252,38,5,2,7,0,14,318
220490201,22,0,0,0,0,0,0,22
220490202,24,6,0,0,0,0,2,32
220490203,4,13,0,0,0,1,1,19
220490301,40,4,0,0,0,0,0,44
220490302,44,2,1,0,0,1,3,51
220490303,43,3,0,0,0,0,7,53
220490304,438,33,1,27,0,2,31,532
220490305,18,2,0,2,0,1,8,31
220490306,25,10,0,2,1,0,1,39
220490307,166,18,0,2,0,1,7,194
220490308,126,18,0,6,2,1,7,160
220490309,268,15,1,7,2,0,25,318
220490310,172,18,0,2,0,2,14,208
220490311,401,43,1,5,1,9,23,483
220490401,29,8,0,0,0,1,10,48
220490402,16,2,0,0,0,0,6,24
220490403,48,4,0,0,0,0,15,67
220560101,387,16,6,13,2,3,12,439
220560102,434,27,1,5,2,0,15,484
220560201,323,29,0,35,2,0,11,400
220560202,26,10,0,0,0,1,1,38
220560203,37,2,0,0,0,2,14,55
220560204,2,0,0,0,0,0,1,3
220560301,48,1,0,0,1,4,5,59
220560302,49,6,0,0,0,0,0,55
220560303,88,3,0,0,0,0,12,103
220560304,52,1,0,1,0,0,5,59
220560305,234,1,0,1,1,0,14,251
220560306,246,17,0,1,0,4,4,272
220560307,19,0,0,1,0,0,0,20
220560308,10,2,0,0,0,2,0,14
220560309,225,24,0,2,0,1,0,252
220560310,282,22,0,0,0,0,3,307
220560311,311,10,0,1,0,0,4,326
220560312,90,7,0,2,0,0,4,103
220560313,376,30,1,1,3,2,6,419
220560314,306,9,0,2,0,0,7,324
220560401,14,0,0,0,0,3,0,17
220560402,17,0,0,0,0,6,0,23
220630101,246,22,2,8,4,0,12,294
220630102,290,13,12,13,0,3,22,353
220630103,186,8,10,4,2,5,17,232
220630104,238,21,0,1,0,0,0,260
220630105,223,31,1,1,3,0,12,271
220630106,223,15,9,5,2,2,17,273
220630107,276,30,10,4,1,1,12,334
220630108,279,26,2,0,0,1,18,326
220630109,207,18,0,1,0,0,13,239
220630202,348,23,0,10,0,4,7,392
220630203,279,4,0,0,0,0,3,286
220630204,125,6,0,0,0,0,0,131
220630205,19,2,0,0,0,0,1,22
220630206,84,2,0,0,0,0,2,88
220630207,56,1,0,0,0,1,4,62
220630208,226,0,0,1,0,1,19,247
220630209,83,3,0,0,0,0,3,89
220630210,265,34,3,3,2,45,45,397
220630211,64,1,0,0,0,0,0,65
220630212,187,8,0,0,0,0,2,197
220630213,71,0,0,0,0,0,2,73
220630214,355,63,0,7,2,14,23,464
220630215,256,43,2,35,2,32,19,389
220630216,75,36,1,9,1,110,46,278
220630301,204,2,0,0,0,3,3,212
220630302,191,35,3,1,0,4,7,241
220630303,91,2,0,0,0,0,1,94
220630304,201,0,0,0,0,0,1,202
220630305,186,4,0,0,0,0,1,191
220630306,275,1,0,0,0,0,0,276
220630307,152,1,0,0,0,0,2,155
220630308,110,10,0,0,0,0,4,124
220630309,400,18,8,36,0,13,26,501
220630310,430,73,1,19,2,1,47,573
220630311,357,29,8,7,4,2,19,426
220630401,179,20,0,12,2,0,8,221
220630402,46,0,0,0,0,0,0,46
220630403,80,15,0,0,0,0,0,95
220630404,330,122,0,6,3,4,40,505
220630501,69,0,0,0,0,0,0,69
220630502,20,2,0,0,0,0,0,22
220630503,90,4,0,0,0,0,1,95
220630504,101,6,0,0,0,0,0,107
220630505,184,8,0,0,0,0,2,194
220630506,167,24,3,2,0,0,5,201
220630507,147,1,1,1,0,0,3,153
220630508,381,51,4,11,2,6,27,482
220630509,327,15,0,1,0,0,12,355
220630601,16,3,0,0,0,0,0,19
220630602,253,22,0,0,0,0,1,276
220630603,218,3,0,0,0,0,10,231
220630604,3,0,0,0,0,0,0,3
220630605,317,16,0,2,0,2,17,354
220630701,144,20,2,7,0,0,20,193
220630702,306,5,0,0,0,0,8,319
220630703,131,10,0,0,0,5,3,149
220630704,11,2,0,0,0,0,2,15
220630705,429,72,3,5,3,2,44,558
220630801,370,35,1,2,1,1,5,415
220630814,218,12,5,0,1,1,7,244
220630816,317,35,3,10,1,3,16,385
220630817,330,30,1,3,0,0,12,376
220630818,141,10,3,9,1,2,8,174
220630824,207,21,1,4,1,1,11,246
220630825,168,13,2,3,1,0,10,197
220630826,121,19,1,5,4,2,4,156
220630827,146,12,1,3,0,6,4,172
220630915,332,28,1,2,1,2,30,396
220630919,342,21,0,3,0,0,28,394
220630920,328,27,2,9,0,2,17,385
220630921,366,43,2,28,0,0,21,460
220630922,162,19,0,0,0,0,1,182
220630923,253,34,1,1,0,1,17,307
220630928,176,7,1,1,0,2,3,190
220630929,189,10,3,12,0,0,12,226
220630930,195,15,3,4,0,1,12,230
220630931,278,26,0,1,0,0,1,306
220630932,219,16,0,3,0,0,18,256
220700101,286,24,1,7,4,3,10,335
220700102,255,25,1,7,2,3,6,299
220700103,353,33,0,1,0,1,12,400
220700104,346,27,3,5,3,0,10,394
220700105,246,14,2,1,0,3,8,274
220700201,48,0,0,2,1,0,11,62
220700202,343,54,4,4,1,3,10,419
220700203,26,0,0,0,0,0,4,30
220700204,25,6,0,0,0,0,0,31
220700205,141,13,0,0,1,1,26,182
220700206,378,37,0,0,4,1,8,428
220700301,290,12,1,7,0,1,24,335
220700302,60,5,1,71,5,2,1,145
220700303,46,3,0,0,0,0,0,49
220700304,54,6,0,0,0,0,0,60
220700305,47,0,0,0,0,0,0,47
220700306,65,10,0,0,1,0,1,77
220700307,328,35,1,4,1,2,6,377
220700308,245,5,3,4,2,1,34,294
220700309,208,20,1,5,1,0,4,239
220700310,126,12,4,2,0,0,6,150
220700311,191,28,3,2,2,0,4,230
220700401,218,38,6,6,1,1,18,288
220700402,61,1,0,0,0,1,22,85
220700403,73,11,0,1,0,0,0,85
220700404,32,1,0,0,0,0,12,45
220700405,67,4,0,0,0,0,7,78
220700406,349,53,9,3,1,0,40,455
220700501,67,8,0,2,0,0,6,83
220700502,30,0,0,0,0,2,11,43
220700503,14,3,0,0,0,0,0,17
220700504,9,4,0,0,0,0,0,13
220700601,61,8,0,0,0,0,7,76
220700602,40,0,0,0,0,0,2,42
220700603,73,2,0,0,0,1,11,87
220770101,266,13,1,3,2,1,4,290
220770102,158,4,0,0,0,0,4,166
220770103,394,19,0,1,1,0,14,429
220770104,250,10,1,4,0,6,14,285
220770105,239,8,3,2,2,0,7,261
220770106,208,4,1,0,0,7,9,229
220770107,281,8,0,18,0,0,2,309
220770201,74,0,1,11,1,17,1,105
220770202,208,13,1,4,0,22,9,257
220770203,42,5,0,1,0,1,2,51
220770204,23,9,0,0,0,0,0,32
220770205,32,1,0,2,0,0,7,42
220770206,112,6,0,2,0,0,2,122
220770207,36,1,0,0,0,4,7,48
220770208,75,5,1,17,0,4,14,116
220770301,69,7,0,0,1,2,1,80
220770302,240,24,0,1,0,1,4,270
220770303,164,7,1,1,0,0,12,185
220770304,117,5,1,0,0,0,22,145
220770305,32,13,0,0,0,4,3,52
220770306,11,0,0,0,0,2,1,14
220770307,25,1,0,0,0,0,10,36
220770308,10,4,0,0,0,0,2,16
220770401,6,0,0,0,0,2,1,9
220770402,15,0,0,1,0,0,6,22
220770403,14,3,0,0,0,4,0,21
220840101,483,14,0,4,0,2,5,508
220840102,240,0,0,0,0,0,4,244
220840103,274,4,0,0,0,0,2,280
220840104,271,15,2,1,0,0,1,290
220840105,396,1,0,2,0,0,4,403
220840201,19,0,0,0,0,0,1,20
220840202,109,9,0,0,0,1,3,122
220840203,251,15,0,1,0,2,4,273
220840204,159,12,0,1,0,0,4,176
220840205,574,16,0,0,0,0,9,599
220840206,123,0,1,2,1,0,3,130
220840207,85,1,0,1,0,0,8,95
220840208,224,11,2,0,0,1,4,242
220840209,380,29,1,15,0,4,11,440
220840301,18,0,1,0,1,3,0,23
220840302,26,1,0,0,0,0,5,32
220840303,32,3,0,0,0,1,0,36
220840401,107,24,0,0,0,0,6,137
220840402,92,34,0,1,0,0,1,128
220840403,47,5,0,0,0,2,8,62
220840404,39,6,0,0,0,0,7,52
220840501,263,19,0,3,0,1,10,296
220840502,271,20,0,10,4,2,10,317
220840503,271,30,1,8,1,0,11,322
220840504,272,9,0,3,0,1,10,295
220840601,296,17,0,3,3,2,20,341
220840602,29,1,0,0,0,0,0,30
220840603,51,5,0,0,0,4,8,68
220840604,119,19,0,1,0,0,1,140
220840605,204,14,0,0,1,0,3,222
220840606,18,1,0,0,0,1,6,26
220840607,7,5,0,0,0,0,3,15
220840701,141,14,0,0,0,6,17,178
220840702,13,2,0,0,0,0,0,15
220840703,22,18,0,0,0,6,1,47
220840704,18,2,0,0,1,0,1,22
220840705,27,7,0,3,0,0,1,38
220840706,37,3,0,0,0,1,1,42
220840707,64,12,0,0,0,4,5,85
220840801,138,33,0,1,0,3,20,195
220840802,72,14,1,0,1,2,28,118
220840803,109,8,1,3,0,2,23,146
220840804,211,10,0,0,1,2,19,243
220840805,136,16,0,0,0,2,6,160
220840901,15,1,1,0,0,0,5,22
220840902,13,0,0,0,0,0,18,31
220840903,79,12,0,3,0,3,13,110
220840904,39,0,0,0,0,6,17,62
220841001,87,3,0,0,0,0,6,96
220841002,276,16,0,3,2,0,8,305
220841003,13,0,0,0,0,0,12,25
220841004,141,10,0,0,0,2,15,168
220841005,288,28,1,7,0,4,2,330
220841006,134,11,0,14,0,8,28,195
220841101,363,21,0,6,0,0,4,394
220841102,174,4,8,2,55,1,16,260
220841103,129,7,0,5,0,1,7,149
220841104,190,10,1,0,0,0,7,208
220841105,256,20,1,2,2,3,7,291
220841106,258,12,0,3,0,0,2,275
220841107,230,37,6,4,4,1,4,286
220841108,243,13,4,0,0,1,4,265
220841109,153,10,0,5,0,0,7,175
220841110,385,32,1,1,0,1,11,431
220841111,234,5,0,0,1,0,3,243
220841112,238,14,0,2,0,0,5,259
220841201,414,42,1,4,0,2,19,482
220841202,310,17,1,10,1,8,11,358
220841203,205,14,0,1,0,1,5,226
220841204,257,2,0,0,0,0,2,261
220841205,233,12,16,3,6,0,9,279
220841206,189,21,5,7,29,0,7,258
220841207,294,29,3,3,2,0,12,343
220841208,191,10,0,0,1,1,3,206
220841209,206,11,0,0,0,0,3,220
220841210,255,5,0,0,0,0,6,266
220841211,354,28,0,12,2,0,9,405
220841212,213,8,0,0,0,0,4,225
220841213,257,4,2,0,1,0,5,269
220841214,249,30,0,0,0,0,4,283
220841215,262,33,0,1,0,0,9,305
220841216,382,23,2,1,0,1,9,418
220841217,182,17,0,7,0,0,2,208
220910101,329,32,2,6,2,0,22,393
220910102,243,16,0,2,3,2,9,275
220910103,368,28,2,2,0,0,3,403
220910104,261,22,6,3,2,0,12,306
220910105,216,7,4,2,1,3,1,234
220910201,47,3,0,0,0,0,6,56
220910202,78,0,0,0,0,0,0,78
220910203,73,1,0,0,0,1,3,78
220910204,89,5,0,0,0,0,5,99
220910301,114,16,0,0,0,1,1,132
220910302,131,1,0,0,0,1,7,140
220910303,177,16,0,0,0,0,2,195
220910304,60,4,0,0,0,3,5,72
220910401,96,9,0,0,0,0,6,111
220910402,126,5,0,2,1,0,5,139
220910403,130,8,0,0,0,0,0,138
220910404,61,1,0,1,0,2,0,65
220910501,416,27,1,8,0,3,6,461
220910502,249,3,1,0,0,2,26,281
220910503,104,14,0,0,0,0,5,123
220910504,108,1,0,0,0,0,2,111
220910505,58,2,0,0,0,1,6,67
220910506,100,16,0,1,0,0,7,124
220910507,247,37,0,0,1,0,10,295
220910508,425,23,1,4,0,2,16,471
220910509,323,36,2,1,3,1,11,377
220910510,261,7,0,0,0,0,10,278
220910511,214,24,2,0,0,0,6,246
220910512,266,16,4,4,0,2,4,296
220910513,272,34,4,7,0,1,8,326
220910601,44,1,0,0,0,0,3,48
220910602,119,3,0,0,0,0,1,123
220910701,44,6,0,0,0,1,10,61
220910702,44,1,0,0,0,0,2,47
220910703,109,0,0,0,0,0,0,109
220910704,101,6,0,0,0,3,4,114
220980101,263,24,2,2,0,0,0,291
220980102,161,22,1,1,0,0,3,188
220980103,480,68,4,12,0,1,12,577
220980104,262,8,1,0,4,0,7,282
220980105,285,20,1,0,0,1,11,318
220980106,267,22,4,1,1,0,10,305
220980107,280,14,0,0,0,0,3,297
220980108,232,39,5,4,0,0,7,287
220980109,240,15,5,1,0,0,10,271
220980110,278,21,4,2,0,0,3,308
220980111,357,26,6,9,3,1,21,423
220980112,158,3,0,0,0,0,20,181
220980113,113,19,6,1,0,1,6,146
220980114,132,17,1,0,5,0,5,160
220980115,156,11,10,2,3,0,5,187
220980116,158,20,7,4,1,0,3,193
220980117,201,32,4,2,0,0,1,240
220980118,180,18,3,2,6,2,3,214
220980119,289,9,1,2,0,4,6,311
220980120,267,18,0,1,0,0,4,290
220980121,305,26,1,9,0,1,4,346
220980122,238,14,0,2,0,0,4,258
220980123,261,26,1,0,0,1,1,290
220980201,46,5,0,1,0,1,2,55
220980202,70,10,0,0,1,7,7,95
220980203,10,0,0,0,0,0,5,15
220980204,25,0,0,0,0,0,9,34
220980205,44,3,0,0,0,1,7,55
220980206,44,20,0,0,0,0,0,64
220980207,77,2,0,2,0,1,12,94
220980208,44,2,0,0,0,0,0,46
220980209,69,6,0,0,0,0,5,80
220980210,24,8,0,0,0,0,5,37
220980211,80,24,0,0,0,0,11,115
220980212,43,11,0,1,0,0,2,57
220980213,30,16,0,0,0,2,4,52
220980214,198,14,0,10,0,0,4,226
220980301,159,8,2,0,0,0,4,173
220980302,261,15,1,0,0,0,4,281
220980303,272,20,0,1,0,0,10,303
220980304,199,14,4,1,1,0,5,224
220980305,257,14,7,6,0,1,4,289
220980306,209,18,1,2,0,3,6,239
220980307,209,16,1,4,0,0,4,234
220980401,174,12,0,0,0,0,3,189
220980402,36,1,0,0,0,2,9,48
220980403,35,5,0,0,0,5,5,50
220980404,25,10,0,0,0,0,0,35
220980405,28,3,0,0,0,2,5,38
220980406,227,22,0,0,0,0,10,259
220980407,111,12,0,0,0,0,4,127
220980408,296,16,3,10,0,0,7,332
220980501,75,2,0,1,0,1,23,102
220980502,42,7,0,0,0,0,0,49
220980503,38,8,0,0,0,0,0,46
220980601,112,10,0,0,1,2,1,126
220980602,26,9,0,2,0,0,2,39
220980603,66,20,0,0,0,1,2,89
220980604,11,2,0,0,0,0,0,13
220980605,40,2,0,0,0,1,7,50
220980701,419,56,1,2,0,3,3,484
220980702,377,10,3,0,0,0,19,409
220980703,181,3,2,1,0,1,3,191
220980704,195,18,3,5,2,0,10,233
220980705,160,33,11,12,20,4,15,255
220980706,275,20,7,10,0,0,9,321
220980707,438,39,6,4,0,0,15,502
220980708,394,20,1,2,0,3,9,429
220980709,344,29,4,6,0,0,7,390
220980710,260,17,3,3,7,0,6,296
220980711,79,10,0,3,3,0,2,97
220980712,160,4,1,1,0,1,4,171
220980713,148,5,0,1,0,0,2,156
220980714,209,15,0,1,0,0,12,237
220980715,363,18,2,2,0,2,9,396
220980716,27,11,0,0,0,0,0,38
220980717,298,19,1,5,0,0,3,326
220980718,427,40,1,8,1,1,16,494
220980719,98,5,1,1,0,0,7,112
220980720,261,22,3,2,2,0,8,298
221050101,176,7,0,1,2,1,4,191
221050102,192,8,5,0,1,0,8,214
221050103,183,22,4,0,1,1,12,223
221050104,162,12,12,4,1,0,11,202
221050105,162,15,3,5,1,1,11,198
221050106,255,13,2,3,1,1,6,281
221050107,317,20,5,5,1,0,14,362
221050108,348,20,7,3,9,1,10,398
221050109,302,24,3,3,0,1,1,334
221050110,197,9,4,4,2,0,8,224
221050111,205,24,5,2,0,0,10,246
221050112,241,17,1,0,0,1,4,264
221050113,170,16,1,6,0,0,4,197
221050114,224,10,0,3,2,0,5,244
221050115,159,12,1,2,0,0,4,178
221050201,101,10,4,3,0,3,4,125
221050202,74,1,0,0,0,0,2,77
221050203,150,2,0,0,0,0,0,152
221050204,45,8,0,0,0,0,0,53
221050205,113,8,0,0,0,0,1,122
221050301,514,66,2,3,4,2,11,602
221050302,22,2,0,0,0,1,2,27
221050303,326,32,3,2,0,0,11,374
221050304,104,10,1,1,0,0,13,129
221050305,68,20,0,0,0,1,2,91
221050306,132,5,0,0,0,0,9,146
221050307,67,1,0,0,0,0,3,71
221050308,36,8,0,1,0,0,1,46
221050309,63,4,1,1,0,1,1,71
221050310,94,18,0,0,0,0,1,113
221050311,409,31,6,14,1,1,16,478
221050312,393,42,3,6,4,0,21,469
221050313,16,3,0,0,0,0,1,20
221050314,305,32,3,5,0,4,8,357
221050315,250,23,3,0,0,0,9,285
221050316,317,39,3,10,1,0,4,374
221050317,267,22,5,1,1,0,27,323
221050401,18,7,0,0,0,0,0,25
221050402,26,0,0,0,0,1,15,42
221050403,69,4,0,0,0,0,0,73
221050404,96,1,0,1,0,0,6,104
221050405,48,4,0,0,0,1,7,60
221120101,342,26,1,3,1,2,8,383
221120102,266,19,2,4,8,1,14,314
221120103,405,38,2,12,1,0,9,467
221120104,358,27,1,2,0,6,15,409
221120105,403,38,2,0,0,0,14,457
221120106,473,39,4,10,1,1,30,558
221120201,0,0,0,0,0,0,1,1
221120202,48,7,0,0,0,0,4,59
221120203,19,5,0,0,0,0,0,24
221120301,228,28,1,3,1,0,12,273
221120302,425,55,2,7,0,1,7,497
221120303,34,7,0,0,0,0,9,50
221120304,24,7,0,1,0,0,1,33
221120305,30,10,0,0,0,0,3,43
221120306,183,21,1,1,0,3,11,220
221120401,195,21,2,2,1,0,1,222
221120402,170,16,1,0,0,0,4,191
221120403,106,3,0,0,0,0,0,109
221120404,139,10,0,0,0,0,11,160
221120405,31,1,0,0,0,0,3,35
221120406,40,0,0,0,0,0,12,52
221120407,301,23,0,1,2,0,2,329
221120408,49,17,0,0,0,0,33,99
221120501,18,8,0,0,0,1,10,37
221120502,26,27,0,0,0,0,9,62
221120503,18,2,0,0,0,0,8,28
221120504,31,15,0,0,0,0,0,46
221120505,31,1,0,0,0,0,0,32
221120601,15,1,0,0,0,1,16,33
221120602,31,17,0,0,0,0,24,72
221120603,38,1,0,0,0,0,13,52
221120701,41,4,0,0,0,0,19,64
221120702,33,13,0,0,0,0,0,46
221120801,53,2,0,0,0,2,2,59
221120802,67,13,0,0,0,0,16,96
221120803,76,16,0,1,1,0,4,98
221120901,35,1,0,0,0,1,1,38
221120902,26,0,0,0,0,0,10,36
221120903,39,13,1,0,0,0,7,60
221121001,84,28,1,0,0,0,8,121
221121002,55,25,0,0,0,0,3,83
221121003,16,3,0,0,0,5,3,27
221190101,223,22,0,2,2,1,5,255
221190102,305,44,1,2,0,1,2,355
221190103,314,9,3,8,2,2,12,350
221190104,380,24,0,4,2,2,13,425
221190105,218,12,2,0,2,2,4,240
221190106,340,9,1,7,2,2,8,369
221190107,285,13,2,2,0,2,12,316
221190108,271,19,0,3,0,1,1,295
221190201,117,9,2,1,3,0,10,142
221190202,176,5,0,2,0,0,8,191
221190203,104,0,0,0,0,0,18,122
221190204,87,12,0,0,0,0,1,100
221190205,158,11,0,0,0,2,4,175
221190206,57,0,0,0,0,1,2,60
221190207,22,7,0,0,0,0,0,29
221190208,41,0,0,0,0,0,0,41
221190301,47,6,0,0,0,0,2,55
221190302,13,3,0,0,0,1,1,18
221190303,26,7,0,0,0,3,0,36
221260101,279,9,2,4,0,4,4,302
221260102,199,8,0,3,0,1,10,221
221260103,157,10,2,1,0,6,5,181
221260104,214,15,1,0,0,5,7,242
221260105,175,16,2,2,2,2,0,199
221260201,23,8,0,0,0,8,0,39
221260202,107,4,1,0,0,22,16,150
221260203,45,7,0,0,0,8,7,67
221260204,43,8,0,0,1,1,3,56
221260301,243,10,2,3,0,12,3,273
221260302,48,1,0,1,0,7,5,62
221260303,93,2,0,2,0,31,30,158
221260304,167,17,4,17,2,28,17,252
221260305,225,33,1,25,1,3,6,294
221260306,25,1,0,2,1,7,11,47
221260307,16,0,0,0,0,0,12,28
221260308,19,10,0,0,0,1,0,30
221260309,11,2,0,0,0,0,2,15
221260310,17,4,0,0,0,2,0,23
221260311,56,0,1,5,0,18,2,82
221260312,202,7,0,1,0,0,1,211
221260313,176,19,1,4,0,7,14,221
221260314,297,35,2,0,4,3,11,352
221260315,12,1,0,0,0,4,2,19
221330101,197,1,6,3,6,2,2,217
221330102,276,23,4,2,0,2,14,321
221330103,312,17,0,0,1,0,6,336
221330104,317,12,3,2,0,1,7,342
221330105,164,4,0,0,0,0,1,169
221330106,328,14,4,3,1,1,14,365
221330107,166,16,3,0,7,3,1,196
221330108,444,20,1,1,0,1,9,476
221330109,357,14,0,4,0,0,9,384
221330110,176,10,0,0,0,2,0,188
221330111,257,12,0,3,0,1,0,273
221330112,199,11,1,1,0,0,4,216
221330113,177,12,1,2,7,1,9,209
221330114,365,9,2,4,0,2,5,387
221330115,342,28,1,4,0,0,9,384
221330116,165,11,1,0,0,0,5,182
221330117,144,7,0,2,3,0,4,160
221330118,226,14,1,2,0,0,5,248
221330119,266,14,2,1,0,1,7,291
221330120,235,20,0,0,1,2,11,269
221330201,50,0,0,0,0,0,0,50
221330202,100,6,1,1,0,0,12,120
221330203,112,2,0,0,0,0,0,114
221330204,23,2,0,0,0,0,0,25
221330205,82,2,0,0,0,0,0,84
221330206,81,0,0,0,0,1,4,86
221330207,217,10,1,9,0,2,14,253
221330208,51,5,1,0,0,0,26,83
221330301,84,2,0,0,0,0,2,88
221330302,109,13,0,0,0,0,3,125
221330303,65,2,0,0,0,0,1,68
221330304,59,1,0,0,0,0,11,71
221330305,68,10,0,1,0,1,14,94
221330306,43,1,0,0,0,4,8,56
221330307,42,1,0,0,1,0,1,45
221330308,62,4,0,0,0,0,0,66
221330309,96,7,0,1,0,1,10,115
221330401,94,9,0,0,1,2,15,121
221330402,65,3,1,0,0,1,3,73
221330403,43,4,0,0,0,0,0,47
221330404,58,0,0,0,0,0,24,82
221330405,77,0,0,0,0,0,4,81
221330406,38,7,0,0,0,0,1,46
221330407,4,0,0,0,0,2,1,7
221330408,57,4,0,0,0,0,4,65
221330409,5,0,1,2,0,0,1,9
221330410,6,0,0,0,0,0,0,6
221330411,113,1,0,7,4,1,2,128
221330412,331,9,1,0,0,0,3,344
221330413,306,13,1,2,0,1,14,337
221330414,207,16,0,0,0,0,2,225
221330415,128,2,1,2,0,0,4,137
221330501,48,3,0,0,0,8,2,61
221330502,44,5,0,0,0,0,6,55
221330503,57,0,0,0,0,0,0,57
221330504,32,4,0,0,0,0,0,36
221330505,52,2,0,0,0,0,10,64
221330506,15,4,0,0,0,0,0,19
221330507,18,2,0,0,0,1,0,21
221330508,21,1,0,0,0,2,6,30
221400101,93,8,0,1,1,0,7,110
221400102,380,4,0,3,0,0,9,396
221400103,159,3,5,1,1,0,10,179
221400104,297,4,2,6,5,1,17,332
221400105,212,5,5,1,0,0,13,236
221400106,263,8,0,3,0,0,0,274
221400107,308,13,2,2,0,2,9,336
221400108,119,2,2,2,0,7,1,133
221400109,284,4,2,2,0,1,9,302
221400110,188,12,1,0,0,0,5,206
221400111,358,9,6,2,0,0,6,381
221400112,240,8,5,4,0,2,5,264
221400113,228,6,0,1,0,0,2,237
221400114,99,14,1,4,0,1,5,124
221400115,218,9,0,3,1,0,3,234
221400116,197,5,1,1,0,0,2,206
221400117,230,4,3,0,0,0,1,238
221400118,187,18,2,2,1,1,5,216
221400201,225,15,2,5,12,1,15,275
221400202,253,28,15,1,3,2,2,304
221400203,272,19,1,4,2,0,16,314
221400204,314,14,1,12,2,0,7,350
221400205,219,15,5,5,4,0,8,256
221400206,354,22,10,6,9,1,13,415
221400207,342,3,0,2,1,0,12,360
221400208,273,19,0,2,8,0,7,309
221400209,183,15,0,0,0,0,7,205
221400210,315,12,4,12,0,0,5,348
221400211,264,9,0,0,0,0,17,290
221400301,200,29,7,3,28,0,13,280
221400302,189,26,10,2,30,1,11,269
221400303,257,36,6,9,33,0,6,347
221400304,251,60,12,2,43,12,17,397
221400305,269,25,7,4,27,0,19,351
221400306,207,18,9,2,10,0,12,258
221400307,194,15,7,4,9,2,18,249
221400308,230,26,1,1,2,2,15,277
221400309,231,13,1,2,1,0,6,254
221400310,193,12,5,5,2,0,2,219
221400311,222,22,14,1,2,1,2,264
221400312,324,8,9,0,3,0,13,357
221400313,346,10,2,3,0,0,8,369
221400401,126,24,10,4,50,0,23,237
221400402,172,18,4,0,19,0,23,236
221400403,220,59,12,3,29,0,14,337
221400404,263,49,9,4,3,0,19,347
221400405,249,38,15,8,3,0,8,321
221400406,221,58,24,3,15,0,15,336
221400407,254,17,14,4,23,1,12,325
221400408,189,46,32,3,15,0,35,320
221400409,260,19,6,2,9,0,11,307
221400410,197,20,7,4,5,0,2,235
221400411,245,16,1,3,1,1,4,271
221400412,277,13,1,7,3,0,11,312
221400413,126,10,3,2,3,0,16,160
221400414,242,10,2,3,5,0,4,266
221400415,130,8,3,1,0,0,8,150
221400416,189,15,3,3,0,4,4,218
221400417,68,7,0,3,0,0,4,82
221400418,125,8,2,1,3,0,1,140
221400501,210,13,4,5,3,3,12,250
221400502,189,6,1,3,1,0,18,218
221400503,221,22,16,2,2,4,2,269
221400504,165,5,2,4,0,0,6,182
221400505,305,12,0,1,0,0,9,327
221400506,203,16,3,4,0,0,16,242
221400507,274,7,9,6,0,1,6,303
221400508,311,22,0,0,1,0,2,336
221400509,203,10,0,1,0,0,4,218
221400510,218,16,6,3,0,0,14,257
221400511,222,5,0,1,0,0,9,237
221400512,226,8,0,0,0,0,12,246
221400513,290,9,1,2,0,0,5,307
221400514,250,1,2,0,0,1,8,262
221400601,353,1,1,8,0,1,54,418
221400602,245,0,8,7,1,1,7,269
221400603,270,8,6,2,2,0,8,296
221400604,227,0,9,1,0,0,7,244
221400605,294,8,0,5,0,0,5,312
221400606,350,1,1,7,2,1,5,367
221400607,200,6,1,4,1,0,6,218
221400608,386,2,0,3,3,1,2,397
221400609,363,0,0,0,0,2,7,372
221400610,326,2,0,1,0,1,3,333
221400611,268,0,0,5,3,0,6,282
221400612,158,2,2,10,1,2,9,184
221400701,250,3,10,0,0,0,10,273
221400702,295,1,4,0,2,2,5,309
221400703,272,0,0,0,1,3,4,280
221400704,220,0,0,4,1,2,3,230
221400705,210,0,2,3,1,2,3,221
221400706,288,1,1,1,1,0,3,295
221400707,188,1,3,0,0,0,8,200
221400708,244,0,6,1,0,0,4,255
221400709,120,0,0,1,0,0,5,126
221400710,220,0,1,0,0,0,3,224
221400711,197,0,0,1,0,0,11,209
221400712,182,3,1,2,0,0,4,192
221400713,165,0,3,0,0,0,4,172
221400714,235,0,1,0,0,0,3,239
221400715,169,12,5,1,10,1,8,206
221400716,263,16,3,11,5,1,8,307
221400717,145,3,1,2,0,0,7,158
221400718,269,6,0,0,3,1,4,283
221400719,212,10,3,4,0,0,4,233
221400720,201,3,2,4,0,0,5,215
221400721,239,9,0,1,4,1,4,258
221400722,10,3,0,0,0,0,3,16
221400723,232,4,5,2,0,1,11,255
221400724,294,9,0,3,0,0,3,309
221400725,203,4,2,0,1,0,9,219
221400726,235,6,3,0,1,0,4,249
221400727,259,9,0,0,0,0,4,272
221400728,181,4,0,5,3,0,3,196
221400729,148,7,3,2,1,0,3,164
221400801,251,42,42,1,98,1,19,454
221400802,242,46,7,5,14,0,9,323
221400803,230,21,34,6,11,0,9,311
221400804,120,7,27,2,6,0,10,172
221400805,178,21,5,0,4,0,16,224
221400806,198,85,9,0,2,0,3,297
221400807,251,53,31,3,13,2,3,356
221400808,283,40,3,0,5,1,5,337
221400809,143,43,12,0,4,6,1,209
221400810,267,15,0,0,1,1,8,292
221400811,203,9,0,5,1,0,0,218
221400812,151,25,4,1,4,1,15,201
221400813,227,21,7,0,2,0,9,266
221400814,288,41,21,2,5,0,10,367
221400815,268,62,13,0,0,0,6,349
221400816,118,15,8,1,2,0,5,149
221400817,181,39,13,4,4,0,3,244
221400818,166,48,41,0,2,1,10,268
221400901,226,41,8,11,1,4,17,308
221400902,374,26,3,3,4,1,4,415
221400903,307,8,4,2,1,0,3,325
221400904,289,19,4,4,2,0,7,325
221400905,254,31,4,1,4,1,17,312
221400906,354,10,1,0,0,0,4,369
221400907,259,13,7,2,0,0,3,284
221400908,248,1,6,2,11,1,7,276
221400909,261,4,1,7,1,0,2,276
221400910,347,18,0,0,1,2,16,384
221400911,249,21,2,1,0,0,1,274
221400912,172,7,2,0,0,0,3,184
221400913,346,26,3,1,0,0,3,379
221400914,391,52,10,2,1,2,9,467
221400915,342,12,4,1,7,2,12,380
221400916,268,30,1,1,0,0,7,307
221400917,210,2,1,1,1,0,1,216
221400918,220,17,0,0,1,1,3,242
221401001,267,16,4,2,6,0,8,303
221401002,174,19,3,1,1,0,0,198
221401003,263,7,3,2,1,1,6,283
221401004,345,22,2,4,2,0,9,384
221401005,300,25,0,2,0,0,14,341
221401006,305,7,2,5,0,0,6,325
221401007,360,20,1,5,1,0,10,397
221401008,237,16,0,3,0,0,5,261
221401009,363,21,0,1,0,0,11,396
221401010,218,8,1,3,1,1,13,245
221401011,262,16,1,2,0,1,3,285
221401012,218,2,0,1,0,0,6,227
221401013,257,44,14,0,2,7,23,347
221401014,268,21,1,6,0,3,13,312
221401015,254,17,1,2,0,0,1,275
221401017,270,8,0,1,0,0,7,286
221401018,231,36,0,3,2,1,3,276
221401019,199,5,0,4,0,2,0,210
221401020,282,10,0,0,0,0,4,296
221401021,217,17,0,0,0,0,10,244
221401022,235,16,0,4,0,0,4,259
221401101,243,40,5,1,0,1,2,292
221401102,293,36,4,0,0,0,2,335
221401103,263,54,13,6,1,0,4,341
221401104,381,10,9,6,2,0,5,413
221401105,205,39,5,2,4,0,9,264
221401106,188,12,2,3,0,1,3,209
221401107,224,20,1,2,0,0,6,253
221401108,208,25,3,4,7,0,10,257
221401109,134,13,1,0,0,2,5,155
221401110,193,19,7,4,3,0,2,228
221401111,262,19,14,5,17,0,4,321
221401112,275,30,33,1,0,2,3,344
221401113,177,18,4,5,2,1,4,211
221401114,212,26,4,4,5,0,1,252
221401115,188,30,1,0,1,0,1,221
221401201,176,37,1,3,7,1,2,227
221401202,187,46,11,1,16,3,14,278
221401203,212,53,8,3,51,0,23,350
221401204,235,52,17,2,3,0,13,322
221401205,198,15,1,4,6,1,36,261
221401206,260,25,20,4,16,2,16,343
221401207,241,28,11,0,15,0,13,308
221401208,322,30,9,1,5,0,9,376
221401209,148,12,3,4,17,0,9,193
221401210,368,75,14,5,3,0,5,470
221401211,332,28,20,7,2,0,15,404
221401212,178,13,1,1,0,0,6,199
221401213,379,12,6,1,2,0,14,414
221401214,195,23,3,4,0,0,8,233
221401215,404,36,4,7,0,0,3,454
221401216,122,31,7,0,12,4,16,192
221401217,356,16,2,0,1,0,11,386
221401301,190,27,4,2,3,0,3,229
221401302,258,28,2,0,1,1,15,305
221401303,234,27,2,2,7,3,10,285
221401304,205,10,1,4,3,0,3,226
221401305,238,13,4,4,1,0,6,266
221401306,200,17,11,8,8,0,11,255
221401307,259,13,3,1,0,1,19,296
221401308,360,23,3,0,0,1,5,392
221401309,158,7,0,1,0,0,2,168
221401310,165,13,0,5,0,0,7,190
221401311,201,3,0,0,1,0,4,209
221401312,160,8,0,3,1,0,2,174
221401313,214,5,0,0,0,0,0,219
221401314,180,8,1,0,0,0,3,192
221401315,49,11,0,424,0,0,6,490
221401401,139,16,2,2,1,0,3,163
221401402,205,13,3,2,0,0,1,224
221401403,275,20,3,0,0,0,6,304
221401404,258,12,9,1,3,6,10,299
221401405,189,12,2,0,0,0,6,209
221401406,355,18,1,0,0,0,4,378
221401407,179,10,0,2,0,1,2,194
221401408,199,21,3,0,0,0,3,226
221401409,189,14,1,0,0,0,2,206
221401410,174,5,1,4,2,4,11,201
221401411,181,4,0,4,2,0,7,198
221401412,99,9,4,3,4,2,1,122
221401413,166,9,3,0,0,1,2,181
221401501,304,8,3,2,5,0,8,330
221401502,97,6,0,0,0,0,7,110
221401503,299,16,8,0,1,0,36,360
221401504,246,9,0,0,3,0,10,268
221401505,172,25,6,0,1,0,7,211
221401506,352,16,7,0,1,2,12,390
221401507,275,18,1,0,1,1,4,300
221401508,232,18,3,0,1,0,23,277
221401509,186,22,6,0,0,0,3,217
221401510,330,24,3,0,1,0,7,365
221401601,232,23,3,2,2,0,5,267
221401602,103,5,2,2,0,0,10,122
221401603,190,21,1,2,1,0,8,223
221401604,288,6,0,1,2,0,7,304
221401605,267,9,0,3,0,0,9,288
221401606,275,7,0,0,0,0,1,283
221401607,210,9,0,0,0,0,3,222
221401608,185,7,3,5,4,1,12,217
221401609,378,27,6,3,0,0,19,433
221401610,198,37,4,4,1,4,15,263
221401611,118,14,0,1,0,0,1,134
221401612,220,3,0,0,0,0,3,226
221401613,138,15,1,2,8,1,12,177
221401614,128,10,0,0,1,1,5,145
221401615,213,9,3,2,2,2,6,237
221401616,276,13,0,6,1,0,11,307
221401617,226,8,2,1,0,0,6,243
221401618,292,9,6,17,1,3,9,337
221401619,253,16,0,0,0,0,11,280
221401620,216,4,0,4,0,0,8,232
221401621,280,8,0,0,0,3,3,294
221401622,48,1,0,4,0,0,10,63
221401623,77,1,0,4,0,0,0,82
221401624,56,2,0,2,2,1,2,65
221401625,183,23,0,3,0,0,5,214
221401701,155,3,3,3,0,0,9,173
221401702,294,8,2,8,6,3,6,327
221401703,338,28,1,3,5,0,24,399
221401704,243,14,0,5,3,0,8,273
221401705,369,23,3,4,0,0,7,406
221401706,325,28,0,3,0,1,2,359
221401707,215,5,0,0,0,0,4,224
221401708,180,1,1,2,0,0,7,191
221401709,182,4,6,0,1,0,4,197
221401710,184,8,0,0,2,2,3,199
221401801,247,5,0,0,0,1,1,254
221401802,326,11,0,1,0,0,5,343
221401803,205,3,0,0,0,1,4,213
221401804,229,10,1,1,0,0,3,244
221401805,214,2,1,1,0,0,7,225
221401806,306,7,0,0,0,0,1,314
221401807,304,15,0,4,1,1,4,329
221401808,248,9,3,0,1,0,9,270
221401809,231,11,0,0,1,0,9,252
221401810,245,7,0,1,1,0,6,260
221401811,212,11,1,0,0,0,6,230
221401812,181,3,1,0,0,0,4,189
221401813,217,4,0,2,0,1,6,230
221401814,216,1,0,0,0,0,3,220
221401815,186,7,4,4,1,0,2,204
221401816,368,16,0,0,0,5,6,395
221401817,179,5,2,2,0,0,5,193
221401818,9,14,0,0,0,0,0,23
221401819,265,7,1,5,0,0,1,279
221401820,242,11,6,7,7,1,7,281
221401821,187,12,2,0,1,0,5,207
221401901,368,13,6,5,4,0,11,407
221401902,73,0,0,7,0,0,1,81
221401903,187,7,0,0,1,1,9,205
221401904,339,6,2,11,6,0,16,380
221401905,154,16,3,3,11,0,9,196
221401906,201,2,1,7,1,0,5,217
221401907,317,18,1,6,2,1,12,357
221401908,190,8,1,0,0,0,2,201
221401909,203,0,1,2,1,1,9,217
221401910,153,15,2,1,0,0,4,175
221401911,196,8,14,1,0,1,1,221
221401912,212,8,5,1,1,1,7,235
221401913,197,9,0,2,0,0,9,217
221401914,161,6,5,2,0,0,8,182
221401915,191,10,2,0,0,0,1,204
221401916,211,3,1,11,0,0,11,237
221402001,212,13,3,1,1,0,12,242
221402002,282,11,4,5,1,0,6,309
221402003,183,3,1,0,1,0,2,190
221402004,265,9,0,2,2,0,0,278
221402005,367,9,1,0,0,0,6,383
221402006,353,10,1,1,0,2,5,372
221402007,230,5,0,6,0,0,4,245
221402008,217,7,0,2,0,0,2,228
221402009,260,2,5,5,1,3,11,287
221402010,210,10,2,0,0,0,4,226
221402011,194,4,0,4,0,0,5,207
221402101,293,6,0,0,0,0,4,303
221402102,257,3,0,0,0,0,2,262
221402103,223,14,2,6,2,0,26,273
221402104,137,5,0,1,0,1,3,147
221402105,367,8,0,2,0,1,7,385
221402106,444,33,2,2,0,1,9,491
221402107,56,0,0,0,0,0,3,59
221402108,248,24,0,1,0,0,4,277
221402109,44,0,0,0,0,0,0,44
221402201,25,3,0,1,0,11,5,45
221402202,33,4,0,0,1,2,6,46
221402203,58,14,0,9,0,1,2,84
221402204,17,1,0,0,0,1,1,20
221402205,45,0,0,0,0,0,4,49
221402206,41,2,0,0,0,0,0,43
221402301,5,4,0,0,0,1,0,10
221402302,2,0,0,0,0,1,0,3
221402303,16,5,0,0,0,3,0,24
221402304,117,2,0,0,1,10,14,144
221402305,19,2,0,0,0,0,0,21
221402401,189,22,0,1,0,2,3,217
221402402,9,0,0,0,0,0,3,12
221402403,29,0,0,0,0,5,1,35
221402404,243,15,0,2,0,0,15,275
221402405,49,14,0,0,0,0,9,72
221402406,88,2,1,2,0,4,4,101
221402407,2,0,0,0,0,0,2,4
221402408,6,4,0,0,0,0,0,10
221402409,56,0,0,0,0,2,4,62
221402410,77,1,0,0,0,1,14,93
221402411,173,16,0,0,0,0,4,193
221402501,293,5,0,0,0,1,16,315
221402502,283,11,10,3,0,0,1,308
221402503,396,21,4,12,0,17,20,470
221402504,343,24,21,4,3,0,5,400
221402505,483,43,5,21,1,1,26,580
221402506,201,10,2,6,0,9,2,230
221402507,84,3,1,2,0,21,12,123
221402508,308,6,2,0,0,0,9,325
221402509,237,2,0,1,0,1,5,246
221402510,335,14,0,7,5,2,9,372
221402511,417,15,1,1,0,1,2,437
221402512,347,31,1,10,0,1,12,402
221402513,148,1,1,9,5,21,2,187
221402514,57,0,0,1,0,3,1,62
221402515,130,13,0,9,0,1,1,154
221402516,156,0,0,3,0,0,7,166
221402517,115,11,3,1,0,1,1,132
221402518,214,14,0,0,0,0,17,245
221402601,213,7,0,2,1,0,2,225
221402602,273,16,0,0,0,0,5,294
221402603,298,6,0,1,0,0,6,311
221402604,194,23,1,4,0,0,6,228
221402605,244,13,0,0,1,0,3,261
221402606,207,15,1,1,0,1,8,233
221402607,360,30,2,20,0,0,4,416
221402608,346,20,1,0,0,0,2,369
221402609,166,11,0,3,0,1,2,183
221402701,311,15,1,3,0,1,11,342
221402702,327,12,4,0,0,3,12,358
221402703,224,19,0,0,0,0,0,243
221402704,260,9,0,4,0,0,3,276
221402705,268,10,2,0,3,1,5,289
221402706,202,5,0,0,0,0,0,207
221402707,357,14,0,0,0,0,3,374
221402708,253,2,0,0,0,0,6,261
221402709,225,16,2,0,0,0,1,244
221402710,177,7,2,0,3,0,0,189
221402711,289,4,1,7,2,2,16,321
221402712,242,17,2,1,0,1,1,264
221402713,239,4,5,2,0,0,2,252
221402714,440,12,1,1,0,4,5,463
221402715,281,2,0,0,0,0,13,296
221402716,354,17,1,1,0,0,5,378
221402717,345,10,1,0,0,0,7,363
221402718,329,6,0,0,3,1,8,347
221402719,325,13,1,3,0,0,10,352
221402720,230,23,0,15,1,0,19,288
221402721,236,9,3,0,0,0,15,263
221402722,277,45,2,18,0,0,13,355
221402723,213,12,0,3,0,2,10,240
221402724,131,1,1,4,0,0,1,138
221402725,181,12,7,31,1,0,14,246
221402726,156,13,6,3,0,0,2,180
221402801,320,27,0,3,1,1,7,359
221402802,285,8,0,0,0,0,3,296
221402803,212,11,0,1,0,0,6,230
221402804,248,10,0,0,0,0,3,261
221402805,382,28,2,0,0,0,9,421
221402806,200,9,1,20,0,0,13,243
221402807,132,3,0,0,0,0,2,137
221402808,376,10,0,0,0,1,2,389
221402809,247,13,1,0,2,0,0,263
221402810,339,50,0,0,0,0,3,392
221402811,279,18,0,0,0,1,2,300
221402901,171,9,0,4,0,0,8,192
221402902,212,25,4,9,0,0,8,258
221402903,246,24,0,3,0,0,2,275
221402904,276,17,0,0,0,0,1,294
221402905,267,16,0,5,0,0,3,291
221402906,257,22,0,1,0,0,6,286
221402907,110,25,0,0,0,2,2,139
221402908,280,14,1,6,1,1,7,310
221402909,325,13,0,0,0,0,4,342
221402910,376,24,2,2,1,0,6,411
221402911,309,15,2,0,0,0,3,329
221402912,159,5,2,0,0,0,9,175
221402913,245,17,1,0,0,0,3,266
221402914,230,18,1,8,0,1,7,265
221402915,264,22,0,0,0,0,2,288
221402916,154,6,0,1,0,0,5,166
221402919,154,0,0,1,0,0,5,160
221402920,199,10,2,4,1,3,3,222
221403001,239,10,0,4,1,0,15,269
221403002,209,3,0,4,0,0,14,230
221403003,321,27,1,1,0,0,7,357
221403004,216,5,0,0,0,1,0,222
221403005,363,12,1,1,0,0,13,390
221403006,159,12,2,5,1,0,6,185
221403007,383,25,0,0,0,0,22,430
221403008,108,0,0,3,0,0,4,115
221403009,313,11,0,0,0,0,2,326
221403010,140,2,0,0,0,0,10,152
221403011,224,11,1,1,0,0,3,240
221403012,181,21,0,0,0,0,0,202
221403013,128,17,1,3,0,0,7,156
221470101,54,2,0,0,0,0,3,59
221470102,13,9,0,0,0,0,1,23
221470103,41,1,0,0,0,0,4,46
221470104,65,10,0,0,0,0,0,75
221470105,90,1,0,0,0,4,3,98
221470106,122,6,0,1,0,1,2,132
221470107,44,9,0,0,0,0,0,53
221470108,45,1,0,0,0,0,0,46
221470201,337,38,0,4,1,1,16,397
221470202,181,10,6,5,20,1,12,235
221470203,306,32,0,10,0,0,15,363
221470204,170,26,0,1,0,2,3,202
221470205,143,15,0,1,0,2,6,167
221470206,291,21,4,2,0,1,6,325
221470301,374,62,2,8,2,3,14,465
221470302,48,12,0,0,0,0,1,61
221470303,96,3,0,0,0,0,7,106
221470304,36,3,0,0,0,1,3,43
221470305,444,48,0,32,0,0,17,541
221470306,349,37,4,5,0,2,8,405
221470307,72,19,0,0,0,0,0,91
221470401,273,19,1,2,1,3,15,314
221470402,99,5,0,0,0,0,6,110
221470403,29,4,0,0,0,5,7,45
221470404,37,1,0,0,0,8,1,47
221540101,356,25,4,10,1,12,27,435
221540102,212,46,0,2,0,0,17,277
221540103,104,18,1,1,0,0,0,124
221540104,148,16,0,2,0,6,21,193
221540105,315,36,0,15,0,5,9,380
221540106,119,12,1,3,0,2,3,140
221540201,242,21,6,14,19,3,18,323
221540202,351,27,2,1,8,1,22,412
221540203,30,3,0,0,0,0,0,33
221540204,165,19,0,1,0,0,0,185
221540205,34,9,0,0,0,1,3,47
221540206,192,17,0,7,0,1,8,225
221540301,237,5,2,6,3,4,12,269
221540302,334,29,5,10,1,1,13,393
221540303,86,7,0,0,0,3,7,103
221540304,47,2,0,0,0,1,4,54
221540305,81,6,1,1,0,4,17,110
221540306,30,12,0,0,0,1,3,46
221540307,353,27,9,8,6,5,24,432
221540308,73,11,0,1,0,4,9,98
221540309,200,13,4,7,2,3,16,245
221540310,104,0,0,2,0,4,29,139
221540311,255,18,2,4,0,3,2,284
221610101,51,0,0,0,0,0,2,53
221610102,23,9,0,0,0,0,6,38
221610103,18,0,0,0,0,0,8,26
221610201,333,22,0,3,0,3,11,372
221610202,62,0,0,0,0,7,21,90
221610203,29,19,0,0,1,2,13,64
221610301,398,106,0,0,0,0,1,505
221610302,62,4,0,2,0,2,5,75
221610303,15,11,0,0,0,0,8,34
221610304,21,25,0,0,0,0,2,48
221610305,30,9,0,0,0,2,8,49
221610401,61,17,0,0,0,3,10,91
221610402,10,11,0,1,0,4,3,29
221680101,333,34,6,4,2,0,1,380
221680102,248,18,1,5,1,2,8,283
221680103,256,16,5,0,0,4,6,287
221680104,269,18,1,5,1,0,6,300
221680105,258,9,1,4,1,1,17,291
221680106,267,20,3,1,0,2,7,300
221680107,454,38,2,5,0,0,13,512
221680108,301,24,2,5,0,4,14,350
221680109,282,18,0,0,0,1,6,307
221680110,319,12,3,5,1,0,4,344
221680111,156,25,0,5,1,0,6,193
221680112,315,21,1,2,0,0,4,343
221680113,320,20,2,2,1,1,20,366
221680114,247,13,2,5,0,2,12,281
221680115,216,24,0,5,0,0,10,255
221680116,186,15,0,0,0,0,4,205
221680117,198,14,0,0,1,1,0,214
221680201,47,0,0,0,0,0,0,47
221680202,80,2,0,0,0,0,0,82
221680203,41,13,0,0,0,0,1,55
221680204,40,2,0,0,0,0,1,43
221680205,66,4,0,0,0,0,0,70
221680206,23,7,0,0,0,0,0,30
221680207,30,1,0,0,0,0,4,35
221680301,59,0,0,0,0,0,4,63
221680302,57,4,0,0,0,0,3,64
221680303,18,0,0,0,0,0,0,18
221680304,40,15,0,0,0,0,0,55
221680305,34,3,1,0,0,3,4,45
221680306,63,16,0,0,0,1,1,81
221680307,50,8,2,0,0,8,7,75
221680308,50,6,0,0,0,2,2,60
221680309,192,9,3,10,0,3,8,225
221680310,348,49,2,13,0,1,7,420
221680401,53,5,0,0,0,1,8,67
221680402,153,15,0,2,0,2,1,173
221680403,140,1,0,0,0,0,2,143
221680404,60,11,0,0,0,0,10,81
221680405,69,5,0,0,0,0,0,74
221680406,89,2,0,0,0,0,2,93
221680407,26,0,0,0,0,0,0,26
221680408,59,10,0,0,0,0,0,69
221680409,246,5,1,1,0,0,5,258
260070101,18,6,0,0,0,0,5,29
260070201,40,0,0,0,0,23,2,65
260070202,150,0,0,1,0,0,2,153
260070301,23,1,0,0,0,8,4,36
260070302,11,0,0,0,0,0,10,21
260070303,27,2,0,21,0,14,7,71
260070304,128,16,2,24,0,6,24,200
260070401,281,43,94,4,43,10,29,504
260070402,219,11,5,3,5,0,10,253
260070403,255,18,17,6,3,0,3,302
260070404,244,13,2,4,0,0,14,277
260070405,309,13,3,0,1,0,19,345
260070406,194,10,1,2,0,0,2,209
260070407,430,28,17,0,1,0,12,488
260070408,103,3,8,0,0,0,5,119
260070409,230,18,0,3,0,0,8,259
260070410,208,28,12,7,0,4,2,261
260070411,158,6,2,4,2,0,12,184
260070412,328,13,9,14,1,7,29,401
260070413,29,1,0,14,11,4,31,90
260070414,10,0,0,13,0,10,1,34
260070501,273,13,0,3,0,0,4,293
260070502,264,11,2,1,0,0,4,282
260070503,272,10,0,2,3,0,1,288
260070504,170,24,6,9,0,1,14,224
260070505,165,12,1,0,1,1,6,186
260070506,231,18,1,1,0,0,2,253
260070507,243,10,1,0,0,1,0,255
260070508,225,18,1,2,0,0,4,250
260070509,227,4,2,2,0,0,4,239
260070510,356,5,0,3,1,0,0,365
260070511,238,12,2,0,0,0,4,256
260070601,331,15,5,2,0,0,3,356
260070602,228,9,8,2,1,1,2,251
260070603,273,9,3,0,0,0,6,291
260070604,364,30,0,0,0,1,11,406
260070605,372,25,1,0,0,0,12,410
260070606,181,7,3,7,0,0,7,205
260070607,292,14,2,0,0,0,0,308
260070608,304,15,3,7,0,1,10,340
260070609,333,20,4,2,1,0,6,366
260070610,324,25,7,19,4,1,5,385
260070611,119,6,2,3,0,0,0,130
260070612,396,48,13,6,5,7,9,484
260070613,182,35,42,8,21,9,23,320
260070614,298,37,14,5,15,3,25,397
260070615,332,25,18,9,1,0,13,398
260070701,73,9,2,1,0,0,1,86
260070702,226,7,1,3,0,0,3,240
260070703,246,6,3,0,0,0,2,257
260070704,324,10,2,4,0,0,6,346
260070705,265,11,0,19,1,0,17,313
260070706,188,5,1,26,0,0,4,224
260070707,319,19,2,9,0,0,13,362
260070708,338,19,1,5,0,0,1,364
260070709,308,5,1,1,1,0,2,318
260070710,265,11,0,2,0,0,2,280
260070711,236,4,0,2,0,0,0,242
260070712,248,18,1,4,0,1,1,273
260070801,255,26,6,4,3,2,7,303
260070802,434,31,8,0,4,2,8,487
260070803,246,25,11,11,0,0,0,293
260070804,318,44,7,8,1,0,5,383
260070805,282,22,13,15,1,0,6,339
260070806,435,43,14,5,4,1,3,505
260070807,195,16,1,2,0,1,1,216
260070808,204,19,34,5,1,0,4,267
260070809,209,13,6,10,0,3,4,245
260070810,215,14,4,40,0,0,18,291
260070811,418,29,9,6,4,0,11,477
260070812,325,15,15,5,0,0,13,373
260070813,258,17,4,15,1,0,1,296
260070901,328,27,14,8,13,5,11,406
260070902,316,41,16,4,0,0,28,405
260070903,435,36,22,1,0,2,16,512
260070904,293,34,3,10,0,0,2,342
260070905,311,33,7,7,4,2,4,368
260070906,276,36,10,2,0,0,12,336
260070907,314,47,14,29,1,2,8,415
260070908,315,9,46,34,0,7,20,431
260070909,156,19,26,8,2,2,10,223
260070910,213,13,18,7,1,1,12,265
260071001,88,11,57,0,0,13,17,186
260071002,342,65,46,1,22,0,44,520
260071003,131,40,62,0,3,15,14,265
260071004,179,50,29,2,2,2,13,277
260071005,245,23,22,9,15,9,6,329
260071006,246,20,20,0,1,3,5,295
260071007,275,41,23,1,1,15,14,370
260071008,207,39,40,9,0,12,14,321
260071009,223,40,30,5,1,2,12,313
260071010,344,48,46,11,1,11,15,476
260071011,232,31,48,6,1,5,4,327
260071012,182,26,21,10,0,1,2,242
260071013,139,29,11,12,0,4,13,208
260140101,47,1,0,1,0,0,0,49
260140102,37,3,0,1,0,0,0,41
260140103,72,4,1,5,1,4,16,103
260140104,227,18,1,13,0,0,9,268
260140105,276,29,2,8,4,3,7,329
260140106,240,19,7,17,0,0,10,293
260140107,191,12,0,0,1,1,7,212
260140108,234,24,4,8,2,1,19,292
260140201,3,2,0,0,0,2,0,7
260140202,13,6,0,0,0,0,0,19
260140203,7,1,0,0,0,0,2,10
260140204,6,0,0,0,0,0,0,6
260140205,2,1,0,0,0,5,0,8
260140206,1,3,0,0,0,0,1,5
260140207,10,0,0,0,0,0,0,10
260140208,4,5,0,0,0,1,0,10
260140209,5,2,0,0,0,0,0,7
260140301,76,15,0,0,0,0,2,93
260140302,46,2,0,0,0,0,3,51
260140303,226,34,3,9,2,2,13,289
260140304,24,6,0,2,0,0,5,37
260140305,55,11,0,0,0,6,7,79
260140306,42,10,0,0,0,2,8,62
260140307,36,5,0,0,1,0,4,46
260140401,54,17,0,1,0,0,12,84
260140501,10,12,0,0,0,0,9,31
260140601,8,6,0,0,0,0,1,15
260140701,20,8,0,0,1,0,7,36
260140702,50,14,0,0,0,0,0,64
260140703,3,2,0,0,0,0,0,5
260140704,17,23,0,0,0,0,0,40
260140705,327,65,0,16,7,10,29,454
260140801,183,48,4,15,1,12,20,283
260140802,13,3,0,3,0,31,2,52
260140803,262,51,1,25,2,4,7,352
260140804,241,41,7,11,2,2,7,311
260140901,598,88,12,43,6,33,59,839
260140902,27,3,0,2,0,2,2,36
260140903,221,22,0,9,0,1,9,262
260140904,249,41,8,11,1,3,15,328
260140905,232,22,7,13,12,3,10,299
260140906,239,40,4,50,1,3,13,350
260141001,64,21,0,0,0,13,14,112
260141002,39,13,0,0,0,1,6,59
260141003,96,18,5,5,0,2,5,131
260141004,232,28,3,8,2,1,14,288
260141101,17,3,0,0,0,0,1,21
260141102,440,55,14,26,0,22,46,603
260141103,269,29,5,16,1,6,18,344
260141104,177,19,6,17,0,5,6,230
260210101,31,2,0,0,0,12,8,53
260210102,21,5,1,1,0,0,0,28
260210103,27,1,0,0,0,3,2,33
260210104,13,0,0,0,0,76,1,90
260210201,15,0,0,0,0,0,0,15
260210202,42,6,0,0,0,9,6,63
260210203,13,0,0,0,0,0,0,13
260210204,365,16,2,1,0,3,5,392
260210301,28,2,0,0,0,7,5,42
260210302,9,1,0,0,0,3,2,15
260210401,2,0,0,0,0,5,0,7
260210402,63,4,0,26,0,0,0,93
260210403,81,9,0,44,0,1,2,137
260210404,277,21,2,7,1,7,9,324
260210405,268,29,7,20,2,13,10,349
260210406,312,36,3,11,1,17,2,382
260210407,327,15,4,8,1,2,2,359
260210408,212,23,0,25,0,3,4,267
260210409,228,13,1,12,3,0,5,262
260210410,239,26,5,8,4,12,15,309
260210411,193,16,7,8,1,29,4,258
260210412,185,13,4,10,3,6,12,233
260210413,226,28,9,14,0,26,24,327
260210414,202,18,3,19,0,2,5,249
260210501,10,0,0,0,0,1,2,13
260210502,223,4,3,3,1,1,2,237
260210503,111,9,0,0,0,0,3,123
260210504,2,0,0,0,0,0,0,2
260210505,289,7,2,2,1,0,18,319
260210506,280,18,4,18,2,0,4,326
260210507,228,13,0,4,0,0,7,252
260210508,127,3,5,6,8,0,4,153
260210509,205,18,1,4,0,0,7,235
260210510,240,7,1,1,0,0,0,249
260210511,268,5,0,3,0,0,0,276
260210512,308,21,0,18,0,0,2,349
260210513,407,8,4,17,1,0,19,456
260210514,399,43,4,10,0,0,6,462
260210515,390,13,1,2,1,1,8,416
260210516,228,10,0,0,0,0,3,241
260210517,231,14,0,0,0,0,2,247
260210518,287,25,1,18,0,1,3,335
260210601,105,8,4,7,0,3,8,135
260210602,189,4,4,56,0,106,13,372
260210603,71,0,2,2,0,0,2,77
260210604,272,14,4,6,0,3,4,303
260210605,353,18,3,6,5,2,10,397
260210606,274,6,0,1,0,0,19,300
260210607,329,1,3,11,0,0,30,374
260210608,436,21,1,40,0,1,6,505
260210609,321,18,0,0,1,3,2,345
260210610,355,9,3,1,2,2,6,378
260210611,337,21,5,14,5,2,10,394
260210612,268,39,2,16,0,0,10,335
260210613,194,33,0,10,0,0,4,241
260210614,254,27,4,27,2,0,11,325
260210615,245,39,5,104,0,0,74,467
260210701,20,0,4,1,0,1,10,36
260210702,236,1,2,31,1,29,15,315
260210703,78,0,0,1,0,0,0,79
260210704,425,0,4,25,0,0,11,465
260210705,105,0,2,11,0,2,3,123
260210706,215,0,5,10,0,0,3,233
260210707,228,0,1,11,0,4,11,255
260210708,209,0,0,10,1,13,14,247
260210709,290,0,1,3,0,0,9,303
260210710,264,1,1,5,0,0,11,282
260210711,162,6,0,8,0,0,2,178
260210712,257,1,0,7,0,0,3,268
260210801,30,2,0,2,0,1,0,35
260210802,408,47,10,13,2,1,3,484
260210803,44,11,0,0,0,0,1,56
260210804,134,17,1,8,0,2,4,166
260210805,197,12,7,6,0,1,6,229
260210806,203,19,5,4,0,1,10,242
260210807,359,37,10,7,5,0,20,438
260210808,264,30,9,6,0,0,20,329
260210809,144,20,4,5,0,0,7,180
260210810,294,29,3,9,0,2,15,352
260210811,32,2,3,1,0,0,2,40
260210812,285,12,0,8,1,2,10,318
260210813,113,5,2,1,0,0,7,128
260210814,369,24,8,28,2,2,10,443
260210815,365,31,1,2,0,0,19,418
260210901,243,20,11,5,10,0,17,306
260210902,206,33,16,2,2,2,6,267
260210903,212,49,30,2,22,1,1,317
260210904,125,33,31,0,33,0,37,259
260210905,183,49,9,1,18,5,4,269
260210906,151,30,11,0,28,8,6,234
260210907,188,65,16,3,23,2,3,300
260210908,247,53,23,3,25,0,28,379
260210909,217,29,4,1,12,0,9,272
260210910,145,17,10,3,9,1,16,201
260210911,285,34,11,5,22,1,23,381
260210912,148,18,0,2,7,0,12,187
260210913,120,21,2,3,18,0,16,180
260210914,182,23,13,4,8,0,19,249
260211001,333,44,25,0,8,4,40,454
260211002,262,42,24,3,98,1,13,443
260211003,322,60,24,5,25,1,11,448
260211004,227,31,6,5,21,0,20,310
260211005,139,19,3,0,1,0,2,164
260211006,155,19,8,0,2,0,10,194
260211007,164,20,2,0,9,0,15,210
260211008,195,37,7,2,2,0,2,245
260211009,164,29,8,4,3,0,6,214
260211010,202,33,5,5,2,1,14,262
260211011,104,19,22,1,1,0,0,147
260211012,472,128,18,0,4,2,13,637
260211013,305,47,6,3,2,0,5,368
260211101,139,9,0,0,0,0,26,174
260211102,248,14,0,1,0,0,6,269
260211103,135,0,0,1,0,0,4,140
260211104,329,9,2,1,4,0,1,346
260211105,158,11,6,1,1,0,9,186
260211106,197,6,0,2,0,0,7,212
260211107,308,22,1,5,0,0,9,345
260211108,337,16,3,4,0,1,21,382
260211109,288,12,12,3,11,0,6,332
260211110,306,19,4,1,2,0,8,340
260211111,272,15,4,3,0,0,5,299
260211112,180,17,4,3,6,1,15,226
260211113,255,12,4,0,0,0,5,276
260211114,229,17,5,3,0,0,4,258
260211115,176,15,5,4,0,0,1,201
260211116,243,21,4,9,0,0,12,289
260211117,208,20,6,3,0,0,3,240
260211201,255,17,0,6,0,0,2,280
260211202,201,5,0,2,0,0,4,212
260211203,283,20,0,1,0,0,4,308
260211204,357,13,2,6,2,0,5,385
260211205,147,4,0,2,1,0,7,161
260211206,276,17,7,2,2,0,4,308
260211207,284,21,4,3,2,2,16,332
260211208,268,22,5,1,2,0,7,305
260211209,241,13,1,3,0,0,5,263
260211210,136,5,1,3,0,0,4,149
260211301,319,7,2,2,1,1,7,339
260211302,328,15,1,2,0,0,8,354
260211303,230,3,0,3,0,0,2,238
260211304,218,21,1,0,0,0,8,248
260211305,310,13,5,5,4,1,3,341
260211306,230,12,1,0,1,0,10,254
260211307,168,6,5,1,0,0,2,182
260211308,216,6,1,1,0,0,3,227
260211309,255,9,1,0,0,0,1,266
260211310,234,12,0,2,0,1,3,252
260211311,161,11,1,6,1,0,13,193
260211312,392,17,7,3,0,0,13,432
260211401,366,53,2,4,3,0,1,429
260211402,280,20,3,3,0,0,10,316
260211403,226,11,5,2,0,1,3,248
260211404,331,20,2,6,2,0,18,379
260211405,233,10,10,12,0,0,14,279
260211406,306,25,4,2,0,0,6,343
260211407,415,29,21,3,20,3,6,497
260211408,237,23,0,1,3,0,5,269
260211409,223,27,3,4,1,0,16,274
260211410,172,18,2,2,7,0,2,203
260211411,242,14,2,2,0,1,8,269
260211412,292,45,4,6,6,2,13,368
260211413,305,22,0,0,1,0,6,334
260211501,210,0,1,3,1,0,4,219
260211502,284,0,0,0,3,0,5,292
260211503,320,4,1,2,0,0,2,329
260211504,272,4,1,9,1,0,5,292
260211505,177,1,2,0,1,0,0,181
260211506,256,1,5,5,0,0,5,272
260211507,205,0,8,2,0,1,7,223
260211508,224,0,0,3,0,0,1,228
260211509,214,0,6,3,1,0,3,227
260211510,283,6,1,0,0,0,3,293
260211511,250,5,2,3,0,0,2,262
260211601,329,10,0,8,0,0,13,360
260211602,107,2,0,1,0,0,2,112
260211603,175,3,0,2,0,0,12,192
260211604,166,0,1,1,0,0,2,170
260211605,269,6,0,3,0,0,3,281
260211606,203,0,1,0,0,0,3,207
260211607,258,12,0,5,0,1,8,284
260211608,257,6,1,4,1,0,2,271
260211609,301,8,1,2,0,0,3,315
260211610,360,10,1,5,0,0,23,399
260211611,247,15,3,11,0,0,5,281
260211612,205,16,2,4,0,1,7,235
260211613,374,13,0,6,0,0,5,398
260211614,183,1,0,0,0,0,6,190
260211615,207,11,0,46,0,1,7,272
260211701,76,4,0,21,0,1,7,109
260211702,295,20,1,17,0,0,6,339
260211703,157,17,0,22,0,5,10,211
260211704,244,24,1,18,0,1,11,299
260211705,246,17,1,14,0,1,3,282
260211706,276,24,1,21,0,6,8,336
260211707,203,14,1,13,1,4,8,244
260211708,286,16,1,20,0,2,17,342
260211709,332,18,1,11,1,3,6,372
260211710,252,15,1,22,2,2,15,309
260211711,373,2,1,7,0,2,2,387
260211712,243,10,1,10,0,4,12,280
260211713,152,7,0,4,0,3,1,167
260211714,310,9,0,4,0,0,5,328
260211801,182,39,1,52,6,51,22,353
260211802,211,29,5,50,1,16,13,325
260211803,256,22,2,42,1,0,2,325
260211804,268,12,2,1,0,0,2,285
260211805,218,15,1,0,0,1,4,239
260211806,155,8,0,0,0,0,3,166
260211807,168,15,0,1,1,0,7,192
260211808,245,11,1,0,0,0,5,262
260211809,353,18,15,9,1,0,7,403
260211810,228,6,2,3,2,0,8,249
260211811,288,17,6,4,1,0,1,317
260211812,219,27,5,4,4,0,1,260
260211813,221,16,0,4,0,0,4,245
260211901,189,17,0,0,1,1,4,212
260211902,281,12,7,3,1,0,10,314
260211903,354,15,8,2,15,0,4,398
260211904,181,34,0,2,0,0,2,219
260211905,251,13,7,0,0,0,5,276
260211906,222,12,8,0,0,0,13,255
260211907,231,26,0,0,0,0,13,270
260211908,242,15,0,1,0,0,6,264
260211909,218,22,0,14,0,0,8,262
260211910,234,12,9,0,0,1,13,269
260211911,245,14,5,7,0,0,8,279
260211912,283,28,7,17,0,0,1,336
260211913,234,27,2,14,0,5,2,284
260211914,155,22,1,21,12,1,4,216
260211915,262,36,0,1,0,0,8,307
260211916,209,9,1,26,0,0,4,249
260280101,24,0,0,0,0,0,0,24
260280102,2,9,0,0,0,0,0,11
260280201,30,10,0,0,0,0,0,40
260280301,13,0,0,0,0,0,0,13
260280302,19,8,0,0,0,0,2,29
260280303,372,80,10,16,1,17,35,531
260350101,34,17,0,0,0,0,0,51
260350102,16,19,0,0,0,0,0,35
260350201,80,22,0,3,2,10,20,137
260350202,21,20,0,0,0,0,7,48
260350301,125,18,11,17,1,1,5,178
260350302,188,7,3,4,0,5,4,211
260350303,209,16,0,0,0,0,1,226
260350304,236,24,3,14,2,0,2,281
260350305,238,24,1,13,2,3,8,289
260350306,205,7,0,12,4,1,22,251
260350307,270,42,4,2,7,0,10,335
260350308,119,19,2,0,15,0,13,168
260350309,297,32,7,8,16,0,8,368
260350310,139,12,0,0,1,0,3,155
260350311,348,35,5,10,10,0,7,415
260350312,235,16,0,0,1,4,2,258
260350313,216,10,0,3,0,1,0,230
260350401,4,3,0,0,0,4,0,11
260350402,19,1,0,0,0,3,3,26
260350403,21,7,0,0,0,0,1,29
260350404,500,79,5,16,4,17,36,657
260350405,8,0,0,0,0,0,0,8
260350501,5,0,0,1,0,3,6,15
260350502,40,61,0,6,0,3,10,120
260350503,20,4,1,4,0,7,1,37
260350504,32,2,0,0,0,5,1,40
260350505,75,31,0,5,1,12,1,125
260350506,34,7,1,1,0,4,7,54
260350507,144,21,1,4,0,10,14,194
260350508,59,13,0,1,1,25,14,113
260350509,261,32,5,6,2,0,8,314
260350510,403,29,8,6,0,6,10,462
260350511,160,19,5,6,3,3,16,212
260350512,155,17,6,31,2,3,11,225
260350513,277,26,9,6,0,4,25,347
260350514,265,12,2,8,0,1,8,296
260350515,318,16,2,2,0,1,10,349
260350601,316,3,6,7,0,0,6,338
260350602,238,11,1,2,0,0,6,258
260350603,245,10,1,3,0,1,8,268
260350604,191,13,0,8,1,0,5,218
260350605,215,14,0,1,1,0,5,236
260350606,176,8,2,0,2,0,2,190
260350607,179,24,2,3,2,0,2,212
260350608,213,46,8,1,13,1,7,289
260350609,170,27,2,2,7,2,7,217
260350610,214,27,5,4,5,0,5,260
260350611,253,36,1,2,6,3,3,304
260350612,231,21,4,4,0,0,3,263
260350613,204,16,7,2,2,2,6,239
260350614,211,23,6,5,2,1,3,251
260350615,279,21,0,6,0,0,4,310
260350701,271,29,2,7,4,1,7,321
260350702,279,4,2,3,0,0,11,299
260350703,349,18,0,3,0,1,5,376
260350704,246,24,1,3,4,0,2,280
260350705,342,34,7,11,2,3,2,401
260350706,234,15,0,8,3,0,8,268
260350707,350,17,0,2,0,0,8,377
260350708,322,21,3,0,0,0,2,348
260350709,310,16,1,6,0,0,0,333
260350710,331,18,1,26,1,0,8,385
260350711,164,22,5,12,0,0,1,204
260350712,355,30,1,1,1,0,6,394
260350713,169,16,11,12,0,0,3,211
260420101,14,0,0,0,0,5,3,22
260420102,26,1,0,0,0,9,9,45
260420103,9,1,0,0,0,0,0,10
260420201,32,0,0,0,0,0,0,32
260420301,57,7,0,0,0,8,6,78
260420302,9,0,0,0,0,0,5,14
260420401,1,0,0,0,0,0,1,2
260420402,5,3,0,0,0,1,1,10
260420403,109,9,0,2,1,2,16,139
260420404,32,7,0,0,0,12,6,57
260420405,37,14,0,0,0,0,6,57
260420406,45,12,0,0,0,17,23,97
260420407,56,4,0,2,0,8,19,89
260420408,53,8,0,1,0,16,15,93
260420409,129,34,0,2,0,11,20,196
260420410,220,19,0,3,0,11,16,269
260420411,151,18,3,6,0,11,19,208
260420412,64,5,0,2,1,6,24,102
260420413,488,54,5,53,1,4,40,645
260420414,379,23,8,15,0,5,11,441
260420415,366,25,0,6,1,0,14,412
260420416,292,15,1,5,9,1,18,341
260420417,327,26,1,0,0,0,8,362
260420418,378,12,13,67,0,2,9,481
260490101,39,11,0,0,0,0,2,52
260490102,25,20,0,0,0,0,7,52
260490103,40,25,1,0,0,0,7,73
260490104,29,10,0,0,0,3,2,44
260490105,68,30,1,5,0,1,2,107
260490106,176,50,4,10,1,0,7,248
260490201,5,2,0,0,0,0,0,7
260490202,13,14,0,0,0,0,0,27
260490203,26,17,1,3,0,2,4,53
260560101,20,18,0,0,0,0,2,40
260560102,18,7,0,2,0,0,3,30
260560103,12,5,0,0,0,0,0,17
260560104,99,31,0,1,0,2,18,151
260560105,20,25,0,0,0,5,2,52
260560106,22,15,0,0,0,1,3,41
260560107,55,15,0,0,1,2,9,82
260560108,154,26,1,0,1,0,6,188
260560201,17,9,0,0,0,0,1,27
260560202,49,22,0,1,0,2,0,74
260560203,5,3,0,0,0,0,5,13
260560204,11,2,0,0,0,0,1,14
260560205,14,12,0,0,0,0,0,26
260560206,373,54,0,1,1,0,19,448
260560301,88,16,2,8,0,4,16,134
260630101,8,0,0,0,0,0,3,11
260630102,13,2,0,0,0,7,8,30
260630103,21,14,0,0,0,0,1,36
260630201,16,5,0,0,0,4,2,27
260630202,18,16,0,0,0,3,1,38
260630203,150,37,0,3,1,0,0,191
260630301,17,9,0,0,0,0,4,30
260630401,17,4,0,0,0,3,0,24
260700101,24,2,0,0,0,1,2,29
260700102,25,4,0,0,0,0,1,30
260700103,15,4,0,0,0,0,6,25
260700104,105,29,0,8,1,10,19,172
260700105,29,11,1,0,0,0,2,43
260700106,18,9,0,0,0,5,1,33
260700107,10,1,0,0,0,5,2,18
260700108,365,53,0,20,0,9,23,470
260700201,18,10,0,0,0,0,0,28
260700202,24,24,0,0,0,0,1,49
260770101,3,0,0,0,0,0,1,4
260770102,13,10,0,0,3,1,0,27
260770103,10,8,0,0,0,0,0,18
260770104,15,23,0,0,0,1,2,41
260770201,22,1,0,0,0,21,0,44
260770202,2,3,0,0,0,0,3,8
260770203,45,41,3,9,0,162,26,286
260770204,56,3,0,9,0,0,0,68
260770301,113,15,0,0,0,15,44,187
260770302,224,37,12,6,3,126,34,442
260770303,162,38,4,34,0,15,26,279
260770304,205,6,1,0,0,0,0,212
260770305,288,25,0,55,0,2,11,381
260770306,199,30,4,12,1,22,16,284
260770307,172,5,0,7,4,105,3,296
260770308,106,9,11,5,5,107,6,249
260770309,75,66,2,10,1,60,9,223
260770310,131,7,12,23,0,46,17,236
260770311,107,14,25,13,0,39,21,219
260770312,104,21,15,26,1,23,15,205
260770313,117,24,17,31,0,45,18,252
260770314,107,15,6,6,0,95,18,247
260770315,145,32,8,32,0,64,26,307
260770316,87,16,1,17,1,2,4,128
260770401,110,50,2,10,0,41,20,233
260770402,60,10,1,0,0,5,8,84
260770403,161,19,2,6,1,26,26,241
260770404,210,24,1,7,1,33,26,302
260770405,83,11,0,1,0,10,17,122
260770501,2,0,0,0,0,0,0,2
260770502,269,13,0,3,0,0,9,294
260770503,189,3,0,0,0,0,1,193
260770504,214,9,1,1,1,0,2,228
260770505,242,16,1,0,1,0,7,267
260770506,244,15,0,1,0,0,2,262
260770507,225,9,2,0,0,0,3,239
260770508,168,14,1,0,0,1,1,185
260770509,198,8,0,0,0,0,1,207
260770510,312,14,0,3,1,0,5,335
260770511,207,10,1,3,0,0,3,224
260770512,173,9,0,0,1,0,2,185
260770513,172,4,2,3,0,0,4,185
260770514,226,14,1,0,0,0,4,245
260770515,224,26,1,0,0,0,5,256
260770516,207,15,1,6,1,0,4,234
260770517,180,6,0,0,1,0,1,188
260770518,230,16,6,13,0,0,12,277
260770519,159,10,2,8,0,1,1,181
260770520,114,25,1,29,1,9,9,188
260770601,202,18,3,1,11,1,2,238
260770602,248,43,6,1,4,0,6,308
260770603,271,31,3,0,2,0,3,310
260770604,179,10,1,0,0,1,6,197
260770605,310,18,3,1,0,0,3,335
260770606,304,19,4,2,1,0,5,335
260770607,159,15,4,0,0,0,4,182
260770608,311,30,0,6,16,0,10,373
260770609,274,26,11,3,27,0,21,362
260770610,165,18,4,0,18,1,8,214
260770611,252,27,1,0,5,6,4,295
260770612,189,32,1,2,5,0,2,231
260770701,464,1,3,3,4,0,47,522
260770702,294,0,0,0,1,0,4,299
260770703,390,11,0,0,0,6,18,425
260770704,454,14,0,0,0,0,51,519
260770705,277,20,0,6,0,0,5,308
260770706,207,7,2,5,0,0,5,226
260770707,277,13,0,1,0,0,2,293
260770708,209,15,0,1,0,0,12,237
260770709,370,8,2,2,0,1,4,387
260770710,292,10,4,1,0,0,2,309
260770711,170,4,0,1,0,1,2,178
260770712,309,12,4,2,1,0,3,331
260770713,285,21,1,2,0,1,4,314
260770714,206,6,0,1,0,0,3,216
260770715,188,5,1,1,3,0,10,208
260770801,309,15,1,11,0,1,5,342
260770802,303,13,0,0,0,0,1,317
260770803,352,20,0,0,0,0,9,381
260770804,255,26,0,1,0,0,3,285
260770805,247,18,0,0,1,0,3,269
260770806,383,15,6,2,2,1,15,424
260770807,147,10,4,2,0,0,1,164
260770808,255,15,4,0,0,1,6,281
260770809,234,12,1,1,0,1,0,249
260770810,235,29,2,1,1,0,4,272
260770811,158,19,3,2,5,0,50,237
260770812,221,16,9,4,3,2,4,259
260770813,307,29,4,1,3,0,8,352
260770814,211,10,3,3,0,0,4,231
260770815,325,4,0,0,0,0,6,335
260770901,383,11,1,7,0,0,2,404
260770902,317,7,0,9,0,0,16,349
260770903,419,15,2,6,0,0,3,445
260770904,272,13,2,2,0,1,7,297
260770905,344,20,2,2,0,0,6,374
260770906,336,27,3,1,1,0,5,373
260770907,221,7,2,5,0,0,7,242
260770908,226,5,0,0,0,0,7,238
260770909,221,12,0,5,0,0,3,241
260770910,330,5,1,0,0,0,4,340
260770911,329,11,2,0,0,0,4,346
260770912,420,10,1,0,0,0,5,436
260771001,238,15,5,3,0,1,5,267
260771002,243,8,6,7,0,2,4,270
260771003,156,8,5,0,2,0,5,176
260771004,233,18,7,15,0,0,14,287
260771005,274,26,8,7,14,1,14,344
260771006,140,31,3,1,8,1,1,185
260771007,187,32,17,2,25,0,22,285
260771008,186,29,19,3,11,3,2,253
260771009,204,46,16,0,15,0,15,296
260771010,208,49,7,1,17,1,12,295
260771011,153,18,3,1,4,2,16,197
260771012,157,29,8,3,26,2,6,231
260771013,310,30,4,5,2,0,7,358
260771014,320,21,6,5,2,2,9,365
260771015,306,26,2,5,0,0,3,342
260771016,475,16,3,4,0,3,7,508
260771017,359,19,7,10,1,1,9,406
260771018,216,19,0,3,0,0,8,246
260771101,154,3,0,0,0,0,0,157
260771102,412,12,0,0,0,0,0,424
260771103,312,17,0,38,0,8,7,382
260771104,206,7,1,1,4,0,8,227
260771105,285,8,0,2,0,1,7,303
260771106,273,10,0,0,0,0,2,285
260771107,311,2,0,5,8,0,7,333
260771108,210,25,6,3,3,0,6,253
260771109,189,18,6,1,3,0,14,231
260771110,156,31,25,4,20,0,20,256
260771111,138,13,6,6,25,3,12,203
260771112,254,49,15,2,24,0,22,366
260771113,326,21,10,4,11,3,8,383
260771114,185,6,1,4,1,0,0,197
260771201,444,3,2,0,0,1,13,463
260771202,280,9,3,6,3,0,6,307
260771203,378,17,5,0,0,0,9,409
260771204,276,13,8,5,1,0,11,314
260771205,325,28,10,4,1,1,9,378
260771206,316,35,11,6,8,2,7,385
260771207,351,39,7,4,4,3,9,417
260771208,315,51,7,1,2,3,15,394
260771209,195,26,2,5,4,0,4,236
260771210,314,34,17,12,1,0,7,385
260771211,378,24,6,2,8,2,16,436
260771212,336,27,8,4,3,1,6,385
260771213,276,45,7,0,0,0,10,338
260771214,374,10,0,0,0,0,3,387
260771215,353,19,1,90,0,4,9,476
260771301,331,23,4,51,2,6,13,430
260771302,439,30,0,5,6,5,8,493
260771303,356,55,21,19,5,6,7,469
260771304,386,21,20,16,0,2,15,460
260771305,384,34,11,14,5,2,17,467
260771306,408,37,9,4,5,1,25,489
260771307,351,24,5,1,3,1,6,391
260771308,351,25,3,1,0,1,3,384
260771309,447,26,1,14,0,2,9,499
260771310,235,13,5,0,0,0,0,253
260771311,290,23,5,9,2,2,4,335
260771312,266,16,1,2,4,0,13,302
260771313,209,21,3,25,0,1,3,262
260771314,129,12,4,21,1,12,11,190
260840101,6,1,0,0,0,8,0,15
260840102,33,38,0,0,0,0,0,71
260840103,42,30,0,0,0,22,0,94
260840104,4,3,0,1,0,21,0,29
260840105,5,6,0,0,0,1,0,12
260840106,40,0,0,0,0,2,2,44
260840107,217,38,7,6,0,6,20,294
260840108,268,37,0,15,6,0,19,345
260840201,20,21,0,0,0,0,5,46
260840202,61,11,2,3,0,2,15,94
260840301,7,3,0,0,0,0,0,10
260840302,7,3,0,0,0,2,2,14
260840303,11,2,0,0,0,0,1,14
260840304,21,23,2,0,0,0,3,49
260840305,447,42,7,2,3,1,29,531
260840306,265,31,17,2,3,3,17,338
260840307,100,17,0,1,3,2,12,135
260840401,20,6,0,0,0,0,0,26
260840402,23,0,0,0,0,0,0,23
260840403,62,35,0,7,0,0,11,115
260840501,10,0,0,0,0,8,5,23
260840502,18,7,0,0,0,0,0,25
260840503,19,1,0,0,0,0,7,27
260840504,24,11,0,0,0,0,0,35
260840505,65,20,0,0,2,2,25,114
260840506,53,15,0,1,0,2,11,82
260910101,25,9,0,0,0,7,3,44
260910102,34,2,0,0,0,1,31,68
260910201,27,5,0,0,0,13,3,48
260910301,7,0,0,0,0,2,2,11
260910302,7,3,0,0,0,0,0,10
260910303,15,6,0,0,0,0,0,21
260910304,22,73,0,0,0,1,2,98
260910305,4,2,0,1,0,0,3,10
260910306,3,7,0,0,0,0,1,11
260910401,202,31,5,20,1,2,11,272
260910402,152,12,1,3,0,0,4,172
260910403,112,18,3,41,0,10,6,190
260910404,278,16,0,3,1,0,10,308
260910405,315,17,0,15,0,0,7,354
260910406,149,9,3,7,1,0,14,183
260910407,159,24,3,20,2,0,5,213
260910408,176,20,2,4,1,1,10,214
260910409,287,47,3,1,3,3,8,352
260910410,267,57,3,4,1,0,5,337
260910411,163,16,4,13,1,0,4,201
260910412,208,34,5,7,1,2,0,257
260910413,223,14,0,5,0,0,7,249
260910414,224,29,2,8,0,0,4,267
260980101,15,0,0,0,0,0,0,15
260980102,27,7,0,0,0,0,1,35
260980103,222,28,8,32,0,2,10,302
260980104,269,44,3,15,3,3,13,350
260980201,15,1,0,0,0,8,4,28
260980202,24,5,0,0,0,13,0,42
260980203,19,0,0,0,0,9,1,29
260980204,0,4,0,0,0,0,1,5
260980205,422,49,4,12,0,2,15,504
260980206,303,32,1,8,1,0,13,358
260980301,0,3,0,0,0,0,0,3
260980302,1,3,0,0,0,0,0,4
260980303,4,5,0,0,0,0,2,11
260980304,13,12,0,0,0,0,0,25
260980305,47,23,0,0,0,2,2,74
260980306,336,39,3,13,1,5,35,432
261050101,26,7,0,0,0,7,3,43
261050102,13,11,0,0,0,0,1,25
261050103,49,21,1,0,0,0,2,73
261050104,25,17,0,0,0,0,0,42
261050105,191,71,0,4,3,1,16,286
261050201,27,15,0,0,0,0,0,42
261050202,10,1,0,0,0,4,0,15
261050203,8,0,0,0,0,0,8,16
261050204,38,10,0,0,0,0,3,51
261050205,204,56,5,17,2,1,4,289
300080101,127,7,26,5,0,9,7,181
300080102,179,4,89,15,2,44,14,347
300080103,171,18,42,4,3,12,13,263
300080104,169,12,20,3,0,13,15,232
300080105,160,8,2,4,1,0,1,176
300080106,190,18,22,9,1,17,9,266
300080107,115,1,67,6,2,19,4,214
300080108,171,25,13,5,6,5,13,238
300080109,205,13,13,6,0,14,12,263
300080110,219,19,27,5,0,2,11,283
300080111,289,20,10,10,0,8,12,349
300080112,213,20,12,3,8,12,6,274
300080113,181,4,4,0,2,10,12,213
300080114,194,20,20,6,1,3,9,253
300080201,145,7,28,8,21,2,10,221
300080202,115,12,14,3,12,2,3,161
300080203,135,31,28,7,2,12,2,217
300080204,194,28,24,4,12,14,16,292
300080205,205,10,4,2,13,17,9,260
300080206,263,14,22,5,6,8,13,331
300080207,288,30,13,7,1,14,13,366
300080208,316,6,3,3,1,5,13,347
300080209,162,10,3,5,3,13,2,198
300080210,171,13,13,4,0,14,9,224
300080211,169,14,33,2,5,21,8,252
300080212,72,7,17,3,0,2,4,105
300080213,55,1,2,4,4,32,3,101
300080214,106,22,8,5,1,84,5,231
300080215,175,13,24,11,0,14,1,238
300080216,155,6,32,3,0,8,19,223
300080301,50,0,0,0,0,2,3,55
300080302,76,1,3,2,1,0,1,84
300080303,91,4,0,1,0,4,7,107
300080304,87,8,0,9,0,8,2,114
300080305,192,13,12,13,0,4,0,234
300080306,260,16,6,8,0,0,3,293
300080307,174,16,15,15,0,5,6,231
300080308,184,18,9,10,1,6,8,236
300080309,74,1,0,1,0,4,2,82
300080310,208,3,17,6,1,1,20,256
300080311,236,21,10,22,2,7,7,305
300080312,193,5,15,10,1,16,13,253
300080313,182,16,0,1,0,12,5,216
300080314,102,4,0,5,0,13,4,128
300080315,113,2,3,16,2,39,13,188
300080316,28,1,0,0,0,5,4,38
300080317,60,2,0,0,0,4,8,74
300080318,55,5,0,1,1,10,1,73
300080319,53,0,0,2,0,12,11,78
300080401,159,0,6,4,0,1,1,171
300080402,354,3,6,10,0,1,8,382
300080403,318,9,6,3,1,1,7,345
300080404,302,10,0,17,1,8,13,351
300080405,325,29,20,16,0,8,8,406
300080406,372,9,10,5,2,8,15,421
300080407,156,5,5,9,0,0,3,178
300080408,242,7,10,4,2,6,9,280
300080409,271,25,6,2,7,3,14,328
300080410,325,22,11,14,1,6,6,385
300080411,257,18,11,6,0,7,1,300
300080412,404,16,11,4,1,7,10,453
300080413,167,7,6,5,2,1,2,190
300080501,39,8,0,0,0,1,4,52
300080502,65,0,0,0,0,7,12,84
300080503,74,6,0,0,0,0,13,93
300080504,139,5,3,0,0,4,7,158
300080505,52,2,1,3,1,2,0,61
300080506,340,19,3,2,0,2,7,373
300080507,325,13,2,12,1,2,11,366
300080508,340,31,3,6,1,9,13,403
300080509,171,26,6,15,0,13,4,235
300080510,136,2,3,0,0,1,22,164
300080511,69,6,37,8,1,89,5,215
300080601,285,39,21,34,0,21,10,410
300080602,346,17,14,5,0,3,9,394
300080603,183,9,5,8,0,8,0,213
300080604,294,19,5,3,1,2,10,334
300080605,357,24,9,10,0,18,8,426
300080606,322,28,6,4,10,7,9,386
300080607,294,15,6,1,3,5,5,329
300080608,362,25,15,8,2,2,11,425
300080609,176,12,3,1,0,2,9,203
300080610,216,7,12,2,2,3,4,246
300080611,326,18,4,0,7,1,11,367
300080612,259,26,9,10,4,14,4,326
300080701,7,2,0,0,0,0,1,10
300080702,30,0,0,2,0,6,7,45
300080703,82,3,16,27,2,2,16,148
300080704,10,0,0,1,0,0,1,12
300080705,57,6,4,2,0,0,2,71
300080706,16,0,0,0,0,0,0,16
300080707,36,4,1,0,0,3,2,46
300080708,20,3,0,0,0,3,6,32
300080709,23,0,0,0,0,0,7,30
300080710,22,0,0,0,0,2,4,28
300080711,65,10,35,0,0,7,0,117
300080801,17,11,0,0,0,0,0,28
300080802,12,5,0,0,0,0,0,17
300080803,10,0,0,0,0,1,7,18
300080804,36,7,0,0,0,0,1,44
300080805,22,4,0,0,0,2,11,39
300080806,16,0,0,0,0,3,5,24
300080807,88,14,0,3,0,0,4,109
300080808,47,4,0,0,0,0,0,51
300080809,15,6,0,0,0,3,1,25
300080810,45,1,0,0,0,3,6,55
300080811,37,2,1,0,0,0,10,50
300080901,22,6,0,1,0,0,2,31
300080902,21,1,0,0,0,2,5,29
300080903,20,0,0,1,0,5,7,33
300080904,8,1,0,0,0,1,3,13
300080905,29,0,0,0,0,1,14,44
300080906,55,11,0,0,0,2,4,72
300080907,14,0,0,0,0,0,3,17
300080908,5,0,0,0,0,2,6,13
300080909,30,3,0,1,0,3,5,42
300080910,222,10,5,6,1,81,44,369
300081001,27,2,0,0,0,0,2,31
300081002,23,3,0,0,0,1,4,31
300081003,171,5,4,4,2,2,19,207
300081004,17,0,0,0,0,0,2,19
300081005,34,4,0,0,0,0,1,39
300081006,16,1,0,0,0,0,6,23
300081007,133,13,0,2,2,0,9,159
300081008,22,5,0,0,0,1,14,42
300081009,10,6,0,0,1,0,0,17
300081101,34,1,5,0,0,1,0,41
300081102,23,0,0,0,0,2,0,25
300081103,24,8,0,0,0,2,3,37
300081104,15,0,0,0,1,1,8,25
300081105,39,5,1,0,0,1,8,54
300081106,4,0,0,0,0,0,4,8
300081107,22,0,0,0,0,0,4,26
300081108,198,5,3,5,0,1,4,216
300081109,109,1,1,0,1,0,0,112
300081110,322,11,4,7,7,0,35,386
300081111,132,5,0,3,1,1,4,146
300081201,1,0,0,0,0,0,0,1
300150101,378,12,2,1,0,1,7,401
300150102,321,0,1,0,0,0,7,329
300150103,466,1,0,0,0,0,7,474
300150104,400,11,0,0,0,0,2,413
300150105,292,4,0,1,0,0,7,304
300150106,368,12,3,0,2,0,9,394
300150107,322,5,0,2,0,0,1,330
300150108,263,0,0,1,0,0,5,269
300150109,278,0,2,2,0,0,6,288
300150110,167,3,0,0,0,0,2,172
300150111,451,10,0,2,0,0,6,469
300150112,337,5,0,2,0,0,1,345
300150113,410,14,0,3,0,1,3,431
300150201,385,17,0,5,1,0,19,427
300150202,258,0,2,3,0,0,12,275
300150203,263,1,0,4,0,0,5,273
300150204,291,5,1,0,1,0,7,305
300150205,439,7,0,2,2,0,7,457
300150206,313,17,4,2,4,0,6,346
300150207,176,5,1,0,0,0,5,187
300150208,332,15,2,5,0,0,5,359
300150209,374,12,3,4,1,0,10,404
300150210,380,18,6,2,1,0,14,421
300150211,292,25,0,1,0,0,6,324
300150212,368,15,2,3,3,0,10,401
300150213,385,13,5,6,3,0,16,428
300150214,213,23,10,9,0,0,14,269
300150301,278,8,2,0,1,0,6,295
300150302,344,12,0,1,0,2,6,365
300150303,392,30,0,0,0,0,9,431
300150304,341,23,2,4,2,2,9,383
300150305,359,12,7,6,1,2,3,390
300150306,49,8,0,1,0,1,0,59
300150307,104,6,1,6,0,0,2,119
300150308,378,30,3,6,1,3,8,429
300150309,288,17,4,5,0,7,2,323
300150310,206,12,2,0,0,0,0,220
300150401,253,7,1,6,2,2,6,277
300150402,175,12,2,3,2,0,4,198
300150403,321,22,5,1,3,1,12,365
300150404,297,16,0,3,1,0,8,325
300150405,299,4,6,2,1,0,19,331
300150406,359,17,7,8,0,3,6,400
300150407,311,14,2,8,1,1,6,343
300150408,305,18,5,8,0,0,3,339
300150409,232,7,2,3,0,0,5,249
300150410,213,2,2,10,1,3,11,242
300150411,387,4,0,11,0,12,11,425
300150412,375,11,2,1,0,0,4,393
300150413,407,17,3,1,5,2,2,437
300150414,259,29,7,3,1,0,9,308
300150415,113,12,1,2,2,0,2,132
300150416,402,59,10,1,6,0,6,484
300150501,183,23,2,1,5,0,8,222
300150502,378,29,5,3,3,0,6,424
300150503,206,13,4,2,2,0,6,233
300150504,190,10,3,0,1,1,4,209
300150505,181,5,0,0,0,0,6,192
300150506,251,10,4,4,0,0,6,275
300150507,247,7,2,3,0,4,6,269
300150508,231,7,3,0,0,0,3,244
300150509,263,10,0,4,0,1,3,281
300150510,178,7,5,2,2,0,7,201
300150511,156,3,7,3,0,0,5,174
300150512,153,5,5,3,1,0,7,174
300150513,156,7,4,1,3,0,7,178
300150514,144,23,3,6,19,1,20,216
300150515,188,18,13,8,18,0,9,254
300150516,178,36,33,1,20,3,1,272
300150517,207,40,14,0,26,0,6,293
300150518,144,11,6,2,8,0,7,178
300150519,189,24,8,3,3,0,8,235
300150520,207,19,6,3,1,2,0,238
300150521,104,2,10,2,0,0,2,120
300150522,356,3,4,0,0,0,7,370
300150601,327,12,0,3,1,0,5,348
300150602,199,4,0,0,0,0,9,212
300150603,410,8,6,2,1,0,1,428
300150604,382,12,8,2,0,0,8,412
300150605,131,14,3,0,26,0,3,177
300150606,241,6,3,3,4,0,13,270
300150607,303,54,1,2,1,0,5,366
300150608,242,25,4,0,6,0,6,283
300150609,244,28,16,5,13,1,4,311
300150610,222,9,5,4,32,0,24,296
300150611,165,9,6,2,44,2,17,245
300150612,192,14,1,6,12,1,11,237
300150613,312,20,4,0,0,0,12,348
300150614,417,11,7,1,5,0,8,449
300150615,222,4,3,3,1,0,7,240
300150616,267,13,7,1,12,2,4,306
300150617,252,19,8,2,6,1,10,298
300150618,116,22,1,0,10,1,7,157
300150619,201,15,6,1,9,0,11,243
300150620,110,16,4,1,19,0,5,155
300150621,133,23,31,1,6,1,13,208
300150701,240,6,3,0,0,0,4,253
300150702,157,12,3,0,3,0,3,178
300150703,187,21,7,4,0,1,4,224
300150704,151,32,6,2,14,1,5,211
300150705,144,29,8,2,10,2,23,218
300150706,118,19,2,0,5,0,6,150
300150707,162,17,6,0,22,0,6,213
300150708,153,7,9,2,7,0,14,192
300150709,164,13,4,1,2,0,3,187
300150710,227,5,0,1,0,0,4,237
300150711,208,7,6,2,0,0,2,225
300150712,224,7,2,1,0,0,4,238
300150713,185,9,9,2,4,0,8,217
300150714,167,12,0,0,1,1,10,191
300150715,168,6,5,1,0,0,0,180
300150716,260,3,2,1,0,0,4,270
300150717,15,0,0,0,0,0,7,22
300150718,395,15,10,1,1,0,9,431
300150719,368,9,0,1,0,9,7,394
300150720,127,4,0,5,0,1,7,144
300150801,158,35,4,4,5,0,15,221
300150802,138,26,19,1,19,3,10,216
300150803,132,15,21,0,10,0,4,182
300150804,140,20,12,3,18,3,10,206
300150805,175,7,6,0,13,1,9,211
300150806,188,2,5,1,0,0,4,200
300150807,325,16,1,1,11,0,24,378
300150808,207,24,1,3,13,0,15,263
300150809,173,13,10,2,19,0,9,226
300150810,210,14,21,0,11,0,6,262
300150811,214,13,7,5,4,0,9,252
300150812,195,12,12,0,8,1,12,240
300150813,5,1,0,0,0,0,0,6
300150814,340,19,2,0,11,0,21,393
300150815,88,0,0,0,0,0,7,95
300150901,79,13,0,0,0,2,7,101
300150902,90,1,6,3,4,18,9,131
300150903,23,3,0,0,0,3,1,30
300150904,248,2,5,7,0,8,14,284
300150905,307,6,0,0,1,8,10,332
300150906,277,4,0,3,3,0,9,296
300150907,296,15,2,3,2,12,17,347
300150908,301,8,1,0,0,1,3,314
300150909,141,7,4,5,5,0,4,166
300150910,119,5,0,4,0,0,10,138
300150911,14,3,0,0,0,0,34,51
300151001,178,5,2,0,3,2,10,200
300151002,400,19,2,8,3,0,6,438
300151003,179,10,0,2,1,3,1,196
300151004,423,13,2,5,0,0,12,455
300151005,368,5,1,2,0,0,18,394
300151006,278,10,1,7,5,0,5,306
300151007,303,11,1,6,1,1,3,326
300151008,310,24,0,6,0,0,2,342
300151009,404,22,5,0,0,0,13,444
300151010,291,8,6,5,0,0,2,312
300151011,392,13,3,4,1,0,4,417
300151012,407,24,0,5,0,0,6,442
300151013,290,5,0,0,0,0,5,300
300151101,230,8,3,10,6,8,85,350
300151102,11,0,0,0,0,0,2,13
300151103,215,11,7,16,0,4,8,261
300151104,177,10,4,3,0,0,4,198
300151105,323,12,10,4,1,9,5,364
300151106,195,7,3,5,0,2,8,220
300151107,200,4,0,17,0,0,15,236
300151108,232,1,0,11,0,4,7,255
300151109,53,1,0,0,0,3,9,66
300151110,234,24,1,12,1,3,19,294
300151111,165,6,3,7,0,5,11,197
300151201,40,4,0,0,0,0,7,51
300151202,29,3,0,0,0,2,14,48
300151203,31,5,1,0,0,0,1,38
300151204,41,1,0,0,0,1,2,45
300151205,12,0,0,0,0,0,0,12
300151206,29,0,0,0,0,0,5,34
300151207,16,4,0,0,0,2,2,24
300151208,64,0,0,0,0,0,6,70
300151209,22,0,0,0,0,0,0,22
300151210,48,9,0,2,0,1,2,62
300151211,57,1,0,2,0,4,4,68
300151212,263,9,3,10,0,7,12,304
300151213,296,19,5,10,1,1,24,356
300151214,287,30,8,6,9,8,12,360
300151301,107,2,0,7,1,34,27,178
300151302,20,1,0,0,0,6,0,27
300151303,17,0,0,0,0,0,6,23
300151304,295,8,0,10,4,0,2,319
300151305,134,0,0,7,4,1,9,155
300151306,42,8,0,0,0,2,2,54
300151307,48,9,0,0,0,2,0,59
300151308,34,8,0,0,0,1,0,43
300151309,14,1,0,1,0,1,2,19
300151310,214,14,2,2,1,4,4,241
300151311,242,5,0,12,0,0,31,290
300151312,177,8,0,4,0,2,11,202
300151401,10,0,0,0,0,1,0,11
300151402,9,1,0,0,0,3,1,14
300151403,58,0,0,0,0,0,0,58
300151404,56,0,0,0,0,0,1,57
300151405,22,3,0,0,0,0,6,31
300151406,30,3,0,0,0,1,1,35
300151407,32,5,0,0,0,0,2,39
300151408,76,4,0,3,3,1,16,103
300151501,57,0,0,0,0,1,15,73
300151502,54,3,0,0,1,3,0,61
300151503,6,0,0,0,0,2,1,9
300151504,60,1,0,0,0,4,3,68
300151505,57,2,0,0,0,0,0,59
300151506,67,8,0,1,1,7,3,87
300151507,51,0,1,1,0,11,12,76
300151508,42,14,0,0,0,0,9,65
300151509,34,5,0,3,0,14,13,69
300151510,89,10,1,5,0,1,5,111
300151511,226,4,2,4,2,0,7,245
300151512,78,0,4,2,5,28,10,127
300151513,85,6,1,2,0,42,9,145
300151514,99,15,0,1,0,4,1,120
300151515,96,4,1,5,0,26,26,158
300151601,11,6,0,0,0,3,12,32
300151602,51,7,2,5,0,0,3,68
300151603,24,1,0,0,0,0,3,28
300151604,14,2,0,0,0,0,0,16
300151605,24,2,0,0,0,0,0,26
300151606,129,0,1,11,0,40,11,192
300151607,127,4,0,5,1,0,8,145
300210101,254,16,1,1,1,1,10,284
300210102,279,22,4,5,0,0,5,315
300210103,40,4,29,0,0,0,3,76
300210104,304,21,4,10,5,4,13,361
300210105,195,14,4,7,0,0,9,229
300210106,251,6,2,6,7,1,15,288
300210107,275,24,3,0,0,1,2,305
300210108,342,15,4,4,1,0,6,372
300210109,178,6,3,0,3,1,15,206
300210110,149,10,1,2,4,1,2,169
300210111,170,17,5,3,4,1,12,212
300210112,199,11,4,3,0,5,9,231
300210201,203,18,2,6,1,1,9,240
300210202,130,15,5,0,1,4,12,167
300210203,251,7,2,2,8,2,11,283
300210204,28,7,0,0,0,0,0,35
300210205,120,8,0,0,0,0,1,129
300210206,89,8,0,0,0,0,2,99
300210207,176,10,1,1,0,1,4,193
300210208,167,16,5,4,0,0,1,193
300210209,131,12,1,2,0,1,2,149
300210210,291,30,4,2,4,2,14,347
300210211,241,18,1,1,0,0,5,266
300210212,348,15,0,4,1,5,18,391
300210301,35,0,0,0,1,1,0,37
300210302,113,2,3,3,0,5,8,134
300210303,163,5,5,1,1,4,6,185
300210304,141,5,2,5,0,3,11,167
300210305,137,9,0,4,0,1,16,167
300210306,38,1,2,0,0,21,1,63
300210307,53,2,0,5,1,9,2,72
300210308,90,5,12,1,0,0,3,111
300210309,149,9,0,0,0,2,2,162
300210310,87,5,0,0,0,4,4,100
300210311,58,7,0,0,0,2,3,70
300210312,41,2,3,1,3,4,0,54
300210401,144,14,10,9,0,111,17,305
300210402,15,0,0,0,0,5,0,20
300210403,76,3,0,5,0,1,12,97
300210404,50,1,3,1,0,13,6,74
300210405,161,4,4,5,2,11,6,193
300210406,112,2,3,2,1,5,4,129
300210407,9,0,0,0,0,1,24,34
300210408,20,20,0,3,0,68,46,157
300210409,58,3,0,0,0,0,3,64
300210410,96,4,3,2,0,2,4,111
300210501,70,4,3,2,0,136,3,218
300210502,74,2,0,0,0,17,15,108
300210503,31,5,0,0,0,1,24,61
300210504,58,1,0,0,0,3,8,70
300210505,266,12,4,22,1,3,24,332
300210506,237,8,3,12,4,3,14,281
300210507,199,8,1,14,0,10,5,237
300210508,27,0,0,0,1,5,3,36
300210509,6,0,0,4,0,15,0,25
300210510,43,0,1,1,0,2,5,52
300210511,44,2,0,0,0,0,3,49
300210512,162,7,1,1,1,4,20,196
300210601,60,3,0,0,0,2,4,69
300210602,57,7,0,0,0,0,14,78
300210603,39,2,0,0,0,2,12,55
300210604,161,10,4,6,1,3,19,204
300210605,38,4,0,1,0,1,5,49
300210606,21,0,0,0,0,0,6,27
300210701,10,0,0,0,0,1,0,11
300210702,15,4,0,0,0,1,1,21
300210703,2,1,0,0,0,0,0,3
300210704,33,2,0,0,0,0,0,35
300210705,16,3,0,1,0,3,2,25
300210706,169,31,6,24,0,1,1,232
300210707,138,9,2,18,0,2,5,174
300210708,199,9,0,5,1,1,7,222
300210709,238,25,11,1,0,2,2,279
300210710,266,44,2,1,1,1,3,318
300210711,24,8,0,2,0,0,2,36
300210712,186,14,3,3,0,1,1,208
300210713,129,19,0,2,0,1,2,153
300210714,245,44,12,3,1,1,7,313
300210715,228,22,8,3,1,0,3,265
300210716,199,16,4,5,1,1,2,228
300210801,14,0,0,0,0,0,2,16
300210802,29,0,0,1,0,0,4,34
300210803,28,2,0,0,0,1,6,37
300210804,107,2,1,2,0,5,11,128
300210805,17,3,0,0,0,0,8,28
300210806,27,1,0,0,0,0,7,35
300210807,34,0,0,0,0,1,24,59
300210808,14,8,0,0,0,0,0,22
300210809,32,4,0,0,0,0,0,36
300210901,68,11,0,0,0,0,1,80
300210902,99,7,1,2,0,0,2,111
300210903,225,10,2,3,0,3,8,251
300210904,137,20,5,1,0,1,0,164
300210905,394,20,6,2,1,0,9,432
300210906,95,3,0,0,0,0,2,100
300210907,227,11,0,0,0,0,4,242
300210908,187,11,4,2,2,0,6,212
300210909,199,18,3,1,0,2,9,232
300210910,180,20,0,5,0,0,2,207
300210911,207,14,7,5,1,0,8,242
300211001,28,6,0,1,0,1,0,36
300211002,152,12,0,10,0,1,3,178
300211003,80,5,2,1,0,3,1,92
300211004,181,16,1,4,0,2,3,207
300211005,106,6,0,4,0,0,2,118
300211006,192,10,6,4,0,2,2,216
300211007,229,15,8,5,4,2,4,267
300211101,36,0,0,0,0,0,12,48
300211102,32,1,1,0,0,3,6,43
300211103,25,3,0,0,0,1,0,29
300211104,19,0,0,0,0,0,11,30
300211105,16,2,0,0,0,2,6,26
300211201,5,0,0,0,0,0,2,7
300211202,4,1,0,0,0,0,0,5
300211203,23,1,0,0,0,2,2,28
300211204,42,11,0,0,0,0,1,54
300211205,21,2,0,0,0,1,7,31
300211206,31,0,0,0,0,0,13,44
300211207,19,7,0,0,0,0,7,33
300211208,32,15,0,0,0,3,5,55
300211209,23,4,0,0,0,0,9,36
300211210,195,43,2,2,2,5,14,263
300211211,12,0,0,0,0,1,1,14
300211212,38,4,0,0,0,3,7,52
300211301,32,12,2,0,0,0,1,47
300211302,12,7,0,0,0,0,0,19
300280101,80,5,32,1,0,2,2,122
300280102,316,20,8,1,3,10,3,361
300280103,204,7,21,1,2,8,14,257
300280104,169,19,29,3,0,6,3,229
300280105,303,13,18,3,1,3,7,348
300280106,282,9,5,1,3,6,0,306
300280107,235,16,4,0,5,2,12,274
300280108,195,13,2,3,4,5,4,226
300280109,159,10,2,5,0,6,9,191
300280110,306,25,8,3,1,1,7,351
300280111,149,20,8,3,1,4,2,187
300280112,188,13,8,8,1,0,21,239
300280113,113,8,0,0,0,0,2,123
300280114,48,4,0,1,1,2,1,57
300280201,54,12,4,3,0,4,1,78
300280202,40,0,0,4,0,0,2,46
300280203,237,1,1,3,0,0,13,255
300280204,333,0,0,0,1,0,0,334
300280205,293,2,1,5,0,0,12,313
300280206,258,12,5,25,1,2,6,309
300280301,43,0,0,0,0,1,10,54
300280302,7,0,0,0,0,1,3,11
300280303,77,9,1,1,0,4,8,100
300280304,7,1,0,0,0,0,2,10
300280305,22,0,0,0,0,14,6,42
300280306,51,1,0,2,0,3,6,63
300280307,3,0,0,0,0,1,1,5
300280308,12,23,0,0,0,2,3,40
300280401,147,3,5,0,0,0,2,157
300280402,233,12,4,3,1,0,2,255
300280403,322,11,3,0,0,0,5,341
300280404,220,5,0,11,0,0,2,238
300280405,202,7,0,5,1,1,1,217
300280406,273,18,2,5,0,0,1,299
300280407,186,5,0,3,0,1,3,198
300280408,250,6,6,6,0,5,0,273
300280409,150,12,5,0,1,0,0,168
300280410,255,9,7,4,0,3,5,283
300280411,210,15,1,2,1,1,1,231
300280412,227,24,4,3,0,0,1,259
300280413,197,14,1,0,0,0,8,220
300280414,188,12,4,3,2,1,5,215
300280415,181,8,3,0,0,0,7,199
300280416,275,17,5,9,2,2,9,319
300280417,211,10,3,4,1,0,4,233
300280418,253,13,1,9,3,1,7,287
300280419,255,5,3,5,2,1,0,271
300280501,230,10,0,2,0,0,1,243
300280502,267,16,1,4,1,0,3,292
300280503,261,7,0,3,0,2,5,278
300280504,196,10,2,3,0,0,9,220
300280505,302,13,2,1,0,0,2,320
300280506,126,6,6,4,2,0,0,144
300280507,256,9,5,1,0,0,8,279
300280508,177,14,1,1,6,0,3,202
300280509,221,19,6,0,4,0,6,256
300280510,166,23,7,3,1,0,19,219
300280511,213,17,7,1,10,1,10,259
300280512,313,17,3,3,4,0,13,353
300280513,155,18,3,7,2,1,7,193
300280514,282,12,0,4,0,0,9,307
300280515,200,18,3,5,4,0,10,240
300280516,140,18,10,1,0,0,1,170
300280517,308,16,5,3,0,1,6,339
300280518,284,29,13,6,3,0,3,338
300280519,241,22,4,13,1,1,4,286
300280601,78,8,1,0,0,0,2,89
300280602,64,6,0,2,0,2,1,75
300280603,175,15,0,57,0,1,7,255
300280604,42,1,0,0,0,0,0,43
300280605,97,2,2,1,0,2,2,106
300280606,107,3,0,6,0,1,2,119
300280607,118,10,9,10,0,0,4,151
300280608,194,10,8,14,1,4,3,234
300280609,201,7,6,18,0,34,71,337
300280610,25,2,0,0,0,2,1,30
300280611,59,4,0,0,0,2,0,65
300280701,2,0,0,0,0,0,0,2
300280702,3,0,0,0,0,1,0,4
300280703,13,5,0,0,0,0,0,18
300280704,30,0,0,1,0,0,3,34
300280705,3,0,0,0,0,0,0,3
300280706,12,0,0,0,0,0,3,15
300280707,8,0,0,0,0,0,2,10
300280708,85,4,0,1,0,1,8,99
300280709,258,14,2,7,0,2,28,311
300280710,332,19,3,1,1,1,7,364
300280711,216,15,0,4,1,5,9,250
300280712,197,9,5,7,1,3,9,231
300280801,40,0,0,2,0,25,2,69
300280802,34,0,0,0,0,0,2,36
300280803,60,1,0,2,0,0,6,69
300280804,3,2,0,0,0,0,0,5
300280805,74,3,0,5,2,2,1,87
300280806,50,1,0,0,0,0,0,51
300280807,24,2,0,0,0,0,0,26
300280808,66,0,0,0,0,4,5,75
300280809,291,4,1,1,1,0,5,303
300280810,180,7,1,5,0,1,0,194
300280811,143,3,0,6,1,0,1,154
300280812,115,8,0,2,0,0,2,127
300280901,56,0,0,0,0,5,5,66
300280902,16,0,0,0,0,0,0,16
300280903,66,1,0,0,1,23,16,107
300280904,53,0,0,0,0,1,8,62
300280905,31,7,0,0,0,0,0,38
300280906,31,0,0,7,1,129,5,173
300280907,224,4,7,3,0,2,10,250
300281001,9,0,0,0,0,0,1,10
300281002,23,0,0,0,0,7,0,30
300281003,7,5,0,0,0,0,0,12
300281004,6,0,0,0,0,0,0,6
300281005,35,1,0,0,0,0,1,37
300281006,6,1,0,0,0,0,0,7
300281007,9,0,0,0,0,2,1,12
300281008,84,2,0,0,0,1,0,87
300281101,16,4,0,0,0,0,1,21
300281102,2,0,0,0,0,0,1,3
300281103,32,1,0,1,0,0,2,36
300281104,31,1,0,0,0,1,4,37
300281105,12,0,0,0,0,0,0,12
300281106,10,3,0,0,0,0,1,14
300281107,173,11,1,2,1,0,6,194
300281108,143,14,3,3,0,1,8,172
300281201,49,1,0,0,0,0,1,51
300281202,2,1,0,0,0,0,0,3
300281203,29,3,1,4,0,0,2,39
300281204,62,4,0,0,0,1,3,70
300281205,28,1,0,0,0,0,0,29
300281206,36,2,0,2,0,1,3,44
300281207,59,1,0,0,0,0,0,60
300281208,201,15,0,3,0,5,8,232
300281209,14,1,0,0,0,1,2,18
300281210,87,2,0,1,0,0,9,99
300281211,51,12,0,0,0,1,0,64
300281212,62,0,0,1,2,0,10,75
300281213,36,1,0,0,0,0,10,47
300281214,46,5,0,0,0,0,8,59
300281215,115,16,0,2,0,5,12,150
300281301,16,0,0,0,0,10,0,26
300281302,12,1,0,0,0,0,1,14
300281303,59,11,0,0,0,0,2,72
300281304,26,0,0,0,0,0,0,26
300281305,8,0,0,0,0,0,0,8
300281306,25,0,0,0,0,0,0,25
300281307,56,8,0,0,0,0,2,66
300281308,10,1,0,1,0,0,3,15
300281309,105,8,1,0,0,0,2,116
300281310,12,0,0,0,0,0,1,13
300350101,195,7,0,3,0,12,13,230
300350102,205,7,3,9,1,3,13,241
300350103,153,4,5,7,1,1,13,184
300350104,375,16,1,4,0,3,13,412
300350105,292,18,3,5,1,5,12,336
300350106,241,7,1,10,0,2,11,272
300350107,263,8,5,3,5,5,17,306
300350108,189,6,2,5,3,2,18,225
300350109,133,3,6,6,0,3,4,155
300350110,213,12,4,4,0,2,7,242
300350111,138,3,10,5,0,0,3,159
300350112,287,25,4,3,0,1,4,324
300350113,273,12,3,4,16,5,14,327
300350114,185,13,0,5,0,1,9,213
300350115,193,7,10,5,0,1,2,218
300350116,307,21,3,18,5,2,7,363
300350117,307,24,3,12,5,4,12,367
300350118,233,14,6,6,0,1,6,266
300350119,217,16,1,5,0,0,3,242
300350201,29,0,0,0,0,0,2,31
300350202,43,8,0,1,0,0,2,54
300350203,55,6,0,0,0,1,3,65
300350204,167,8,0,1,0,8,20,204
300350205,35,0,0,1,0,1,1,38
300350206,72,2,0,5,0,1,5,85
300350301,4,2,0,0,0,0,0,6
300350302,5,2,0,0,0,4,0,11
300350303,9,0,0,0,0,5,0,14
300350304,12,1,0,3,0,4,1,21
300350305,5,0,0,0,0,8,4,17
300350401,25,7,0,0,0,1,4,37
300350402,8,1,0,0,0,1,0,10
300350403,36,1,0,0,0,0,5,42
300350404,4,0,0,0,0,0,0,4
300350405,21,0,0,0,0,2,3,26
300350406,15,0,0,0,0,5,2,22
300350407,26,0,0,0,0,7,4,37
300350408,34,7,0,0,0,0,16,57
300350409,45,2,0,1,0,4,4,56
300350410,8,0,0,0,0,0,4,12
300350411,12,0,0,0,0,0,0,12
300350412,6,0,0,0,0,5,10,21
300350413,3,0,0,0,0,2,0,5
300350414,97,8,0,1,0,1,10,117
300350501,26,2,0,0,0,0,0,28
300350502,16,4,0,0,0,0,0,20
300350503,4,0,0,0,0,0,4,8
300350504,33,4,0,1,0,2,4,44
300350505,13,11,0,0,0,4,0,28
300350506,14,16,0,0,0,4,0,34
300350507,65,5,1,2,0,0,3,76
300350601,5,0,0,0,0,0,2,7
300350602,7,1,0,0,0,1,1,10
300350603,19,1,0,0,0,1,2,23
300350604,9,0,0,0,0,0,2,11
300350605,24,4,0,0,0,1,2,31
300350606,16,1,0,0,0,2,5,24
300350701,53,8,0,0,0,0,3,64
300350702,30,0,0,0,0,1,16,47
300350703,19,0,0,0,0,7,1,27
300350704,21,1,0,0,0,5,5,32
300350705,24,1,0,0,0,3,3,31
300350706,37,0,0,2,0,4,14,57
300350801,24,2,0,0,0,2,1,29
300350802,29,0,0,0,0,0,0,29
300350803,28,3,0,0,0,3,0,34
300350804,41,7,0,0,0,0,0,48
300350805,27,1,1,1,0,1,4,35
300350901,24,3,0,0,0,2,6,35
300350902,34,0,0,0,0,0,6,40
300350903,10,1,0,1,0,0,11,23
300350904,5,0,0,0,0,0,1,6
300350905,29,5,0,0,0,1,2,37
300350906,9,1,0,0,0,0,5,15
300350907,8,1,1,0,0,2,0,12
300351001,1,0,0,0,0,0,2,3
300351002,4,0,0,0,0,0,3,7
300351003,28,1,0,1,0,1,5,36
300351004,13,0,0,0,0,1,4,18
300351005,85,12,0,2,0,0,4,103
300351006,89,6,1,5,0,4,0,105
300351007,193,19,2,4,0,0,25,243
300351101,18,0,0,0,0,0,0,18
300351102,36,3,0,0,0,0,24,63
300351103,349,9,8,9,2,3,21,401
300351104,192,17,0,3,9,5,7,233
300351105,202,13,5,2,0,0,6,228
300351106,134,8,1,0,1,4,0,148
300420101,220,15,2,2,1,2,3,245
300420102,250,9,1,3,0,5,14,282
300420103,205,9,2,5,0,1,4,226
300420104,271,11,8,2,5,3,6,306
300420105,195,4,3,4,3,1,2,212
300420106,257,18,0,1,13,0,11,300
300420107,248,23,9,5,0,3,13,301
300420108,182,10,1,4,0,0,8,205
300420109,129,5,2,2,3,2,10,153
300420110,210,15,1,0,1,2,1,230
300420111,233,17,1,5,1,1,11,269
300420112,180,15,2,0,1,0,9,207
300420201,54,2,0,1,0,0,3,60
300420202,67,0,0,1,0,0,14,82
300420203,44,0,0,0,0,2,8,54
300420204,133,7,0,4,0,4,10,158
300420205,80,0,0,0,0,0,5,85
300420206,72,4,0,0,0,1,12,89
300420301,24,0,0,0,0,0,2,26
300420302,63,13,0,1,0,2,4,83
300420303,71,14,0,2,1,0,5,93
300420304,7,0,0,0,0,8,0,15
300420305,38,0,0,0,0,1,13,52
300420401,15,4,0,0,0,0,0,19
300420402,25,0,0,0,0,5,5,35
300420403,13,1,0,0,0,0,0,14
300420404,47,0,0,0,0,0,18,65
300420405,8,4,0,2,0,1,10,25
300420406,25,3,0,0,0,4,1,33
300420501,17,0,0,0,0,4,1,22
300420502,12,1,0,0,0,0,0,13
300420503,102,9,0,0,0,3,21,135
300420504,41,6,0,0,0,1,1,49
300420601,5,1,0,0,0,0,5,11
300420602,25,0,0,0,0,0,8,33
300420603,33,8,0,0,0,1,1,43
300420604,18,3,1,4,0,0,2,28
300420605,16,2,0,0,0,0,0,18
300420701,20,0,1,0,0,1,0,22
300420702,12,0,0,0,0,0,0,12
300420703,41,6,0,0,0,2,7,56
300420704,83,14,0,0,0,2,4,103
300490101,89,7,0,2,0,7,5,110
300490102,358,19,2,4,0,1,11,395
300490103,246,25,16,6,0,10,3,306
300490104,146,10,2,1,0,0,4,163
300490105,288,9,9,12,1,0,12,331
300490106,317,21,5,7,1,0,26,377
300490107,294,19,5,9,1,1,12,341
300490108,293,31,0,1,8,0,6,339
300490109,147,8,4,4,4,2,8,177
300490110,183,26,3,4,17,3,15,251
300490111,251,19,1,0,1,0,12,284
300490112,196,15,8,1,0,2,0,222
300490113,154,5,1,3,2,2,11,178
300490114,143,11,0,0,0,0,2,156
300490201,236,13,4,1,1,1,8,264
300490202,338,1,8,6,3,9,23,388
300490203,204,8,3,3,0,2,7,227
300490204,166,12,3,1,0,0,8,190
300490205,195,18,4,4,1,4,4,230
300490206,178,9,0,1,0,0,8,196
300490207,136,20,4,3,1,0,3,167
300490208,187,26,6,1,5,2,3,230
300490209,219,18,2,1,1,0,6,247
300490210,320,14,4,2,0,1,5,346
300490211,257,26,6,10,9,3,13,324
300490212,129,22,0,2,6,2,12,173
300490213,228,28,4,0,1,0,3,264
300490214,162,27,4,2,3,1,2,201
300490215,127,5,2,1,12,5,3,155
300490216,104,4,1,1,1,1,1,113
300490217,82,4,1,0,0,0,1,88
300490218,263,18,2,4,1,1,9,298
300490219,253,38,10,5,4,0,17,327
300490220,275,18,5,8,0,2,4,312
300490221,204,6,1,2,0,1,4,218
300490222,163,4,2,6,0,2,3,180
300490301,377,20,7,12,2,2,14,434
300490302,190,9,2,2,6,0,21,230
300490303,133,16,8,2,18,2,12,191
300490304,178,9,0,3,8,0,11,209
300490305,229,16,5,4,5,0,18,277
300490306,280,25,9,4,4,1,12,335
300490307,253,19,1,2,0,0,18,293
300490308,326,13,3,4,0,2,4,352
300490309,356,10,5,4,1,2,5,383
300490310,375,10,1,6,0,1,16,409
300490311,134,6,1,4,0,2,4,151
300490312,242,3,2,3,1,2,12,265
300490401,130,6,4,8,0,37,27,212
300490402,99,19,0,3,0,9,8,138
300490403,86,9,0,0,0,7,13,115
300490404,17,4,0,0,0,0,0,21
300490405,17,0,0,0,0,2,3,22
300490406,7,18,1,1,1,22,3,53
300490407,104,16,0,3,0,16,8,147
300490408,39,1,0,4,0,18,13,75
300490409,126,3,0,4,1,8,10,152
300490410,4,1,0,0,0,5,0,10
300490411,162,4,5,16,0,49,8,244
300490412,349,30,3,7,2,3,12,406
300490413,312,25,1,5,0,0,11,354
300490414,221,16,3,3,3,1,1,248
300490415,192,11,0,9,0,2,7,221
300490416,3,1,0,1,0,2,0,7
300490417,82,8,0,1,1,0,1,93
300490501,23,1,0,0,0,0,0,24
300490502,14,1,0,0,0,3,0,18
300490503,36,1,0,0,0,3,4,44
300490504,15,3,0,0,0,0,2,20
300490505,22,2,0,1,0,1,3,29
300490506,19,1,0,0,2,4,1,27
300490507,27,0,0,0,0,0,11,38
300490508,34,9,0,0,0,0,4,47
300490509,35,4,1,2,0,5,7,54
300490510,37,0,0,0,0,1,11,49
300490511,113,2,1,4,0,19,8,147
300490512,48,4,0,1,1,3,7,64
300490513,16,0,0,0,0,5,1,22
300490601,27,0,0,0,0,5,8,40
300490602,21,12,0,0,0,6,0,39
300490603,21,2,0,0,0,4,7,34
300490604,15,12,1,0,0,2,6,36
300490605,31,14,0,0,0,5,2,52
300490606,22,3,0,0,0,0,9,34
300490607,10,8,0,0,0,0,0,18
300490608,3,4,0,0,0,0,2,9
300490609,37,0,0,0,0,1,16,54
300490610,12,3,0,0,0,3,0,18
300490611,112,14,1,6,3,7,4,147
300490701,17,1,0,0,0,6,13,37
300490702,41,11,0,0,0,0,2,54
300490703,19,8,0,0,0,2,3,32
300490704,7,3,0,0,0,3,4,17
300490705,11,1,0,0,0,6,4,22
300490706,39,7,0,0,0,15,8,69
300490707,19,6,8,0,1,2,1,37
300490708,32,10,0,0,0,8,13,63
300490709,14,1,0,0,1,0,13,29
300490710,11,2,0,0,0,0,1,14
300490711,15,0,0,1,0,1,1,18
300490712,12,4,0,0,0,2,4,22
300490801,6,0,0,0,0,0,0,6
300490802,26,0,0,0,0,1,10,37
300490803,24,3,0,0,0,1,2,30
300490804,27,0,0,0,0,0,0,27
300490805,28,11,0,0,0,0,0,39
300490806,43,4,0,0,0,9,3,59
300490807,10,1,0,0,0,5,1,17
300490901,13,5,0,0,0,0,0,18
300490902,37,12,0,3,0,58,11,121
300491001,1,3,0,1,0,0,0,5
300491002,10,0,0,0,0,0,5,15
300491003,20,0,0,4,0,3,9,36
300491004,18,4,0,1,0,1,2,26
300491005,77,3,2,1,1,2,9,95
300491006,194,13,3,1,4,1,9,225
300491007,297,27,12,6,0,2,6,350
300491008,182,12,2,10,2,4,12,224
300491009,140,9,1,1,0,0,12,163
300491010,321,27,7,13,3,6,5,382
300491011,297,30,2,4,2,4,12,351
300560101,291,1,0,3,0,7,7,309
300560102,247,0,0,0,0,0,1,248
300560103,345,1,4,8,0,1,11,370
300560104,305,2,6,2,0,2,14,331
300560105,349,15,8,1,6,1,5,385
300560106,351,15,2,9,0,0,9,386
300560107,366,14,4,11,1,2,20,418
300560108,317,20,13,12,12,4,3,381
300560109,216,11,4,0,3,1,6,241
300560110,361,5,7,8,0,2,11,394
300560111,330,18,12,3,0,1,4,368
300560112,149,15,6,1,3,2,5,181
300560113,183,26,11,0,4,2,4,230
300560114,222,10,5,0,1,3,2,243
300560115,380,19,4,10,2,3,11,429
300560116,308,8,1,2,5,5,11,340
300560117,273,10,9,6,3,2,14,317
300560118,113,21,3,0,8,0,14,159
300560119,190,7,3,0,1,0,9,210
300560120,222,28,17,5,12,3,7,294
300560121,166,16,17,2,9,1,11,222
300560122,225,19,3,3,21,2,12,285
300560201,271,1,9,2,1,1,10,295
300560202,224,18,5,3,0,4,9,263
300560203,340,17,0,4,2,1,19,383
300560204,148,5,1,0,0,2,8,164
300560205,367,18,4,5,0,4,11,409
300560206,351,22,7,4,0,0,6,390
300560207,223,17,6,10,0,1,3,260
300560208,195,1,10,4,0,4,7,221
300560209,199,8,9,11,2,4,10,243
300560210,185,11,7,8,1,4,17,233
300560211,141,17,3,5,3,0,1,170
300560212,197,14,5,4,7,1,5,233
300560213,206,8,3,1,7,3,9,237
300560214,228,16,4,0,3,1,9,261
300560215,220,17,9,3,6,3,5,263
300560216,269,10,6,11,0,1,6,303
300560217,213,21,9,5,0,7,11,266
300560218,186,16,2,3,8,4,12,231
300560219,163,21,5,5,15,4,4,217
300560220,258,39,2,7,11,4,9,330
300560221,175,11,16,3,19,5,7,236
300560301,75,19,1,3,9,3,7,117
300560302,105,15,5,1,9,10,8,153
300560303,249,19,10,2,18,4,28,330
300560304,173,30,4,1,14,1,16,239
300560305,127,19,2,1,1,0,13,163
300560306,178,22,6,0,3,1,9,219
300560307,203,27,9,8,10,10,16,283
300560308,241,54,13,11,5,2,15,341
300560309,168,15,12,4,5,1,5,210
300560310,233,22,7,2,14,2,9,289
300560311,184,19,1,1,0,1,7,213
300560312,206,5,6,7,4,6,12,246
300560313,309,20,9,8,3,1,11,361
300560314,255,14,5,3,1,3,7,288
300560315,110,7,9,6,1,4,1,138
300560316,197,14,8,8,2,8,6,243
300560317,323,7,8,16,0,1,12,367
300560318,312,19,0,2,0,2,4,339
300560319,118,4,0,0,0,0,6,128
300560401,209,7,8,0,1,1,5,231
300560402,186,10,3,2,1,1,10,213
300560403,130,18,3,0,0,3,3,157
300560404,150,13,15,3,19,3,8,211
300560405,289,31,9,4,2,0,15,350
300560406,215,7,12,8,1,1,8,252
300560407,251,27,10,5,1,2,6,302
300560408,312,20,4,12,1,1,12,362
300560409,323,16,4,4,2,5,8,362
300560410,350,16,1,1,0,1,9,378
300560411,279,5,2,0,0,0,7,293
300560412,259,4,0,2,0,0,10,275
300560413,240,15,1,6,2,2,12,278
300560414,346,12,1,8,0,2,7,376
300560415,284,7,1,6,0,1,12,311
300560416,199,7,0,5,0,5,6,222
300560417,282,25,2,8,0,7,8,332
300560418,245,9,1,5,0,6,11,277
300560501,137,1,1,2,3,4,11,159
300560502,149,13,0,0,0,0,1,163
300560503,143,4,0,1,0,4,4,156
300560504,313,18,3,0,0,0,6,340
300560505,190,3,1,6,0,0,13,213
300560506,153,8,1,11,0,3,6,182
300560507,230,4,1,1,0,4,8,248
300560508,221,12,2,8,0,1,5,249
300560509,179,4,1,1,0,1,9,195
300560510,241,12,2,5,5,1,5,271
300560511,290,13,1,4,0,1,8,317
300560512,178,9,1,6,0,1,9,204
300560513,300,14,2,5,4,5,6,336
300560601,60,5,0,3,0,13,9,90
300560602,120,7,4,5,0,9,6,151
300560603,23,0,0,1,0,3,0,27
300560604,45,1,1,3,0,13,0,63
300560605,352,6,3,0,0,2,4,367
300560606,297,9,2,6,1,3,8,326
300560607,99,6,3,1,0,3,1,113
300560608,337,22,1,7,0,1,7,375
300560609,23,7,0,0,0,0,8,38
300560610,114,16,6,7,0,32,9,184
300560611,66,7,1,7,0,15,12,108
300560612,19,5,0,0,1,2,1,28
300560701,380,13,1,0,0,0,4,398
300560702,328,21,7,17,0,6,9,388
300560703,63,31,2,4,0,33,7,140
300560704,28,1,1,0,0,3,22,55
300560705,85,5,2,0,0,11,7,110
300560706,268,20,2,13,1,8,9,321
300560707,53,0,0,1,1,0,0,55
300560801,16,5,0,0,0,2,0,23
300560802,12,1,0,0,0,2,10,25
300560803,1,2,0,0,0,0,2,5
300560804,44,3,0,0,0,4,12,63
300560805,14,1,0,0,0,1,0,16
300560806,11,0,0,0,0,1,2,14
300560807,6,0,0,0,0,1,3,10
300560808,54,4,0,0,0,3,9,70
300560809,26,2,0,0,0,0,28,56
300560810,43,2,0,1,0,2,10,58
300560811,152,11,1,6,0,9,21,200
300560812,100,12,1,2,0,0,4,119
300560901,19,5,0,0,0,2,0,26
300560902,43,8,1,1,0,0,2,55
300560903,7,6,0,0,0,0,1,14
300560904,12,1,0,0,0,5,11,29
300560905,8,0,0,0,0,2,5,15
300560906,22,11,0,0,0,0,6,39
300560907,41,0,0,0,0,1,12,54
300560908,48,3,0,2,0,1,2,56
300560909,36,7,2,3,0,3,8,59
300560910,15,14,0,0,0,0,0,29
300560911,118,24,2,1,0,7,16,168
300560912,8,7,0,0,0,0,3,18
300560913,15,8,0,0,0,0,6,29
300560914,6,2,0,0,0,0,1,9
300560915,147,13,1,4,0,0,4,169
300560916,212,15,0,3,0,6,11,247
300561001,44,6,0,1,1,19,2,73
300561002,5,8,0,0,0,1,0,14
300561003,43,13,0,0,0,6,13,75
300561004,70,13,1,1,1,19,5,110
300561005,37,0,0,0,0,3,0,40
300561006,5,11,0,0,0,0,0,16
300561007,11,1,0,1,0,9,25,47
300561008,23,10,0,0,0,1,4,38
300561009,75,9,1,1,0,11,23,120
300561010,19,9,0,0,0,6,0,34
300561011,52,4,1,8,0,11,23,99
300561101,5,5,0,1,0,0,2,13
300561102,16,5,0,0,0,3,12,36
300561103,17,6,0,0,0,11,5,39
300561104,14,1,0,0,0,5,5,25
300561105,15,0,0,0,0,6,0,21
300561106,20,0,0,0,0,0,18,38
300561107,19,2,0,0,0,2,7,30
300561108,7,3,0,0,0,1,0,11
300561109,15,7,0,0,0,3,4,29
300561110,19,0,0,0,0,0,0,19
300561111,108,19,3,4,0,1,20,155
300561201,71,28,0,0,0,0,4,103
300561202,49,1,0,0,0,10,4,64
300561203,25,14,0,0,0,1,1,41
300561204,42,6,0,0,0,6,5,59
300561205,46,5,0,0,0,7,1,59
300561206,53,1,0,0,0,12,10,76
300561207,38,3,0,1,0,9,5,56
300561208,41,6,0,0,0,8,8,63
300561209,16,0,0,0,0,1,0,17
300561301,7,1,0,0,0,20,1,29
300561302,45,14,0,0,1,11,4,75
300561303,20,3,0,0,1,5,8,37
300561304,11,1,1,0,0,1,0,14
300561305,12,0,0,0,0,4,1,17
300561306,51,1,0,0,0,1,10,63
300561307,18,3,0,0,0,3,4,28
300561308,30,4,0,0,0,0,10,44
300561309,6,2,0,0,0,0,2,10
300561310,24,3,0,0,0,5,7,39
300561401,49,13,0,0,0,4,13,79
300561402,10,0,0,0,0,1,4,15
300561403,17,3,1,0,0,3,0,24
300561404,15,3,1,0,0,1,3,23
300561405,18,1,0,0,1,1,2,23
300561406,221,15,3,5,1,9,9,263
300561501,172,5,4,1,1,2,8,193
300561502,200,20,2,4,0,5,5,236
300561503,215,13,0,5,3,0,11,247
300561504,197,12,7,6,0,2,4,228
300561505,146,10,9,6,2,0,3,176
300561506,206,6,2,8,0,2,8,232
300561507,278,14,2,10,1,1,11,317
300561508,158,10,3,0,1,0,3,175
300561509,252,13,7,8,0,1,8,289
300561510,105,8,1,6,0,0,4,124
300561511,255,18,0,20,0,3,5,301
300561512,238,24,5,10,0,1,10,288
300561513,280,23,2,9,0,9,8,331
300561601,65,5,1,0,0,0,2,73
300561602,47,2,0,15,1,2,7,74
300561603,1,0,0,0,0,0,6,7
300561604,105,11,0,15,1,3,7,142
300561605,16,0,0,1,0,0,2,19
300561701,21,12,0,0,0,0,1,34
300561702,64,3,0,0,0,0,26,93
300561703,154,6,2,9,0,1,9,181
300561704,257,14,7,7,6,2,3,296
300561705,244,12,1,4,0,2,7,270
300561706,127,10,1,2,0,3,4,147
300561707,218,23,3,10,1,0,17,272
300561708,173,11,0,3,0,1,2,190
300561709,165,16,3,4,3,0,5,196
300561710,152,9,2,4,0,1,1,169
300561711,171,13,0,5,0,0,4,193
300561712,171,16,1,4,0,0,3,195
300561801,33,0,0,0,0,8,12,53
300561802,10,1,0,0,0,0,1,12
300561803,8,0,0,0,0,1,0,9
300561804,29,25,0,0,0,1,0,55
300561805,25,9,0,1,0,9,0,44
300561806,19,1,0,0,0,14,2,36
300561807,16,2,0,2,0,4,4,28
300561808,63,9,0,1,2,57,1,133
300561809,77,16,65,18,5,170,6,357
300561810,146,34,10,18,3,50,18,279
300561811,181,27,14,14,2,34,23,295
300561812,124,24,37,20,4,53,20,282
300561813,92,13,12,18,0,34,5,174
300561814,87,16,11,13,0,57,4,188
300561815,17,4,2,10,0,59,3,95
300630101,30,10,0,1,1,9,25,76
300630102,23,0,0,0,0,1,1,25
300630103,100,5,0,2,0,9,26,142
300630104,43,2,7,5,0,10,14,81
300630105,33,3,0,0,0,10,6,52
300630106,11,0,0,0,0,0,7,18
300630107,48,3,0,1,0,0,70,122
300630108,41,1,2,0,0,41,19,104
300630109,6,0,0,0,0,5,9,20
300630110,260,28,2,14,1,1,7,313
300630111,241,14,1,4,0,9,14,283
300630201,37,13,0,0,0,0,3,53
300630202,15,15,0,0,2,0,0,32
300630203,63,19,2,0,0,0,5,89
300630204,265,20,2,2,0,3,13,305
300630205,321,26,3,3,1,5,4,363
300630206,285,31,1,4,3,7,12,343
300630207,266,49,3,7,1,1,6,333
300630301,43,15,0,0,0,6,7,71
300630302,17,13,0,0,0,3,0,33
300630303,28,1,0,0,0,0,1,30
300630304,174,38,0,9,1,1,20,243
300630401,3,1,0,0,0,0,0,4
300630402,1,0,0,0,0,0,3,4
300630403,6,0,0,0,0,0,2,8
300630404,5,6,0,0,0,0,10,21
300630405,13,5,0,0,1,0,0,19
300630406,49,0,0,1,0,4,1,55
300630407,13,1,0,0,0,0,4,18
300630408,16,3,0,0,0,0,0,19
300630409,14,1,0,1,0,0,3,19
300630410,1,0,0,0,0,0,1,2
300630411,3,5,0,0,0,0,1,9
300630412,178,17,0,5,1,0,9,210
300630413,256,35,0,10,1,6,32,340
300630501,23,8,0,0,0,1,4,36
300630502,39,1,0,0,0,0,8,48
300630503,8,0,0,0,0,0,3,11
300630504,32,15,0,0,0,3,1,51
300630505,73,24,0,0,3,5,4,109
300630506,7,0,0,0,0,0,5,12
300630507,31,9,0,0,1,0,6,47
300630508,121,16,0,3,3,28,23,194
300630509,52,4,0,0,0,72,27,155
300630510,9,2,0,0,0,1,5,17
300630511,13,0,0,1,0,8,9,31
300630512,48,27,0,0,0,6,0,81
300630513,4,0,0,0,0,8,20,32
300630514,1,5,0,0,0,3,3,12
300700101,98,19,0,3,4,1,9,134
300700102,160,16,8,0,13,1,2,200
300700103,145,21,14,0,7,1,22,210
300700104,163,4,10,4,0,3,9,193
300700105,180,6,4,1,2,1,6,200
300700106,241,4,0,15,0,1,4,265
300700107,203,13,2,0,4,3,12,237
300700108,224,22,6,3,1,2,13,271
300700109,248,29,11,5,5,1,9,308
300700110,180,13,3,3,2,1,3,205
300700111,197,15,1,1,0,2,8,224
300700112,169,13,6,3,2,1,3,197
300700113,270,10,2,7,1,1,5,296
300700114,360,20,1,4,0,0,10,395
300700115,311,7,3,0,0,0,17,338
300700201,254,13,3,10,2,3,8,293
300700202,196,17,2,5,0,0,3,223
300700203,237,3,0,0,0,1,5,246
300700204,216,12,1,3,1,0,11,244
300700205,155,12,1,1,0,1,2,172
300700206,245,3,1,2,0,0,3,254
300700207,134,4,0,3,0,0,1,142
300700208,139,9,0,0,0,0,4,152
300700209,205,18,0,0,0,0,2,225
300700210,214,7,0,0,0,0,3,224
300700301,5,0,0,0,0,0,1,6
300700302,59,4,0,1,1,6,3,74
300700303,229,15,2,5,1,1,8,261
300700304,226,18,3,9,3,8,9,276
300700305,107,3,0,0,2,12,13,137
300700306,39,1,0,4,0,2,15,61
300700307,52,9,0,0,0,1,1,63
300700308,237,9,12,6,0,2,11,277
300700309,122,9,8,8,0,12,0,159
300700310,268,22,3,2,0,18,1,314
300700311,148,13,8,25,1,26,3,224
300700312,70,6,0,1,0,2,2,81
300700313,29,2,0,0,0,0,8,39
300700314,9,0,0,0,0,0,0,9
300700401,54,2,0,0,0,2,0,58
300700402,33,3,0,0,1,1,3,41
300700403,5,9,0,0,0,0,0,14
300700404,15,0,0,0,0,0,8,23
300700405,25,16,0,0,0,0,0,41
300700406,87,0,0,0,0,0,0,87
300700407,43,1,0,0,0,0,2,46
300700408,68,4,0,0,0,2,5,79
300700409,31,0,0,0,0,0,1,32
300700410,3,1,0,0,0,0,1,5
300700411,49,7,1,0,0,1,1,59
300700412,14,1,0,0,0,0,3,18
300700413,35,2,0,1,0,4,13,55
300700414,37,4,0,0,0,2,0,43
300700415,58,7,0,0,0,0,0,65
300700416,20,1,0,0,0,2,4,27
300700501,36,11,0,0,0,3,0,50
300700502,31,4,0,0,0,1,1,37
300700503,36,1,0,0,0,0,12,49
300700504,10,0,0,0,0,1,4,15
300700505,45,2,0,1,0,1,6,55
300700506,41,4,0,0,0,1,13,59
300700507,39,5,0,0,0,5,3,52
300700508,7,12,0,0,0,0,0,19
300700509,24,1,0,0,0,0,11,36
300700510,131,18,0,1,0,1,8,159
300700511,196,15,0,3,1,1,4,220
300700601,8,0,1,0,0,0,3,12
300700602,11,3,0,0,0,0,1,15
300700603,10,1,0,0,0,0,0,11
300700604,20,0,0,0,0,0,11,31
300700605,5,0,0,0,0,0,1,6
300700606,6,0,0,0,0,0,0,6
300700607,19,0,0,0,0,0,0,19
300700608,67,4,0,1,0,0,3,75
300700609,25,2,0,0,0,5,0,32
300700701,54,12,0,0,0,1,3,70
300700702,15,1,0,0,0,1,1,18
300700703,49,1,0,0,0,0,3,53
300700704,20,1,0,0,0,2,5,28
300700705,29,6,0,0,0,0,5,40
300700706,46,10,0,0,0,4,0,60
300700801,13,1,0,0,0,3,2,19
300700802,11,0,0,0,0,3,0,14
300700803,26,3,0,0,0,5,5,39
300700804,16,0,0,0,0,0,2,18
300700805,16,0,0,0,0,1,3,20
300700806,21,9,0,0,0,0,1,31
300700807,15,3,0,0,0,5,8,31
300700808,11,0,0,0,0,0,0,11
300700809,12,1,0,0,0,1,1,15
300700810,131,12,1,1,0,0,5,150
300700901,33,9,0,0,0,1,1,44
300700902,10,1,0,0,1,3,0,15
300700903,68,3,0,1,0,2,4,78
300700904,28,9,0,0,0,3,1,41
300700905,23,4,0,0,0,3,6,36
300700906,5,0,0,0,0,1,6,12
300700907,63,5,1,1,0,3,8,81
300700908,30,21,1,2,0,1,2,57
300700909,76,8,0,4,0,0,1,89
300701001,1,0,0,0,0,0,1,2
300701002,9,1,1,0,0,2,2,15
300701003,91,8,1,1,0,2,11,114
300701004,192,7,0,4,0,0,9,212
300701005,202,14,2,0,1,0,6,225
300701006,123,6,1,1,0,0,3,134
300701007,152,10,0,2,3,2,11,180
300701008,302,18,2,2,0,2,12,338
300701009,268,8,3,5,0,0,9,293
300701010,292,28,2,3,12,0,28,365
300701011,186,10,0,0,0,0,4,200
300701101,190,6,3,1,6,0,8,214
300701102,157,9,4,3,0,4,9,186
300701103,208,17,1,4,1,0,10,241
300701104,302,22,3,3,0,1,14,345
300701105,143,8,0,2,0,0,2,155
300701106,334,20,5,1,1,6,1,368
300701107,221,6,0,0,0,0,2,229
300701108,211,15,1,0,0,0,0,227
300701109,210,8,1,1,0,7,21,248
300701110,337,6,5,5,0,5,4,362
300701111,301,10,1,3,0,1,13,329
300701112,87,8,0,3,0,3,8,109
300701201,83,16,0,0,0,12,0,111
300701202,21,2,0,0,0,6,1,30
300701203,20,1,0,0,0,0,0,21
300701204,68,10,1,3,0,1,5,88
300701205,25,2,0,0,0,0,0,27
300701206,27,4,0,0,0,2,5,38
300701207,39,6,0,0,0,0,8,53
300701208,23,7,0,0,0,0,3,33
300701209,34,3,0,0,0,0,4,41
300701210,21,0,0,0,0,0,0,21
300701211,0,0,0,0,0,1,1,2
300701212,80,9,2,14,1,26,12,144
300701213,304,19,5,12,1,7,13,361
300701301,66,19,0,1,0,0,9,95
300701302,93,5,1,1,1,3,9,113
300701303,25,21,0,0,0,0,1,47
300701304,44,4,0,0,0,4,7,59
300701305,12,3,0,0,0,0,0,15
300701306,16,0,0,0,0,0,0,16
300701307,22,1,0,0,0,2,2,27
300701308,57,1,0,5,0,1,3,67
300701309,168,23,1,5,0,0,8,205
300701310,114,10,3,1,0,1,6,135
300701311,169,18,0,0,0,0,8,195
300701312,152,11,4,1,1,1,6,176
300701401,12,5,0,0,0,0,2,19
300701402,17,2,0,0,0,0,1,20
300701403,14,0,0,0,0,0,0,14
300701404,16,0,0,0,0,0,1,17
300701405,289,12,1,2,0,0,13,317
300701406,212,5,4,0,0,0,4,225
300701407,202,14,0,1,0,0,11,228
300701408,235,4,0,1,0,4,4,248
300701409,211,5,3,4,0,2,1,226
300701410,199,17,0,1,0,0,2,219
300701411,364,12,2,1,0,0,5,384
300701412,244,7,0,6,0,0,7,264
300701413,311,9,0,4,0,2,2,328
300701501,3,2,0,0,0,1,0,6
300770101,117,1,0,8,0,2,11,139
300770102,266,14,4,3,0,2,3,292
300770103,176,9,1,2,0,2,1,191
300770104,194,23,2,2,0,0,7,228
300770105,220,10,3,12,0,1,6,252
300770106,186,6,0,5,2,5,10,214
300770107,212,23,3,4,0,0,5,247
300770108,182,17,2,2,0,2,6,211
300770109,222,17,7,3,1,2,3,255
300770110,328,22,3,5,1,5,8,372
300770111,147,13,7,1,3,6,1,178
300770112,98,5,1,0,0,0,1,105
300770113,300,29,6,3,5,2,8,353
300770114,273,17,6,4,7,2,3,312
300770115,233,15,7,3,4,2,2,266
300770201,221,19,4,6,0,0,6,256
300770202,283,28,2,3,0,2,6,324
300770203,128,6,0,4,1,3,3,145
300770204,201,23,3,2,2,2,1,234
300770205,214,27,4,0,9,1,17,272
300770206,185,18,1,6,3,1,5,219
300770207,232,21,2,3,3,3,14,278
300770208,202,16,4,1,2,1,4,230
300770209,188,7,1,0,0,0,0,196
300770210,242,10,2,2,1,1,12,270
300770211,238,25,7,7,1,1,6,285
300770212,101,7,0,2,0,1,4,115
300770213,260,19,3,3,0,0,3,288
300770214,182,14,0,6,0,0,1,203
300770215,208,11,0,2,0,3,5,229
300770216,306,6,3,1,0,0,1,317
300770217,109,1,1,1,0,3,0,115
300770301,18,0,0,0,0,0,0,18
300770302,75,6,1,2,0,1,6,91
300770303,19,2,0,1,0,1,1,24
300770304,83,11,0,0,0,0,0,94
300770305,100,2,0,9,2,13,10,136
300770306,76,2,0,0,0,2,3,83
300770401,13,0,0,0,0,0,6,19
300770402,20,4,0,0,0,0,1,25
300770403,36,8,1,0,0,0,5,50
300770404,27,2,0,0,0,1,0,30
300770405,49,5,0,0,0,0,6,60
300770406,27,0,0,0,0,0,4,31
300770407,28,0,0,0,0,2,1,31
300770408,35,2,0,1,0,0,3,41
300770409,15,0,0,0,1,3,2,21
300770410,31,0,0,0,0,3,15,49
300770411,25,4,0,0,0,2,3,34
300770412,15,0,0,0,0,0,4,19
300770413,1,2,0,0,0,0,0,3
300770414,40,2,0,1,0,3,11,57
300770415,23,2,0,0,0,0,2,27
300770416,32,5,0,0,0,0,0,37
300770417,15,0,0,0,0,1,0,16
300770501,32,2,1,1,0,2,8,46
300770502,5,4,0,0,0,0,2,11
300770503,23,1,0,0,0,0,0,24
300770504,18,2,0,0,0,2,0,22
300770505,46,4,0,0,0,0,5,55
300770506,39,2,0,1,0,0,7,49
300770507,41,3,0,0,0,1,3,48
300770508,19,5,0,0,0,0,7,31
300770509,7,1,0,0,0,0,0,8
300770510,32,0,0,0,0,2,7,41
300770511,10,0,0,0,0,0,3,13
300770512,5,0,0,0,0,3,6,14
300770513,28,5,0,0,0,0,0,33
300770514,33,1,0,0,0,0,4,38
300770515,20,1,0,0,0,0,8,29
300770516,50,2,0,0,0,0,0,52
300770517,29,0,0,0,0,0,1,30
300770518,20,0,0,0,0,0,2,22
300770519,7,0,0,0,0,0,7,14
300770601,46,1,0,0,0,1,0,48
300770602,11,0,0,0,0,1,3,15
300770603,40,0,0,0,0,1,5,46
300770604,5,1,0,0,0,1,2,9
300770605,45,1,0,0,0,4,12,62
300770606,38,1,0,0,0,0,6,45
300770607,33,0,0,0,0,2,6,41
300770608,14,3,0,0,0,0,10,27
300770609,17,0,0,1,0,0,11,29
300770610,30,6,0,0,0,6,4,46
300770611,19,0,0,0,0,8,6,33
300770612,95,5,4,0,0,5,10,119
300770613,5,1,0,0,0,0,0,6
300770701,46,1,0,0,0,2,3,52
300770702,30,0,0,0,0,2,9,41
300770703,16,3,0,0,0,0,0,19
300770704,18,12,0,0,0,0,0,30
300770705,24,7,0,0,0,3,0,34
300770706,232,9,5,11,0,6,13,276
300770707,254,9,1,0,1,0,20,285
300770708,9,0,0,0,0,0,7,16
300770709,25,1,0,0,0,6,7,39
300770710,20,4,0,0,0,1,5,30
300770711,7,0,0,0,0,0,9,16
300770801,88,9,0,4,0,3,5,109
300770802,140,7,1,0,0,3,19,170
300770803,146,26,2,3,0,1,13,191
300770804,167,14,6,1,8,0,13,209
300770805,31,3,0,0,0,0,3,37
300770806,61,14,0,0,1,2,1,79
300770807,6,7,0,1,0,0,0,14
300770901,21,0,0,0,0,0,4,25
300770902,10,0,0,0,0,7,5,22
300770903,25,0,0,0,0,4,3,32
300770904,46,16,1,0,0,7,13,83
300770905,8,4,0,0,0,2,2,16
300770906,93,11,1,0,1,22,28,156
300770907,20,0,0,0,0,2,5,27
300770908,23,1,0,0,0,2,7,33
300771001,27,7,0,0,0,0,4,38
300771002,31,0,0,0,0,1,9,41
300771003,14,0,0,0,0,0,4,18
300771004,9,2,0,0,0,2,9,22
300771005,13,1,0,0,0,0,7,21
300771006,4,0,0,0,0,0,2,6
300771101,33,0,0,5,1,25,5,69
300771102,20,0,0,0,0,11,5,36
300771103,59,4,0,2,0,2,20,87
300771104,23,0,0,0,0,0,0,23
300771105,20,0,0,0,0,1,2,23
300771106,8,0,1,2,0,1,3,15
300771107,3,1,0,0,0,0,2,6
300771108,20,0,0,0,0,2,2,24
300771109,26,0,0,0,0,3,4,33
300771110,33,1,0,0,1,1,8,44
300771111,25,0,0,0,0,1,12,38
300771112,35,8,3,0,0,1,0,47
300771113,35,4,0,0,0,3,1,43
300771114,31,5,0,0,0,0,1,37
300771115,20,12,0,0,0,0,0,32
300771201,294,19,4,9,0,3,24,353
300771202,121,11,0,5,1,3,6,147
300771203,196,13,1,5,2,9,4,230
300771204,194,9,5,5,4,0,8,225
300771205,195,12,3,1,1,0,11,223
300771206,169,2,3,7,0,10,20,211
300771207,235,14,3,5,0,6,11,274
300771208,35,5,0,0,0,1,7,48
300771209,29,1,0,0,0,0,6,36
300771210,13,1,0,0,0,1,5,20
300771211,10,1,0,0,0,0,2,13
300771212,11,7,0,0,0,1,2,21
300771213,2,0,0,0,0,0,2,4
300840101,266,4,0,2,0,1,17,290
300840102,243,0,0,1,0,0,6,250
300840103,104,0,0,3,0,15,14,136
300840104,289,1,2,4,0,0,3,299
300840105,268,10,5,11,1,4,10,309
300840106,176,7,1,0,0,4,5,193
300840107,178,7,0,2,0,0,9,196
300840108,365,19,1,5,0,1,4,395
300840109,113,6,0,2,0,2,3,126
300840110,176,10,0,0,0,0,1,187
300840111,337,9,0,2,0,0,6,354
300840112,300,6,2,3,2,1,9,323
300840113,322,14,0,1,0,0,3,340
300840114,387,16,1,2,1,0,5,412
300840201,206,9,1,0,0,0,14,230
300840202,168,30,8,1,15,0,5,227
300840203,228,19,8,2,5,1,17,280
300840204,192,38,19,6,9,2,5,271
300840205,321,48,17,6,21,1,22,436
300840206,185,25,9,2,6,1,10,238
300840207,168,13,5,0,2,1,12,201
300840208,276,3,0,0,1,0,4,284
300840209,224,18,20,4,5,0,16,287
300840210,126,27,5,4,19,0,4,185
300840211,191,21,8,3,8,1,8,240
300840212,247,42,11,2,70,8,34,414
300840213,248,68,10,5,58,5,19,413
300840214,144,23,2,0,19,0,3,191
300840215,248,23,2,0,8,0,8,289
300840216,288,11,4,1,2,0,12,318
300840217,251,22,23,0,6,0,7,309
300840218,238,31,12,1,6,0,3,291
300840219,204,33,6,0,11,10,8,272
300840220,201,34,17,1,20,2,14,289
300840221,202,27,13,2,39,8,10,301
300840222,163,29,32,2,46,6,15,293
300840223,166,78,9,0,21,2,3,279
300840224,154,62,32,2,21,0,19,290
300840301,310,25,18,8,4,4,10,379
300840302,288,8,2,1,1,0,2,302
300840303,225,8,3,1,13,2,12,264
300840304,220,23,4,1,1,0,7,256
300840305,388,17,12,1,5,0,0,423
300840306,258,34,13,2,15,2,7,331
300840307,209,30,5,2,8,2,26,282
300840308,213,39,10,1,8,2,6,279
300840309,259,60,20,2,16,1,12,370
300840310,293,33,13,1,6,0,6,352
300840311,252,14,12,6,13,0,12,309
300840312,201,20,11,5,2,0,9,248
300840313,154,20,32,1,19,1,7,234
300840314,303,22,28,7,27,4,9,400
300840315,141,18,7,1,1,1,11,180
300840316,186,28,9,4,2,0,2,231
300840317,214,24,9,6,9,1,7,270
300840318,412,81,16,5,16,1,13,544
300840319,105,23,14,1,5,0,21,169
300840320,217,50,4,4,16,2,10,303
300840321,170,34,16,0,29,1,17,267
300840322,109,35,4,0,31,1,11,191
300840323,164,39,14,1,27,0,20,265
300840401,298,1,1,5,0,6,6,317
300840402,247,8,2,2,0,0,1,260
300840403,112,0,4,5,0,19,5,145
300840404,336,3,16,1,5,0,13,374
300840405,270,10,2,4,0,0,4,290
300840406,198,8,5,4,1,0,6,222
300840407,172,5,3,1,0,0,3,184
300840408,226,10,2,0,0,1,4,243
300840409,315,19,3,3,1,0,11,352
300840410,235,2,1,1,0,0,8,247
300840411,369,3,0,1,1,1,4,379
300840412,283,7,4,10,3,3,5,315
300840413,218,16,4,1,0,1,8,248
300840414,279,5,3,0,1,1,4,293
300840415,378,12,5,1,0,0,3,399
300840416,341,9,2,2,1,0,8,363
300840417,324,19,7,3,9,0,10,372
300840418,262,12,7,1,0,0,3,285
300840419,137,5,2,2,0,0,4,150
300840420,212,8,2,0,0,0,2,224
300840421,234,16,4,6,3,0,3,266
300840501,343,18,5,6,2,0,14,388
300840502,235,14,0,2,5,0,15,271
300840503,229,8,3,1,0,0,2,243
300840504,322,16,3,0,1,0,5,347
300840505,469,35,4,8,1,0,5,522
300840506,194,9,1,1,0,1,4,210
300840507,220,3,0,0,0,0,12,235
300840508,285,11,7,5,1,0,3,312
300840509,181,10,4,4,0,0,7,206
300840510,222,8,1,5,1,1,6,244
300840511,168,16,3,1,0,0,2,190
300840512,316,11,2,0,0,0,7,336
300840513,209,6,0,1,0,0,2,218
300840514,355,11,0,1,0,0,11,378
300840515,194,6,0,0,0,0,5,205
300840516,351,21,5,6,0,0,1,384
300840517,265,9,5,4,0,4,6,293
300840518,227,6,6,2,2,0,7,250
300840519,205,16,7,3,0,0,3,234
300840520,250,13,2,2,0,2,10,279
300840521,202,12,7,7,5,0,4,237
300840522,333,39,2,0,3,0,5,382
300840523,345,26,5,2,5,0,11,394
300840524,324,24,3,0,3,0,20,374
300840601,323,8,31,3,10,1,19,395
300840602,104,35,5,0,1,1,2,148
300840603,184,6,25,1,5,0,12,233
300840604,297,54,2,0,2,0,6,361
300840605,205,68,16,0,11,2,7,309
300840606,190,29,15,1,18,1,13,267
300840607,178,41,13,10,5,1,5,253
300840608,318,28,15,1,14,0,9,385
300840609,133,9,7,2,4,6,11,172
300840610,78,23,3,0,3,0,6,113
300840611,115,8,1,2,1,0,2,129
300840612,233,45,9,0,3,0,15,305
300840613,159,17,10,2,4,0,3,195
300840614,165,23,13,0,2,0,11,214
300840615,258,19,2,0,6,0,30,315
300840616,283,19,2,2,2,0,8,316
300840617,276,23,7,4,11,1,16,338
300840618,240,44,32,15,24,0,12,367
300840619,273,17,6,0,19,0,12,327
300840620,330,26,15,6,9,0,7,393
300840621,262,26,2,2,5,0,8,305
300840622,212,6,4,2,1,0,8,233
300840623,263,13,12,2,4,1,11,306
300840701,281,13,6,5,4,0,23,332
300840702,240,17,15,3,12,0,12,299
300840703,109,27,13,1,5,1,4,160
300840704,92,22,4,1,6,3,3,131
300840705,147,26,6,3,23,0,7,212
300840706,201,32,12,0,5,0,4,254
300840707,150,31,4,0,2,0,11,198
300840708,304,35,8,1,17,0,27,392
300840709,367,16,6,1,6,1,3,400
300840710,313,18,8,3,16,0,23,381
300840711,352,38,15,3,1,4,22,435
300840712,312,29,10,4,3,0,23,381
300840713,302,0,0,0,1,0,5,308
300840714,351,2,4,0,0,0,6,363
300840715,298,29,14,2,0,0,7,350
300840801,187,5,3,4,1,1,5,206
300840802,289,16,3,0,3,0,4,315
300840803,189,7,1,1,0,0,3,201
300840804,316,16,5,0,0,0,5,342
300840805,368,14,12,3,1,1,3,402
300840806,287,21,2,2,3,0,1,316
300840807,317,22,0,2,0,0,12,353
300840808,177,11,5,2,2,0,7,204
300840809,226,16,2,1,0,0,6,251
300840810,284,6,1,1,2,0,5,299
300840811,289,8,2,1,4,1,8,313
300840812,233,4,6,0,0,0,3,246
300840813,8,0,0,0,0,0,0,8
300840814,296,18,10,2,2,1,5,334
300840815,286,18,1,2,0,0,1,308
300840816,267,6,1,1,0,0,5,280
300840817,256,20,1,3,0,0,2,282
300840818,334,10,6,4,0,3,11,368
300840819,350,14,7,2,0,0,16,389
300840820,303,10,3,0,0,0,9,325
300840821,368,25,2,6,0,1,8,410
300840822,336,24,6,12,1,0,2,381
300840823,169,12,3,10,1,2,6,203
300840901,309,42,17,1,4,0,7,380
300840902,275,2,4,1,3,1,23,309
300840903,135,8,2,0,5,0,3,153
300840904,280,31,3,2,5,1,8,330
300840905,153,5,2,5,0,0,5,170
300840906,227,12,5,14,0,1,4,263
300840907,424,10,4,5,3,0,9,455
300840908,131,5,1,0,1,0,0,138
300840909,318,10,6,1,2,0,5,342
300840910,230,13,2,1,3,0,6,255
300840911,294,20,13,7,0,0,11,345
300840912,260,5,3,1,0,0,6,275
300840913,354,14,5,0,3,0,3,379
300840914,289,13,10,1,5,0,7,325
300840915,131,2,1,3,1,0,3,141
300840916,250,11,11,2,0,0,1,275
300840917,351,21,2,11,1,0,6,392
300841001,268,20,4,1,2,0,9,304
300841002,246,5,3,2,1,0,5,262
300841003,257,10,2,0,3,0,9,281
300841004,173,10,3,2,0,0,8,196
300841005,200,15,5,1,1,1,1,224
300841006,180,27,62,3,2,0,8,282
300841007,240,9,13,0,1,0,3,266
300841008,293,15,8,2,2,0,9,329
300841009,300,20,2,0,1,0,7,330
300841010,212,7,6,1,1,0,5,232
300841011,281,13,5,10,0,0,1,310
300841012,230,17,1,4,1,0,0,253
300841013,219,13,6,1,0,0,3,242
300841014,340,16,9,8,1,1,7,382
300841015,307,17,6,0,0,0,5,335
300841016,197,8,3,1,1,0,7,217
300841017,318,24,10,2,1,0,4,359
300841018,254,17,1,1,0,1,4,278
300841019,153,7,7,12,0,1,4,184
300841020,318,18,2,2,1,0,8,349
300841021,275,10,4,5,6,1,6,307
300841101,106,10,0,0,0,0,0,116
300841102,236,8,2,2,0,1,9,258
300841103,310,11,1,10,3,0,6,341
300841104,238,4,2,0,0,0,6,250
300841105,118,10,2,0,2,0,0,132
300841106,275,14,1,2,0,0,6,298
300841107,323,7,5,4,0,0,9,348
300841108,234,8,1,2,0,0,3,248
300841109,70,2,0,0,0,0,0,72
300841110,386,5,3,0,0,0,5,399
300841111,262,15,1,9,4,2,6,299
300841112,186,12,1,3,0,2,3,207
300841113,157,7,0,1,1,0,7,173
300841114,303,20,0,7,0,11,7,348
300841201,79,4,4,24,0,4,6,121
300841202,179,11,1,12,0,2,10,215
300841203,46,5,0,0,0,16,1,68
300841204,48,0,1,23,0,7,1,80
300841205,220,7,4,2,1,9,6,249
300841206,65,2,0,7,1,17,6,98
300841207,228,22,13,1,2,1,14,281
300841208,55,8,0,2,0,24,0,89
300841209,54,6,1,3,0,6,7,77
300841210,133,5,0,6,0,5,1,150
300841211,168,5,1,7,1,3,1,186
300841212,7,0,1,0,10,0,0,18
300841301,271,7,3,7,1,1,9,299
300841302,188,10,5,5,0,1,7,216
300841303,44,1,0,0,0,0,5,50
300841304,181,0,0,10,0,3,5,199
300841305,41,2,0,0,0,0,1,44
300841306,157,8,0,9,1,1,9,185
300841307,157,5,0,11,0,0,9,182
300841401,251,14,2,2,0,0,10,279
300841402,354,29,4,3,1,0,6,397
300841403,293,9,4,9,2,2,5,324
300841404,324,15,6,7,0,1,5,358
300841405,290,12,2,8,3,1,6,322
300841406,383,8,1,8,0,0,8,408
300841407,365,25,7,18,4,0,9,428
300841408,234,15,5,1,10,0,8,273
300841409,280,10,3,3,2,0,8,306
300841410,259,20,8,10,1,0,5,303
300841411,297,22,2,3,4,1,2,331
300841412,340,17,1,5,2,1,6,372
300841413,156,2,0,6,0,1,1,166
300841414,323,15,11,8,0,1,5,363
300841415,121,1,1,1,3,0,4,131
300841416,289,12,2,3,0,1,6,313
300841417,326,12,4,6,1,5,7,361
300841501,260,4,5,4,1,0,10,284
300841502,134,17,1,1,0,0,2,155
300841503,394,25,3,2,0,2,6,432
300841504,268,15,0,0,0,0,5,288
300841505,138,2,3,0,0,2,2,147
300841506,284,17,1,0,0,1,1,304
300841507,344,3,1,0,1,0,0,349
300841508,343,12,1,3,0,1,11,371
300841509,190,12,0,102,1,1,0,306
300841510,252,10,5,6,1,0,2,276
300841511,158,3,0,0,1,0,2,164
300841512,327,11,0,0,0,0,1,339
300841513,4,0,0,0,0,1,0,5
300841601,281,9,7,1,0,1,5,304
300841602,228,9,6,5,4,1,6,259
300841603,286,9,9,8,0,0,5,317
300841604,220,7,3,5,0,0,2,237
300841605,192,13,4,3,1,0,3,216
300841606,275,10,3,2,2,2,5,299
300841607,313,6,7,2,1,0,7,336
300841608,335,15,3,4,2,0,4,363
300841609,235,10,0,9,3,0,6,263
300841610,274,14,5,16,1,4,3,317
300841611,313,11,7,12,5,3,6,357
300841701,111,0,0,1,1,0,0,113
300841702,257,7,0,0,0,0,2,266
300841703,245,11,3,1,2,0,3,265
300841704,262,19,14,4,7,0,5,311
300841705,224,10,2,2,2,0,11,251
300841706,151,4,4,0,0,0,4,163
300841707,342,14,4,2,9,1,5,377
300841708,251,11,0,6,0,0,2,270
300841709,258,9,1,1,0,0,1,270
300841710,281,14,0,0,0,0,1,296
300841711,244,10,0,0,0,0,4,258
300841712,214,3,2,1,0,0,8,228
300841713,271,9,5,0,3,1,5,294
300841714,373,18,2,2,0,0,5,400
300841715,239,4,0,0,1,0,0,244
300841716,202,1,0,1,0,0,3,207
300841717,197,2,0,1,0,0,8,208
300841718,171,3,0,0,0,0,0,174
300841719,336,13,0,3,0,0,9,361
300841801,28,3,1,1,0,4,1,38
300841802,255,7,4,11,0,1,7,285
300841803,125,13,5,2,0,6,6,157
300841804,94,11,0,2,0,3,6,116
300841901,26,6,0,0,0,1,5,38
300841902,10,2,0,0,0,0,0,12
300841903,4,0,0,0,0,0,195,199
300841904,4,0,0,0,0,1,204,209
300841905,154,17,1,5,1,0,3,181
300841906,118,5,3,5,1,6,5,143
300841907,80,1,0,1,0,8,7,97
300841908,15,0,0,195,0,0,3,213
300841909,103,2,1,12,0,0,7,125
300841910,143,10,2,7,0,1,3,166
300841911,128,13,4,1,1,29,5,181
300841912,49,1,4,9,0,94,4,161
300842001,10,3,0,0,0,2,1,16
300842002,71,2,0,3,0,57,4,137
300842003,56,6,1,2,0,29,2,96
300842004,46,3,0,6,0,0,10,65
300842005,24,2,0,8,0,35,1,70
300842006,24,10,0,8,0,19,11,72
300842007,26,12,0,4,4,23,8,77
300842101,307,8,2,14,0,3,2,336
300842102,117,5,1,6,0,8,8,145
300842103,153,4,3,4,1,0,6,171
300842104,152,6,1,2,0,0,10,171
300842105,110,6,0,4,0,2,1,123
300842106,438,19,3,10,0,5,10,485
300842107,227,5,4,7,3,1,11,258
300842108,247,5,3,3,0,3,13,274
300842201,156,4,4,15,2,2,36,219
300842202,125,6,2,5,1,2,5,146
300842203,54,10,0,2,0,1,3,70
300842204,93,5,2,15,0,4,1,120
300842205,72,0,2,10,0,0,1,85
300842206,207,4,3,3,0,2,10,229
300842207,37,4,0,1,2,4,4,52
300842208,20,0,0,0,0,2,1,23
300842301,7,1,0,0,0,0,0,8
300842302,67,6,1,3,1,2,3,83
300842303,5,1,0,1,0,0,3,10
300842304,19,5,0,2,12,8,11,57
300842305,208,15,7,26,0,10,2,268
300842306,242,26,9,14,1,1,9,302
300842307,154,21,20,11,1,6,7,220
300842308,313,53,13,3,0,0,10,392
300842309,277,34,15,14,5,8,11,364
300842310,229,47,51,29,1,1,15,373
300842311,52,0,2,16,0,19,3,92
300842401,46,1,0,1,1,2,5,56
300842402,23,8,0,0,0,2,7,40
300842403,66,5,0,0,0,0,6,77
300842404,36,3,0,1,0,3,1,44
300842405,51,5,0,0,1,1,9,67
300842406,31,3,0,0,1,0,1,36
300842407,74,9,1,1,0,4,7,96
300842408,14,7,0,0,0,0,0,21
300842409,233,16,3,4,1,6,17,280
300842501,6,2,0,0,0,0,1,9
300842502,7,1,0,0,0,1,0,9
300842503,39,10,0,3,0,0,1,53
300842504,36,3,0,0,0,1,4,44
300842505,32,1,0,2,0,2,10,47
300842506,207,6,0,0,0,0,1,214
300842507,241,20,0,2,3,10,7,283
300842508,325,12,5,6,5,6,4,363
300842509,267,13,0,4,0,8,4,296
300842510,215,14,11,4,3,6,4,257
300842511,228,27,4,6,7,9,11,292
300842512,82,6,0,5,0,3,0,96
300842601,7,0,0,0,0,0,4,11
300842602,6,5,0,0,0,0,0,11
300842603,6,5,0,0,0,0,0,11
300842604,11,0,0,0,0,5,0,16
300842605,14,1,0,0,0,2,2,19
300842606,10,0,0,0,1,2,5,18
300842607,26,4,0,0,0,0,8,38
300842608,13,0,0,0,0,3,3,19
300842609,50,5,0,0,0,2,8,65
300842610,30,8,0,0,0,1,1,40
300842611,18,11,0,0,0,0,0,29
300842612,19,0,0,0,0,0,8,27
300842613,34,4,0,0,0,0,2,40
300842614,9,9,0,0,0,2,1,21
300842615,108,7,0,0,1,48,5,169
300842616,98,9,3,2,3,21,4,140
300842701,18,0,0,0,0,0,5,23
300842702,22,1,0,4,0,5,3,35
300842703,202,14,8,10,0,2,2,238
300842704,278,16,8,8,3,2,6,321
300842705,271,14,5,3,5,2,11,311
300842706,111,4,1,4,0,0,0,120
300842707,306,21,3,8,1,1,7,347
300842708,222,9,1,2,0,1,4,239
300842801,87,5,0,1,0,1,2,96
300842802,8,0,0,0,0,0,5,13
300842803,24,11,0,0,0,0,0,35
300842804,6,0,0,0,0,0,10,16
300842805,17,2,0,0,0,1,3,23
300842806,22,1,0,0,0,0,4,27
300842807,10,0,0,0,0,1,5,16
300842808,21,1,0,0,0,0,10,32
300842809,25,1,0,0,0,0,0,26
300842810,18,1,0,0,0,3,4,26
300842811,14,0,0,0,0,0,1,15
300842812,24,5,0,0,0,0,0,29
300842813,19,0,0,0,0,2,0,21
300842901,6,0,0,0,1,2,2,11
300842902,9,1,0,0,0,2,3,15
300842903,12,3,0,0,0,0,0,15
300842904,12,0,0,0,0,1,1,14
300842905,7,0,0,0,0,0,6,13
300842906,11,0,0,0,0,0,3,14
300842907,4,1,0,0,0,0,1,6
300842908,2,0,0,0,0,0,4,6
300842909,12,0,0,0,0,0,9,21
300842910,197,2,0,4,1,0,14,218
300843001,24,2,0,2,0,2,1,31
300843002,49,1,1,0,0,1,6,58
300843003,23,2,0,1,0,1,2,29
300843004,7,2,0,0,0,0,3,12
300843005,77,3,2,0,0,0,2,84
300843006,206,14,4,3,1,0,2,230
300843007,194,9,12,3,1,0,4,223
300843008,146,12,4,21,0,3,8,194
300843009,138,4,4,0,1,2,8,157
300843010,119,5,2,5,1,0,11,143
300843011,148,15,5,4,0,4,4,180
300843012,272,18,7,5,2,6,6,316
300843013,221,12,8,12,0,0,1,254
300843014,57,0,0,3,0,1,8,69
300843101,21,0,0,0,0,0,4,25
300843102,34,5,0,0,0,7,3,49
300843103,12,2,0,0,0,2,2,18
300843104,5,0,0,0,0,0,0,5
300843105,16,0,0,0,0,0,7,23
300843106,13,3,0,0,0,2,3,21
300843107,55,20,0,0,0,2,1,78
300843108,14,5,0,0,0,1,0,20
300843109,30,17,0,0,1,1,2,51
300843110,28,0,0,0,2,3,5,38
300843111,13,5,0,0,0,0,2,20
300843112,35,1,0,0,0,2,4,42
300843113,28,0,0,0,0,0,17,45
300843114,16,0,0,0,0,0,8,24
300843115,97,2,3,6,0,53,24,185
300843116,107,8,0,1,0,5,12,133
300843201,22,1,0,0,0,4,2,29
300843202,62,11,0,1,1,5,2,82
300843203,42,2,0,0,0,5,4,53
300843204,46,3,0,0,0,0,13,62
300843205,108,6,0,0,0,7,13,134
300843206,92,5,0,1,2,17,5,122
300843207,68,1,0,0,0,13,14,96
300843208,33,0,0,0,0,9,4,46
300843209,157,6,1,1,0,14,9,188
300843210,31,9,0,0,0,2,0,42
300843211,42,1,17,4,1,76,32,173
300843212,97,41,4,4,0,109,9,264
300843213,77,32,5,1,1,46,14,176
300843301,10,2,0,0,0,0,0,12
300843302,24,2,1,0,0,5,1,33
300843303,16,7,0,0,0,0,0,23
300843304,7,0,0,2,1,111,0,121
300843305,86,1,1,8,0,6,7,109
300843306,300,16,3,4,1,1,14,339
300843307,324,16,4,8,0,5,16,373
300843308,375,27,4,5,4,1,50,466
300843309,214,7,3,12,0,1,7,244
300843310,98,13,3,2,0,3,3,122
300843311,124,12,2,0,3,0,4,145
300843312,216,10,9,3,1,1,5,245
300843313,215,18,7,5,0,4,7,256
300843314,317,19,9,7,0,1,18,371
300843401,4,0,0,0,0,1,1,6
300843402,16,1,0,0,0,2,5,24
300843403,8,3,0,0,0,0,5,16
300843404,12,0,0,0,0,6,4,22
300843405,11,1,0,0,0,6,3,21
300843406,0,0,0,0,0,1,1,2
300843407,49,4,0,1,0,1,10,65
300843408,49,0,0,2,0,6,11,68
300843409,17,3,0,0,0,0,7,27
300843410,17,0,0,0,0,0,14,31
300843411,14,1,0,0,0,2,2,19
300843412,47,4,0,1,0,1,1,54
300843413,22,10,0,0,0,0,0,32
300843414,32,5,1,1,0,0,7,46
300843415,75,2,0,0,0,1,2,80
300843416,145,5,0,5,1,4,27,187
300843501,12,1,0,0,0,1,3,17
300843502,13,0,0,0,0,2,2,17
300843503,18,0,0,0,0,0,0,18
300843504,8,0,0,0,0,3,4,15
300843505,16,0,0,0,0,3,17,36
300843506,124,9,1,0,0,0,3,137
300843507,117,5,0,4,1,0,2,129
300843508,135,4,0,7,0,1,11,158
300843601,16,2,0,1,0,3,5,27
300843602,20,0,0,0,0,2,1,23
300843603,26,3,0,0,0,0,3,32
300843604,19,0,0,0,1,1,0,21
300843701,183,11,3,5,0,0,1,203
300843702,147,18,2,5,0,0,4,176
300843703,114,6,2,6,0,1,4,133
300843704,355,23,3,2,1,1,1,386
300843705,181,4,2,4,5,3,7,206
300843706,212,15,0,1,0,0,3,231
300843707,182,12,6,0,0,0,9,209
300843708,130,4,6,4,2,2,4,152
300843709,142,3,0,0,0,3,1,149
300843710,205,5,0,2,0,0,2,214
300843711,247,7,3,5,0,0,16,278
300843712,168,4,0,1,0,0,5,178
300843713,142,5,0,0,0,0,47,194
300843714,261,7,3,2,0,0,3,276
300843715,22,1,1,0,0,0,3,27
300843801,4,4,0,0,0,0,0,8
300843802,14,0,0,0,0,7,4,25
300843803,14,0,0,0,0,0,0,14
300843804,15,2,0,0,0,0,0,17
300843805,33,2,0,0,0,1,9,45
300843806,12,4,0,0,0,1,0,17
300843807,25,0,0,0,0,4,2,31
300843808,26,4,0,0,0,3,2,35
300843809,14,3,0,0,0,0,7,24
300843901,35,1,0,1,0,11,20,68
300843902,26,0,0,0,0,8,11,45
300843903,51,0,0,0,0,2,13,66
300843904,35,0,0,0,0,14,2,51
300843905,9,0,0,0,0,0,2,11
300843906,7,0,0,0,0,2,9,18
300843907,14,0,0,0,0,0,16,30
300843908,30,2,1,0,0,0,6,39
300843909,26,2,0,0,0,1,3,32
300844001,48,1,0,0,0,0,0,49
300844002,22,0,0,0,0,0,18,40
300844003,23,0,0,0,0,1,4,28
300844004,50,6,0,1,0,1,8,66
300844005,24,6,0,0,0,1,2,33
300844006,13,0,0,0,0,0,4,17
300844007,27,2,0,0,0,0,0,29
300844008,40,0,1,0,0,4,4,49
300844009,41,0,0,1,0,0,1,43
300844101,7,0,0,0,0,0,7,14
300844102,15,0,0,0,0,0,10,25
300844103,19,0,0,0,0,0,6,25
300844104,18,1,0,0,0,0,7,26
300844105,282,10,4,4,2,1,8,311
300844106,270,9,4,9,0,2,6,300
300844107,2,0,0,3,0,0,0,5
300844108,316,18,6,7,3,2,13,365
300844109,199,11,6,3,3,2,9,233
300844110,153,10,0,12,0,4,6,185
300844201,8,4,0,0,0,1,0,13
300844202,45,1,0,0,0,1,15,62
300844203,16,0,0,0,0,6,3,25
300844204,48,10,0,0,0,2,11,71
300844205,14,0,0,0,0,0,0,14
300844206,10,0,0,0,0,0,5,15
300844207,22,0,0,0,0,0,11,33
300844208,19,0,0,0,0,0,1,20
300844209,41,3,0,0,0,0,1,45
300844301,321,15,2,16,0,0,8,362
300844302,190,5,2,4,0,2,3,206
300844303,243,19,5,5,1,1,7,281
300844304,201,19,5,4,3,0,5,237
300844305,255,24,3,2,3,0,14,301
300844306,262,18,6,2,2,0,2,292
300844307,268,17,1,4,0,0,3,293
300844308,203,10,2,3,0,1,9,228
300844309,361,16,8,6,0,2,15,408
300844310,144,8,3,9,0,0,7,171
300844311,186,9,1,0,0,0,4,200
300844312,201,3,0,1,1,0,2,208
300844313,184,6,2,1,0,0,0,193
300844401,285,18,1,0,2,0,6,312
300844402,85,4,6,3,0,0,4,102
300844403,358,18,3,7,0,1,1,388
300844404,343,17,4,4,2,0,4,374
300844405,138,11,1,1,0,0,5,156
300844406,193,10,3,0,0,0,11,217
300844407,290,30,3,3,2,1,5,334
300844408,284,13,3,20,0,3,8,331
300844409,132,6,1,0,0,0,75,214
300844410,262,11,6,2,0,1,5,287
300844411,204,7,2,8,0,0,2,223
300844501,33,0,0,0,0,0,6,39
300844502,30,3,1,0,0,0,1,35
300844503,39,6,1,2,0,0,0,48
300844504,49,4,0,0,0,1,1,55
300844505,50,3,0,0,0,1,0,54
300844506,33,1,0,1,1,0,2,38
300844507,141,8,7,12,0,2,0,170
300844508,124,5,0,14,0,1,4,148
300844509,55,3,0,10,0,0,2,70
300844510,120,3,5,1,0,0,3,132
300844511,33,3,0,11,0,0,1,48
300844601,17,2,0,0,0,8,1,28
300880101,259,10,2,0,0,2,1,274
300880102,267,21,4,7,3,1,5,308
300880103,352,22,5,13,3,1,16,412
300880104,241,14,3,8,3,0,4,273
300880105,221,13,5,0,2,1,1,243
300880106,270,23,8,2,1,0,8,312
300880107,222,10,5,6,0,1,1,245
300880201,52,5,1,1,0,2,4,65
300880202,38,7,0,2,0,9,8,64
300880203,51,0,0,0,0,0,3,54
300880204,256,14,3,3,0,0,37,313
300880205,375,13,2,3,1,3,14,411
300880206,327,7,5,7,0,1,2,349
300880207,314,21,2,3,0,3,1,344
300880208,307,20,2,15,0,0,3,347
300880209,189,12,0,4,0,3,6,214
300880210,107,2,1,0,0,0,2,112
300880301,129,16,0,1,0,1,4,151
300880302,12,1,0,0,0,1,2,16
300880303,6,0,0,0,0,1,2,9
300880304,101,8,0,0,0,0,6,115
300880305,152,7,0,1,0,0,7,167
300880306,228,16,0,0,0,2,6,252
300880307,159,7,4,4,4,2,11,191
300880308,154,5,7,1,0,4,4,175
300880401,5,0,0,0,0,0,1,6
300880402,23,0,0,0,0,1,6,30
300880403,8,2,0,0,0,1,0,11
300880404,15,0,0,0,0,0,6,21
300880405,33,0,1,0,0,2,6,42
300880501,20,0,0,0,0,2,2,24
300880502,5,3,0,0,0,0,1,9
300880503,14,3,0,0,0,2,0,19
300880504,23,6,0,0,0,0,0,29
300880601,2,6,0,0,0,2,0,10
300880602,11,2,0,0,0,0,1,14
300880603,7,1,0,1,0,1,1,11
300880604,11,12,0,0,0,0,1,24
300880605,1,9,0,0,0,0,1,11
300880606,8,0,0,0,0,0,1,9
300880701,33,3,0,1,0,1,1,39
300880702,17,1,0,0,0,10,3,31
300880703,7,0,0,0,0,1,3,11
300880704,23,9,0,0,0,0,3,35
300880705,4,4,0,0,0,0,0,8
300880706,21,1,0,0,0,1,5,28
300880707,30,3,0,2,0,1,3,39
300910101,268,11,0,5,0,0,8,292
300910102,287,15,4,0,2,1,12,321
300910103,372,26,2,2,0,0,15,417
300910104,241,27,8,2,3,0,6,287
300910105,195,10,3,0,1,1,6,216
300910106,185,19,5,3,5,1,6,224
300910107,177,12,0,4,0,1,4,198
300910108,245,13,2,7,0,0,21,288
300910109,278,12,7,42,1,5,12,357
300910110,180,18,1,8,0,0,7,214
300910111,190,13,1,2,1,4,9,220
300910112,165,13,1,4,2,4,5,194
300910113,203,16,1,4,0,5,7,236
300910114,55,7,1,2,1,2,5,73
300910115,171,18,0,7,0,1,2,199
300910116,317,17,1,4,0,3,12,354
300910117,196,19,3,10,0,1,10,239
300910118,236,5,2,13,0,1,7,264
300910201,9,0,0,0,0,0,4,13
300910202,10,0,0,0,0,3,4,17
300910203,51,5,1,0,0,0,9,66
300910204,25,2,0,0,0,1,9,37
300910205,46,1,0,5,2,40,13,107
300910206,6,0,0,0,0,0,2,8
300910207,50,0,0,1,0,2,13,66
300910208,102,8,2,12,1,9,13,147
300910209,20,0,0,0,0,4,3,27
300910301,15,0,0,0,0,3,1,19
300910302,95,21,0,0,0,7,10,133
300910303,20,0,1,1,0,3,0,25
300910304,60,11,0,0,0,0,1,72
300910305,28,1,0,0,0,0,3,32
300910306,31,2,0,0,0,0,8,41
300910307,49,4,2,0,0,6,5,66
300910308,9,0,0,0,0,2,1,12
300910309,24,0,0,2,0,8,9,43
300910401,1,0,0,0,0,0,1,2
300910402,16,0,0,1,0,3,4,24
300910403,37,1,0,1,0,6,4,49
300910404,37,4,0,0,0,1,6,48
300910405,17,11,0,0,0,0,7,35
300910406,11,0,0,0,0,0,8,19
300910407,13,0,0,0,0,0,4,17
300910501,215,6,2,9,0,7,17,256
300910502,250,27,0,4,1,4,9,295
300910503,226,6,3,4,1,5,12,257
300910504,229,9,1,1,1,2,11,254
300910505,138,5,2,1,5,2,3,156
300910506,294,29,7,7,11,3,11,362
300910507,258,17,5,8,0,9,18,315
300910508,221,12,4,9,1,0,12,259
300910509,55,4,0,0,0,1,4,64
300910510,25,0,0,1,0,3,4,33
300910511,11,4,0,0,0,0,0,15
300910512,11,3,0,0,0,0,0,14
300910601,18,4,0,0,0,0,3,25
300910602,11,12,0,0,0,0,2,25
300910603,6,0,0,0,0,0,0,6
300910604,18,0,0,0,0,1,1,20
300910605,9,0,0,0,1,2,5,17
300910606,155,14,3,2,2,7,27,210
300910701,14,3,0,0,0,0,10,27
300910702,74,0,1,2,0,11,13,101
300910703,18,0,0,0,0,0,10,28
300910704,5,1,0,0,0,6,1,13
300910705,7,0,0,0,0,4,2,13
300910706,6,7,0,0,0,0,4,17
300910801,13,1,0,0,0,4,3,21
300910802,17,1,0,0,0,1,12,31
300910803,11,0,0,0,0,3,1,15
300910804,5,1,0,0,0,5,0,11
300910805,10,0,0,0,0,0,2,12
300910806,8,0,0,0,0,1,2,11
300910807,9,0,0,0,0,3,9,21
300910808,65,8,0,3,0,2,13,91
300910901,14,1,0,0,0,1,2,18
300910902,5,0,0,0,0,0,0,5
300910903,35,6,0,0,0,6,11,58
300910904,9,2,0,0,0,0,1,12
300910905,23,3,0,0,0,0,0,26
300910906,4,2,0,0,0,0,0,6
300911001,134,14,1,2,2,10,4,167
300911002,188,13,3,2,3,6,12,227
300911003,170,13,3,1,1,7,13,208
300911004,201,15,5,1,2,5,12,241
300911005,89,7,1,1,0,8,18,124
300911101,9,2,0,0,0,5,2,18
300911102,16,0,0,0,0,0,8,24
300911103,12,0,0,1,0,0,5,18
300911104,7,2,0,0,0,1,8,18
300911105,50,10,0,0,1,8,14,83
300911106,22,11,0,0,0,2,1,36
300980101,321,5,0,1,1,0,8,336
300980102,258,6,1,6,1,0,17,289
300980103,221,4,0,4,1,0,10,240
300980104,252,21,5,6,1,1,10,296
300980105,261,16,5,1,0,0,7,290
300980106,339,20,5,14,0,3,6,387
300980107,213,18,4,7,1,1,1,245
300980108,242,3,2,4,1,3,16,271
300980109,337,32,10,3,2,5,2,391
300980110,313,28,8,5,2,2,9,367
300980111,286,10,1,5,2,0,8,312
300980112,330,20,4,7,2,0,22,385
300980113,365,21,3,7,3,0,5,404
300980114,207,12,2,3,3,0,8,235
300980115,254,12,3,3,5,0,5,282
300980116,404,9,2,4,0,0,10,429
300980117,280,8,1,3,2,0,1,295
300980118,235,20,3,3,1,1,4,267
300980119,214,9,4,2,1,2,2,234
300980120,156,14,1,2,0,1,5,179
300980201,278,5,5,5,0,0,3,296
300980202,296,18,8,5,1,1,7,336
300980203,281,5,11,1,2,1,6,307
300980204,286,26,7,2,9,3,11,344
300980205,306,19,19,5,16,1,26,392
300980206,140,13,1,2,3,0,6,165
300980207,204,11,3,2,0,1,5,226
300980208,267,19,10,2,0,2,2,302
300980209,291,6,3,3,3,0,6,312
300980210,237,10,9,5,2,2,4,269
300980211,321,8,2,6,1,2,3,343
300980212,318,6,4,5,0,15,16,364
300980213,206,7,2,1,1,0,5,222
300980214,273,10,1,4,4,2,1,295
300980215,230,12,9,1,0,0,5,257
300980301,158,11,2,1,1,2,2,177
300980302,200,20,5,4,22,0,3,254
300980303,332,60,21,4,18,2,10,447
300980304,320,48,5,0,6,1,13,393
300980305,280,38,1,17,16,0,10,362
300980306,202,18,3,4,5,1,5,238
300980307,229,39,12,5,33,2,7,327
300980308,205,45,9,2,20,0,11,292
300980309,195,27,2,8,9,2,13,256
300980310,186,30,8,4,10,2,3,243
300980311,55,10,1,0,0,0,11,77
300980312,174,33,7,1,6,1,12,234
300980313,132,23,2,2,20,1,10,190
300980314,191,20,6,10,3,2,9,241
300980315,142,21,1,1,1,2,2,170
300980316,268,28,12,4,1,2,5,320
300980317,135,21,1,0,1,0,2,160
300980318,213,23,5,0,17,1,7,266
300980401,174,5,2,6,0,2,6,195
300980402,204,0,3,0,1,0,2,210
300980403,251,1,5,2,0,1,4,264
300980404,177,3,2,1,0,0,8,191
300980405,148,23,7,1,6,1,5,191
300980406,183,49,10,7,14,2,5,270
300980407,135,6,0,2,5,1,16,165
300980408,179,18,7,1,4,2,7,218
300980409,200,17,4,3,6,1,4,235
300980410,262,6,3,5,3,1,10,290
300980411,253,14,3,3,0,1,7,281
300980412,208,8,0,3,0,0,6,225
300980413,293,9,5,5,0,3,3,318
300980414,242,16,4,5,0,0,3,270
300980415,170,23,10,2,2,1,6,214
300980416,216,21,4,1,0,0,2,244
300980417,229,33,12,1,2,0,7,284
300980418,245,13,9,6,1,0,6,280
300980419,156,11,1,6,0,1,1,176
300980420,159,34,11,7,0,1,14,226
300980421,174,18,5,1,1,18,6,223
300980501,60,5,4,2,1,4,21,97
300980502,144,1,0,2,0,47,6,200
300980503,47,10,0,4,1,24,0,86
300980504,233,10,1,3,0,0,3,250
300980505,26,3,0,1,0,4,1,35
300980506,244,8,1,1,0,0,4,258
300980507,222,21,0,3,0,0,2,248
300980508,306,15,0,1,1,0,5,328
300980509,352,16,2,0,1,0,2,373
300980510,246,24,4,3,1,1,5,284
300980511,321,22,0,2,0,4,7,356
300980512,254,6,1,2,1,0,0,264
300980513,222,8,0,1,0,0,2,233
300980514,67,2,4,3,0,9,7,92
300980601,11,1,0,0,1,0,0,13
300980602,55,12,7,1,2,6,4,87
300980603,84,9,2,2,3,15,18,133
300980604,36,12,0,0,0,0,20,68
300980605,223,7,2,4,0,5,3,244
300980606,346,18,2,7,0,1,19,393
300980607,264,8,3,2,0,0,3,280
300980608,330,23,2,3,2,1,6,367
300980609,128,2,1,1,0,0,2,134
300980610,225,5,0,3,3,0,4,240
300980611,309,19,2,10,0,3,10,353
300980612,34,5,2,0,1,6,4,52
300980613,33,4,0,0,0,1,6,44
300980614,66,14,1,1,2,13,3,100
300980701,363,21,4,13,2,2,15,420
300980702,90,6,0,6,0,1,1,104
300980703,245,13,1,6,0,0,2,267
300980704,186,14,3,2,0,0,4,209
300980705,86,7,2,8,0,0,1,104
300980706,169,24,3,3,1,2,1,203
300980707,276,15,1,1,4,1,12,310
300980708,187,22,5,3,1,0,15,233
300980709,205,10,2,0,0,0,6,223
300980710,193,18,7,7,0,0,7,232
300980711,171,9,1,3,0,1,10,195
300980712,148,8,4,1,0,0,3,164
300980713,196,13,1,4,0,0,4,218
300980714,173,9,0,0,0,1,2,185
300980715,218,9,2,2,0,0,5,236
300980716,102,9,0,1,0,0,1,113
300980801,12,1,0,0,0,1,1,15
300980802,14,0,0,0,0,0,0,14
300980803,6,1,0,0,0,0,1,8
300980804,12,2,0,0,0,0,0,14
300980805,21,0,0,6,0,8,3,38
300980901,10,11,0,0,0,1,3,25
300980902,9,3,0,0,0,3,0,15
300980903,135,12,1,0,0,0,28,176
300980904,1,1,0,0,0,0,4,6
300980905,7,2,0,1,0,0,5,15
300980906,47,3,0,0,0,7,8,65
300980907,112,20,0,3,0,0,3,138
300980908,101,1,3,2,5,4,8,124
300980909,22,7,0,0,0,7,1,37
300980910,33,0,0,0,0,6,13,52
300980911,12,0,0,0,0,2,8,22
300980912,75,10,0,2,0,4,6,97
300980913,82,12,0,1,0,5,19,119
300980914,54,5,0,0,0,0,11,70
300980915,18,3,0,0,0,7,2,30
300980916,13,7,0,0,0,0,0,20
300980917,19,0,0,0,0,0,2,21
300981001,222,36,7,11,0,12,4,292
300981002,216,29,2,5,1,29,9,291
300981003,38,17,0,1,0,3,3,62
300981004,24,0,0,3,0,5,10,42
300981005,47,7,0,0,0,0,0,54
300981006,11,0,0,0,0,1,2,14
300981007,7,5,0,0,0,0,0,12
300981101,117,14,2,0,3,0,17,153
300981102,117,12,0,2,0,2,2,135
300981103,126,18,6,4,0,3,1,158
300981104,97,11,0,3,0,0,1,112
300981105,16,1,0,0,0,6,5,28
300981106,10,1,0,0,0,4,3,18
300981201,10,0,0,1,0,1,3,15
300981202,6,0,0,0,0,3,0,9
300981203,13,10,0,0,0,5,5,33
300981204,6,0,0,0,0,2,5,13
300981205,8,0,0,0,0,6,3,17
300981206,7,0,0,0,0,1,7,15
300981301,12,0,0,1,0,0,0,13
300981302,2,0,0,0,0,1,0,3
300981303,14,0,0,0,2,4,0,20
300981304,5,0,0,0,0,0,7,12
300981305,13,4,0,0,1,0,1,19
300981306,23,0,0,0,0,0,0,23
300981307,43,3,0,1,0,0,6,53
300981308,16,1,0,0,0,2,0,19
300981309,140,7,1,5,0,0,6,159
300981310,153,6,5,2,4,2,15,187
300981311,130,5,5,3,0,1,3,147
300981312,58,2,0,0,0,3,7,70
300981313,21,4,0,0,0,0,0,25
300981314,18,2,0,0,0,2,1,23
300981401,34,6,0,0,0,0,4,44
300981402,32,18,0,0,0,1,0,51
300981403,37,2,0,0,0,0,9,48
300981404,6,0,0,0,0,0,5,11
300981405,240,20,3,2,0,3,14,282
300981406,37,4,0,0,0,0,5,46
300981407,26,0,1,0,0,0,2,29
300981408,14,2,0,0,0,0,11,27
300981409,320,18,7,4,4,2,18,373
300981410,92,9,1,0,0,0,6,108
300981411,94,16,0,0,1,2,7,120
300981412,20,1,0,0,0,8,1,30
300981413,48,4,0,0,0,8,1,61
300981414,51,0,0,0,0,2,4,57
300981415,27,0,0,0,0,0,3,30
300981416,34,0,0,0,0,0,0,34
300981501,35,1,0,0,0,1,0,37
300981502,81,2,1,3,0,2,12,101
300981503,248,5,0,4,1,0,7,265
300981504,133,13,0,4,0,1,3,154
300981505,33,2,0,0,1,2,5,43
300981506,19,2,0,0,0,0,1,22
300981507,39,0,0,1,0,5,7,52
300981508,44,4,0,1,0,0,3,52
300981509,56,3,2,0,1,0,0,62
300981510,146,7,7,5,8,0,11,184
300981511,195,14,4,5,2,1,4,225
300981512,124,5,3,2,0,2,2,138
300981513,118,9,4,9,0,0,7,147
300981514,13,2,0,0,0,0,0,15
300981515,16,0,0,0,0,0,9,25
300981516,31,5,1,3,0,3,5,48
300981601,5,2,0,0,0,0,0,7
300981602,10,2,0,0,0,1,8,21
300981603,50,7,0,0,0,0,2,59
300981604,48,2,0,0,0,8,9,67
300981605,86,5,0,0,0,1,3,95
300981606,40,0,0,1,0,4,6,51
300981701,28,2,0,1,0,2,4,37
300981702,103,10,0,0,0,0,3,116
300981703,101,0,0,2,1,6,6,116
300981704,108,8,1,3,1,10,11,142
300981705,31,6,0,0,0,2,0,39
300981706,11,0,1,0,0,0,4,16
300981707,13,6,0,0,0,2,0,21
300981708,23,0,0,1,0,0,5,29
300981709,24,0,0,0,0,0,2,26
300981801,3,0,0,0,0,40,3,46
300981802,12,2,0,0,0,0,0,14
301050101,194,11,0,1,0,1,7,214
301050102,153,5,0,47,0,1,7,213
301050103,174,21,1,3,0,5,7,211
301050104,253,20,4,6,0,5,2,290
301050105,124,14,0,3,0,1,2,144
301050106,113,11,0,1,0,0,5,130
301050107,217,24,5,2,1,1,10,260
301050108,234,19,2,1,1,0,8,265
301050109,162,21,1,3,2,0,3,192
301050110,249,18,5,4,4,5,3,288
301050111,138,20,6,2,2,0,1,169
301050112,157,22,4,2,13,1,8,207
301050201,138,20,2,2,1,4,8,175
301050202,207,8,0,4,0,2,7,228
301050203,216,14,2,4,0,0,4,240
301050204,173,22,5,1,2,5,9,217
301050205,184,20,5,7,1,3,3,223
301050206,200,22,2,2,0,4,6,236
301050207,208,9,1,3,3,5,7,236
301050208,197,7,2,13,3,6,11,239
301050209,260,17,5,10,1,2,9,304
301050210,239,21,15,0,35,3,30,343
301050211,165,12,4,3,3,4,7,198
301050212,200,12,5,2,12,0,13,244
301050213,189,7,6,4,0,5,5,216
301050301,247,31,2,7,1,20,5,313
301050302,35,6,19,12,0,7,11,90
301050303,364,46,8,8,2,10,16,454
301050304,231,17,1,5,0,1,19,274
301050305,185,20,4,5,3,4,16,237
301050306,278,24,17,5,1,3,38,366
301050307,219,16,8,0,0,1,8,252
301050308,239,18,7,8,9,3,6,290
301050309,204,17,14,11,1,11,7,265
301050310,234,33,5,1,0,3,9,285
301050401,114,20,6,0,5,0,2,147
301050402,131,27,4,2,13,1,10,188
301050403,193,19,3,1,1,1,21,239
301050404,256,6,7,5,0,2,17,293
301050405,160,23,2,3,0,4,18,210
301050406,280,31,8,5,6,9,12,351
301050407,181,15,1,9,2,1,4,213
301050408,83,7,1,8,0,2,7,108
301050409,232,31,2,7,1,24,5,302
301050410,310,17,1,10,0,14,8,360
301050501,66,22,0,0,1,0,1,90
301050502,15,0,0,0,0,6,1,22
301050503,61,16,2,34,0,14,15,142
301050504,60,23,4,3,0,12,1,103
301050601,38,0,0,0,0,2,6,46
301050602,24,0,0,0,0,1,7,32
301050603,8,0,0,0,0,0,0,8
301050604,21,2,0,0,0,10,8,41
301050605,53,24,0,0,0,4,4,85
301050606,111,13,1,0,0,5,26,156
301050607,19,0,0,0,0,11,5,35
301050608,13,4,0,0,0,7,4,28
301050609,46,12,0,0,0,3,23,84
301050610,188,16,0,0,1,1,9,215
301050611,35,5,0,0,0,1,10,51
301050612,63,4,0,0,0,15,11,93
301050701,13,0,0,0,1,5,0,19
301050702,29,0,0,1,0,10,4,44
301050703,41,4,2,1,0,3,34,85
301050704,18,0,0,0,0,3,0,21
301050705,28,0,0,0,0,17,6,51
301050706,21,0,0,0,0,0,0,21
301050707,22,6,0,0,0,1,1,30
301050708,42,19,0,1,1,3,0,66
301050709,21,19,2,0,0,4,2,48
301050710,10,1,0,3,1,7,4,26
301050711,131,9,1,3,4,14,32,194
301050712,129,19,0,0,1,3,10,162
301050713,18,0,0,1,0,1,5,25
301050714,12,4,0,0,0,3,1,20
301050715,68,22,0,4,1,16,7,118
301050801,25,1,0,0,0,3,8,37
301050802,13,18,0,2,0,8,7,48
301050803,10,5,0,1,0,0,14,30
301050804,3,8,0,0,0,0,0,11
301050805,2,2,0,0,0,0,0,4
301050806,25,9,0,0,0,14,0,48
301050807,26,2,0,0,0,0,36,64
301050808,22,0,0,4,0,14,5,45
301050809,15,2,0,0,0,24,0,41
301050810,36,4,0,6,1,49,17,113
301050811,25,30,0,0,0,3,4,62
301050812,58,0,1,6,1,38,2,106
301130101,93,5,0,4,0,0,36,138
301130102,1,0,0,4,0,0,0,5
301130103,254,10,0,0,0,0,0,264
301130104,194,13,7,3,0,1,10,228
301130105,339,29,19,38,1,12,24,462
301130106,213,12,1,0,0,1,4,231
301130107,161,10,2,1,0,1,6,181
301130108,257,22,1,6,2,1,5,294
301130109,365,46,16,14,2,4,11,458
301130110,207,24,0,2,0,0,2,235
301130111,266,21,1,3,0,1,3,295
301130112,293,45,5,1,7,1,7,359
301130113,201,15,2,2,0,1,2,223
301130114,195,17,3,1,1,0,6,223
301130115,304,14,9,5,0,3,6,341
301130116,187,11,1,2,0,0,5,206
301130117,189,14,0,9,0,0,3,215
301130118,247,9,7,3,0,0,3,269
301130119,214,15,5,2,4,3,9,252
301130120,107,6,4,1,5,3,3,129
301130121,165,23,6,1,11,0,7,213
301130122,312,23,3,3,0,0,5,346
301130123,305,28,10,3,1,0,10,357
301130201,259,28,10,2,1,3,15,318
301130202,110,16,2,0,4,0,2,134
301130203,182,31,8,1,4,3,7,236
301130204,193,11,5,3,0,0,5,217
301130205,256,31,12,2,5,0,15,321
301130206,118,17,1,0,4,0,6,146
301130207,128,22,2,2,0,0,6,160
301130208,211,11,4,4,0,1,5,236
301130209,229,9,7,3,0,1,12,261
301130210,216,21,7,3,1,3,14,265
301130211,255,13,7,6,0,2,8,291
301130212,264,15,4,6,2,5,8,304
301130213,122,15,1,0,0,1,3,142
301130214,256,19,5,5,0,0,6,291
301130215,182,9,1,6,0,0,4,202
301130216,188,11,3,9,0,3,5,219
301130301,7,0,0,0,0,2,2,11
301130302,67,0,0,0,0,4,5,76
301130303,182,7,3,7,0,3,9,211
301130304,66,6,2,0,2,8,3,87
301130305,144,26,3,1,1,4,21,200
301130306,58,0,2,1,0,0,2,63
301130307,301,20,2,2,0,1,4,330
301130308,121,1,0,0,1,1,4,128
301130309,233,4,1,1,1,0,5,245
301130310,328,11,0,22,0,0,14,375
301130311,197,1,0,2,0,3,10,213
301130312,13,1,0,0,0,0,1,15
301130401,6,0,0,0,0,1,0,7
301130402,3,1,0,0,0,0,0,4
301130403,12,3,0,0,0,0,0,15
301130404,205,13,0,2,0,2,5,227
301130405,258,24,1,1,0,3,14,301
301130406,287,12,2,32,0,0,13,346
301130501,10,0,0,0,0,3,2,15
301130502,0,0,0,0,0,0,1,1
301130503,14,0,0,0,0,0,3,17
301130504,153,10,0,2,0,1,6,172
301130505,133,7,1,1,1,4,11,158
301130506,114,16,0,0,0,1,9,140
301130507,101,1,1,0,0,1,25,129
301130601,18,0,0,0,0,4,0,22
301130602,14,0,0,0,0,0,9,23
301130603,62,4,0,1,0,0,4,71
301130604,17,1,0,0,0,2,6,26
301130605,12,5,0,0,0,0,0,17
301130606,118,22,0,1,0,2,4,147
301130607,35,0,0,0,0,2,8,45
301130608,79,7,0,1,0,6,7,100
301130609,37,0,0,0,0,1,6,44
301130610,27,0,0,0,0,0,0,27
301130701,22,3,0,0,0,0,0,25
301130702,97,1,0,2,0,6,13,119
301130703,54,6,0,0,0,1,0,61
301130704,28,4,0,0,0,0,4,36
301130705,56,3,0,1,0,5,7,72
301130706,113,17,0,0,0,0,1,131
301130801,16,1,0,0,0,0,7,24
301130802,6,6,0,0,0,0,0,12
301130803,14,0,0,1,0,3,8,26
301130804,16,6,0,0,0,0,1,23
301130805,38,2,0,0,0,0,0,40
301130806,61,3,0,0,0,0,5,69
301130807,36,0,0,0,0,3,1,40
301130808,40,1,0,0,0,5,0,46
301130809,17,7,0,0,0,0,1,25
301130810,16,4,4,0,0,3,1,28
301130811,12,0,0,0,0,0,8,20
301130812,15,0,0,0,0,0,2,17
301130813,23,11,1,0,0,3,3,41
301130814,17,1,0,0,0,4,4,26
301130815,29,2,0,0,0,1,0,32
301130901,20,6,0,0,0,0,0,26
301130902,19,7,1,0,0,0,7,34
301130903,28,2,0,0,0,2,1,33
301130904,23,1,0,0,0,0,1,25
301130905,20,1,0,0,0,2,0,23
301130906,56,3,0,0,0,5,0,64
301130907,19,0,1,0,0,0,0,20
301130908,13,0,0,0,0,5,7,25
301131001,38,5,0,0,0,0,0,43
301131002,65,8,0,1,0,0,14,88
301131003,29,0,0,0,0,8,9,46
301131004,53,0,0,0,0,0,7,60
301131005,49,0,0,0,0,1,0,50
301131006,24,0,0,0,0,3,1,28
301131007,37,0,0,0,0,0,5,42
301131008,40,6,0,0,0,2,2,50
301131101,11,0,0,0,0,0,3,14
301131102,4,1,0,0,0,0,0,5
301131103,42,0,0,0,0,0,2,44
301131104,45,9,0,0,0,0,0,54
301131105,39,2,0,1,1,2,4,49
301131106,87,2,3,0,1,2,13,108
301131107,11,1,0,0,0,1,0,13
301131108,20,0,0,0,0,0,6,26
301131109,24,6,0,0,0,4,5,39
301131110,36,0,0,0,0,5,10,51
301131201,20,0,0,0,0,0,1,21
301131202,13,0,3,1,0,0,0,17
301131203,124,3,0,3,0,2,10,142
301131204,76,0,0,0,0,0,0,76
301131205,10,1,0,0,0,0,0,11
301131206,27,6,0,0,0,0,0,33
301131207,19,2,1,0,0,2,4,28
301131208,31,3,0,0,0,0,0,34
301131209,47,1,0,2,0,1,11,62
301131301,4,0,0,0,0,0,0,4
301131302,33,0,0,0,0,0,1,34
301131303,11,1,0,0,0,0,0,12
301131304,24,0,0,0,0,0,0,24
301131305,5,0,0,0,0,0,0,5
301131306,11,1,0,0,0,1,2,15
301131307,5,0,0,0,0,0,0,5
301131308,118,12,0,0,0,0,1,131
301131309,73,10,0,3,1,2,5,94
301131401,14,0,0,0,0,0,0,14
301131402,30,3,0,0,0,0,0,33
301131403,7,5,0,0,0,0,0,12
301131404,8,2,0,0,0,0,0,10
301131405,33,2,0,1,0,1,2,39
301131406,17,0,0,0,0,0,0,17
301131407,6,0,0,0,0,1,1,8
301131408,6,0,0,0,0,0,1,7
301131409,8,0,0,0,0,0,3,11
301131410,4,7,0,0,0,4,4,19
301131411,113,13,0,1,5,1,10,143
340070101,81,3,0,0,0,0,2,86
340070102,294,14,0,0,0,0,0,308
340070201,200,22,0,2,0,1,7,232
340070202,33,8,0,0,0,0,0,41
340070203,177,13,0,0,0,1,11,202
340070204,146,24,0,0,0,0,2,172
340070301,35,5,0,0,0,0,5,45
340070401,59,6,0,0,0,1,22,88
340070402,139,17,2,4,0,4,23,189
340070403,164,18,0,0,0,0,4,186
340070404,132,12,3,3,0,0,19,169
340070405,238,46,0,5,1,0,6,296
340070406,201,16,2,14,7,1,37,278
340070407,135,17,2,5,11,3,37,210
340070408,133,20,2,10,1,9,45,220
340070409,117,26,2,2,0,0,10,157
340070501,184,33,1,0,0,0,7,225
340070502,51,33,1,0,0,0,2,87
340070503,118,25,0,1,0,0,10,154
340070504,50,21,1,0,0,0,21,93
340070505,125,19,0,17,0,0,36,197
340070601,30,7,0,0,0,0,0,37
340070602,96,21,0,0,0,0,2,119
340070603,17,7,0,2,0,0,3,29
340070701,27,16,0,0,0,1,2,46
340070702,127,25,0,0,0,1,53,206
340070703,85,7,0,1,0,0,0,93
340070801,90,10,0,0,0,1,1,102
340140101,240,12,0,4,1,2,6,265
340140102,188,25,1,4,0,0,2,220
340140103,88,21,123,69,0,0,22,323
340140104,255,48,8,2,0,2,26,341
340140105,230,20,1,2,1,0,8,262
340140106,248,12,0,0,0,0,9,269
340140107,196,6,0,0,0,0,4,206
340140108,390,10,5,0,0,2,11,418
340140109,230,8,3,2,4,0,6,253
340140110,288,4,0,1,0,0,4,297
340140111,191,19,1,2,0,1,2,216
340140112,242,16,0,0,0,0,3,261
340140113,281,5,9,2,0,0,5,302
340140114,271,12,0,0,1,0,4,288
340140115,168,13,1,1,1,1,6,191
340140116,242,14,3,3,1,1,8,272
340140117,225,0,5,1,0,1,5,237
340140118,148,29,0,1,0,0,5,183
340140119,160,16,2,5,5,3,4,195
340140120,306,38,5,1,6,0,12,368
340140121,163,13,6,6,4,1,2,195
340140122,221,0,6,6,1,3,10,247
340140123,242,30,7,3,0,0,6,288
340140124,206,13,0,0,0,0,1,220
340140125,199,16,0,1,0,1,6,223
340140126,169,9,1,14,10,4,2,209
340140201,353,4,3,4,0,0,9,373
340140202,274,8,0,0,0,4,4,290
340140203,321,29,0,29,1,1,3,384
340140204,184,31,3,1,0,0,1,220
340140205,326,17,1,2,1,0,5,352
340140206,281,8,0,2,0,0,6,297
340140207,230,8,0,0,0,0,0,238
340140208,245,17,3,8,1,0,11,285
340140209,344,6,5,4,3,1,6,369
340140210,235,15,3,5,0,2,4,264
340140211,239,9,2,3,0,0,19,272
340140212,227,5,0,1,1,1,4,239
340140213,187,33,4,1,1,0,6,232
340140214,308,2,3,3,7,0,35,358
340140215,248,29,1,0,1,2,23,304
340140216,218,30,10,4,11,0,12,285
340140217,202,30,5,2,6,0,8,253
340140218,183,31,5,7,11,0,7,244
340140219,172,8,0,10,1,1,6,198
340140220,318,8,5,4,0,3,5,343
340140221,163,2,0,0,0,0,4,169
340140222,175,10,0,0,0,0,0,185
340140223,189,2,0,1,0,0,4,196
340140301,250,13,1,4,26,2,18,314
340140302,309,17,9,1,7,0,8,351
340140303,256,21,3,0,25,1,13,319
340140304,267,67,21,0,6,5,6,372
340140305,224,10,12,4,19,1,52,322
340140306,225,37,9,2,6,3,3,285
340140307,290,21,2,12,8,3,20,356
340140308,237,9,1,2,1,0,3,253
340140309,150,6,0,1,0,0,4,161
340140310,271,7,1,9,1,1,32,322
340140311,256,10,5,7,0,0,11,289
340140312,245,20,4,10,0,24,10,313
340140313,248,6,0,4,1,1,3,263
340140401,194,3,2,4,7,0,14,224
340140402,181,19,15,5,1,2,6,229
340140403,349,2,4,9,2,3,8,377
340140404,344,6,3,5,0,2,12,372
340140405,200,3,1,1,1,0,1,207
340140406,323,11,5,9,30,2,10,390
340140407,212,0,5,3,3,0,8,231
340140408,263,1,1,2,2,0,1,270
340140409,336,30,5,5,20,2,4,402
340140410,246,11,6,2,2,2,3,272
340140411,198,2,7,2,0,0,11,220
340140412,246,6,3,2,0,0,3,260
340140413,271,0,0,0,0,0,2,273
340140414,232,1,0,1,0,0,3,237
340140415,314,12,0,1,0,0,0,327
340140416,270,4,3,0,0,0,2,279
340140417,257,2,4,0,0,0,4,267
340140418,221,5,6,2,0,0,10,244
340140419,235,1,1,0,0,0,11,248
340140501,17,0,0,0,0,1,4,22
340140502,324,5,1,6,0,7,6,349
340140503,14,0,0,0,0,10,7,31
340140504,116,1,0,2,0,3,18,140
340140505,83,6,0,2,1,3,8,103
340140506,148,8,0,1,1,1,10,169
340140601,6,1,0,0,0,0,3,10
340140602,137,17,1,2,1,20,0,178
340140603,106,1,1,0,0,3,23,134
340140604,21,4,0,0,0,1,1,27
340140605,54,8,0,1,0,2,3,68
340140606,55,1,0,10,0,11,13,90
340140607,94,5,0,2,1,0,10,112
340140608,3,1,1,272,0,0,1,278
340140609,0,1,0,26,0,0,254,281
340140701,185,24,0,4,0,2,29,244
340140702,212,41,0,2,0,1,19,275
340140703,190,9,0,0,0,0,0,199
340140704,192,13,0,0,0,0,0,205
340140705,301,9,3,1,0,1,4,319
340140706,274,3,0,0,0,0,4,281
340140707,223,6,0,0,0,0,4,233
340140708,255,11,0,0,0,0,3,269
340140709,292,13,8,3,0,0,3,319
340140710,182,2,0,0,0,1,6,191
340140711,213,2,0,0,0,1,4,220
340140712,5,0,0,0,0,0,292,297
340140713,244,27,0,0,1,0,6,278
340140714,269,5,0,0,0,0,10,284
340140715,265,16,0,1,2,2,6,292
340140716,121,32,0,1,0,6,45,205
340140717,185,12,0,10,0,6,28,241
340140801,31,22,1,0,0,0,5,59
340140802,16,9,0,0,0,1,6,32
340140803,34,0,0,0,0,0,25,59
340140804,54,10,2,1,0,1,21,89
340140901,115,9,2,0,0,1,8,135
340140902,31,7,0,0,1,0,0,39
340141001,64,5,0,1,0,1,7,78
340141002,7,0,0,0,0,0,3,10
340141003,5,4,0,0,0,3,0,12
340141004,109,4,0,1,1,3,9,127
340141005,155,9,1,5,2,1,6,179
340141101,39,0,0,0,0,0,0,39
340141102,13,2,0,0,0,1,2,18
340141103,57,6,0,4,1,1,2,71
340141104,108,16,1,2,0,2,10,139
340141201,54,1,0,0,0,4,9,68
340141301,47,3,0,0,0,3,4,57
340141302,7,2,0,0,0,0,0,9
340141401,36,7,2,0,0,1,8,54
340141402,51,9,1,0,0,2,6,69
340141403,161,10,0,0,1,1,27,200
340141404,97,11,0,0,0,1,2,111
340141501,325,25,0,5,2,3,8,368
340141502,215,14,0,0,0,1,0,230
340141503,202,47,0,7,0,0,11,267
340141504,374,21,0,1,0,0,0,396
340141505,230,12,0,0,0,0,1,243
340141506,251,28,0,0,0,0,3,282
340141507,356,18,1,0,1,0,5,381
340141508,325,18,8,6,0,3,13,373
340141509,254,7,0,1,0,0,1,263
340141510,167,5,0,0,0,0,3,175
340141511,83,1,0,0,0,0,1,85
340141512,281,22,1,5,3,0,6,318
340141513,287,6,3,2,0,1,5,304
340141514,327,19,3,7,0,0,14,370
340141515,178,6,0,5,1,0,1,191
340141516,257,9,4,7,1,1,5,284
340141517,345,31,1,0,0,0,4,381
340141518,272,7,0,0,0,0,3,282
340141519,199,10,1,0,0,0,2,212
340141520,159,7,2,6,0,0,13,187
340141521,189,1,0,0,0,0,5,195
340141522,209,14,1,0,1,0,0,225
340141523,221,17,0,2,0,1,3,244
340141524,201,11,2,0,3,1,7,225
340141525,276,35,0,3,0,0,10,324
340141526,188,16,0,0,0,3,11,218
340141527,206,17,0,6,1,0,7,237
340141528,228,12,1,4,0,0,5,250
340141601,190,19,0,3,0,1,6,219
340141602,344,16,1,5,0,0,2,368
340141603,172,9,0,0,0,1,1,183
340141604,200,8,0,2,0,0,3,213
340141605,294,15,0,2,0,1,8,320
340141606,301,11,1,1,0,0,10,324
340141607,205,5,0,2,0,1,3,216
340141608,333,12,6,5,1,4,4,365
340141609,227,8,0,3,8,1,10,257
340141610,244,7,0,0,0,0,3,254
340141611,242,15,3,0,1,0,6,267
340141612,208,12,0,0,0,0,1,221
340141613,227,18,0,0,0,0,7,252
340141614,190,11,0,1,0,1,4,207
340141615,227,12,1,0,0,0,1,241
340141616,276,3,0,3,0,0,10,292
340141617,199,6,0,0,0,1,16,222
340141618,108,2,0,0,0,0,2,112
340141619,209,17,0,0,0,0,1,227
340141620,241,9,0,0,0,0,1,251
340141621,289,11,0,1,1,3,12,317
340141622,307,15,2,1,0,0,10,335
340141623,264,7,0,1,0,2,8,282
340141624,201,9,0,1,4,0,1,216
340141625,206,10,0,1,0,0,1,218
340141626,215,9,1,0,0,0,3,228
340141627,161,15,0,8,0,0,3,187
340141628,167,7,5,1,5,0,7,192
340141701,159,10,0,2,0,1,0,172
340141702,109,2,0,2,2,4,4,123
340141703,231,9,0,0,1,0,5,246
340141704,208,12,0,0,0,0,7,227
340141705,362,11,0,0,0,0,10,383
340141706,181,10,0,0,1,0,8,200
340141707,118,3,0,0,0,0,8,129
340141708,217,4,3,0,0,1,1,226
340141709,190,13,0,0,0,0,0,203
340141710,201,9,0,0,0,1,2,213
340141711,218,11,0,0,0,1,5,235
340141712,148,7,0,3,0,0,9,167
340141713,109,0,0,0,0,2,0,111
340141714,256,16,1,0,1,0,7,281
340141715,186,5,0,0,0,0,1,192
340141716,323,21,1,3,0,0,11,359
340141717,229,14,1,1,1,2,11,259
340141801,9,4,0,0,0,0,0,13
340141802,6,1,0,0,0,1,0,8
340141901,32,2,0,0,0,0,0,34
340141902,4,0,0,0,0,0,0,4
340142001,37,9,0,0,0,0,0,46
340142002,218,10,0,0,0,0,15,243
340142003,18,0,0,1,0,1,1,21
340142004,255,10,0,10,1,0,9,285
340142005,14,4,0,0,0,1,1,20
340142006,224,14,2,1,0,14,8,263
340142007,40,12,0,0,0,0,2,54
340142008,5,0,0,0,0,0,0,5
340142009,17,0,0,0,0,3,0,20
340142010,2,0,0,0,0,2,1,5
340142011,26,11,0,0,0,0,1,38
340142012,21,1,2,2,0,1,1,28
340142013,264,26,5,10,1,2,8,316
340142014,215,4,2,13,1,3,11,249
340142015,312,10,4,6,1,2,19,354
340142016,238,18,0,3,0,2,1,262
340142017,222,30,0,2,0,3,5,262
340142018,177,20,0,0,0,0,0,197
340142019,188,7,1,0,0,0,4,200
340142020,178,18,0,2,0,1,8,207
340142021,0,0,0,5,0,0,163,168
340142022,1,0,0,0,0,0,311,312
340142023,310,17,3,4,0,1,3,338
340142024,181,14,2,3,3,1,4,208
340142025,259,36,2,11,5,0,15,328
340142026,249,1,0,9,0,1,27,287
340142027,302,9,1,2,1,0,18,333
340142101,88,1,0,0,1,2,1,93
340142102,179,6,1,2,0,1,6,195
340142103,253,26,1,0,1,1,4,286
340142104,262,24,1,8,1,0,14,310
340142105,102,5,0,3,1,0,2,113
340142106,94,13,12,7,2,0,9,137
340142107,238,57,1,1,2,1,5,305
340142108,200,29,2,30,0,0,0,261
340142109,207,12,4,9,0,1,7,240
340142110,190,26,0,1,1,0,3,221
340142111,196,20,1,2,2,1,2,224
340142112,156,13,1,1,0,0,2,173
340142113,153,10,2,0,0,0,0,165
340142114,219,14,2,1,0,1,10,247
340142115,335,7,0,1,0,0,5,348
340142116,336,13,3,4,0,1,3,360
340142117,252,17,2,4,3,1,3,282
340142118,209,11,0,0,0,0,4,224
340142119,250,6,1,2,2,0,0,261
340142201,213,12,0,1,0,2,4,232
340142202,296,17,0,0,2,3,11,329
340142203,173,8,0,0,1,6,0,188
340142204,315,34,0,0,0,0,8,357
340142205,368,23,0,0,0,2,3,396
340142206,305,12,1,1,5,0,3,327
340142207,321,16,3,5,0,0,2,347
340142208,332,15,0,1,0,0,12,360
340142209,286,12,0,4,4,0,12,318
340142210,354,12,1,1,0,1,5,374
340142211,294,9,0,1,1,1,5,311
340142212,354,14,0,2,0,1,7,378
340142213,339,4,0,1,0,0,10,354
340142214,333,8,3,3,4,0,14,365
340142215,190,3,2,1,2,0,6,204
340142216,245,10,3,2,1,0,6,267
340142217,244,9,0,3,0,0,3,259
340142218,243,4,0,0,1,2,3,253
340142219,342,15,0,21,1,1,21,401
340142220,191,12,2,0,2,0,4,211
340142221,176,7,5,1,0,3,5,197
340142222,30,0,0,0,0,1,6,37
340210101,7,1,0,0,0,0,2,10
340210102,24,10,0,0,0,0,1,35
340210201,137,13,0,0,0,2,27,179
340210202,35,1,0,0,0,1,7,44
340210203,9,0,1,0,0,1,3,14
340210204,6,4,0,0,0,0,0,10
340210205,5,4,0,0,0,2,2,13
340210206,49,0,0,0,0,3,21,73
340210207,10,6,0,0,0,0,1,17
340210208,79,10,0,13,0,0,31,133
340210209,34,6,0,0,0,2,1,43
340210210,46,6,0,0,0,4,7,63
340210211,173,13,0,0,0,1,1,188
340210212,190,12,0,0,0,0,9,211
340210213,266,24,0,2,1,0,2,295
340210214,289,34,3,24,0,0,40,390
340210215,142,13,4,1,9,5,9,183
340210301,71,7,0,0,0,19,6,103
340210302,123,20,0,1,0,40,5,189
340210303,65,2,0,0,0,15,17,99
340210304,175,12,2,6,6,10,29,240
340210305,158,9,0,7,4,12,6,196
340210306,75,27,0,0,0,14,3,119
340210307,194,10,1,1,1,12,13,232
340210401,11,1,0,0,0,9,0,21
340210402,70,4,0,0,2,4,12,92
340210403,246,20,0,2,0,9,35,312
340210501,5,0,0,0,0,1,1,7
340210502,127,8,0,3,0,7,16,161
340210601,50,8,0,0,0,0,9,67
340210602,131,21,3,1,0,1,8,165
340210603,203,11,0,1,2,5,29,251
340210604,241,22,2,0,0,1,9,275
340210701,18,3,0,0,0,3,6,30
340210702,14,3,0,0,0,2,1,20
340210703,49,2,0,0,0,1,1,53
340210704,27,8,0,0,0,0,3,38
340210705,7,7,0,0,0,0,1,15
340210706,309,18,1,3,1,2,7,341
340210707,219,34,1,3,3,0,7,267
340210708,172,11,0,2,0,1,11,197
340210709,99,12,0,0,1,4,2,118
340280101,161,13,0,2,1,0,3,180
340280102,150,29,5,1,0,0,24,209
340280103,252,31,2,9,1,2,38,335
340280104,227,30,1,5,10,0,6,279
340280105,263,24,1,7,5,3,20,323
340280106,204,42,1,7,0,1,8,263
340280107,191,21,3,0,2,2,1,220
340280108,151,27,1,4,2,0,9,194
340280109,252,28,0,5,0,3,24,312
340280110,137,34,2,13,0,0,4,190
340280111,116,25,4,27,0,0,7,179
340280112,154,36,1,5,0,0,8,204
340280113,244,49,10,12,1,0,17,333
340280114,184,20,4,2,0,1,10,221
340280115,161,18,2,1,0,0,8,190
340280201,229,21,0,3,0,2,8,263
340280301,98,1,0,0,0,5,3,107
340280302,28,10,0,0,0,1,3,42
340350101,212,20,2,0,0,12,13,259
340350102,59,9,2,0,0,0,1,71
340350103,149,19,0,3,0,1,11,183
340350104,29,0,0,0,0,0,5,34
340350105,47,11,0,0,0,2,1,61
340350106,156,2,0,0,0,5,14,177
340350107,6,0,0,0,0,0,0,6
340350108,196,12,0,2,0,0,1,211
340350201,170,10,0,1,0,1,11,193
340350202,67,7,0,0,0,2,10,86
340350203,155,43,0,3,0,0,18,219
340350204,91,15,1,9,0,1,8,125
340350205,23,17,0,0,0,0,1,41
340350206,93,11,1,0,0,0,12,117
340350207,5,2,0,0,0,0,0,7
340350301,199,23,0,1,0,1,4,228
340350302,24,23,0,0,0,0,1,48
340350303,109,16,0,0,0,2,9,136
340350304,11,3,0,0,0,0,0,14
340350401,14,1,0,0,0,2,4,21
340350402,260,25,0,0,0,0,20,305
340350403,64,1,0,0,0,0,8,73
340350404,26,9,0,0,0,1,0,36
340350405,182,10,0,3,3,0,13,211
340350406,112,13,0,0,0,0,0,125
340350501,410,55,0,8,0,14,38,525
340350502,29,11,0,0,0,1,1,42
340350503,2,3,0,0,0,0,1,6
340350601,106,6,0,0,0,4,18,134
340350602,138,8,0,0,0,1,19,166
340350603,137,26,0,0,0,0,5,168
340350604,177,23,1,0,0,0,8,209
340350605,140,13,1,6,0,2,6,168
340350606,149,8,3,3,4,11,6,184
340350607,196,12,0,2,0,1,16,227
340350608,161,25,1,4,1,0,8,200
340350609,141,30,0,4,0,1,2,178
340350610,119,24,0,5,1,0,38,187
340350611,286,24,0,3,0,1,49,363
340350612,295,17,1,0,0,2,29,344
340350613,216,19,1,2,0,0,12,250
340350614,122,20,2,2,1,0,2,149
340350615,141,25,0,3,0,0,8,177
340350701,111,3,2,3,0,1,8,128
340350702,157,16,0,0,0,0,28,201
340350703,173,22,1,1,0,1,9,207
340350704,284,27,6,4,5,1,22,349
340350705,233,43,2,7,3,5,9,302
340350706,155,22,1,3,0,0,11,192
340350707,218,16,3,4,0,2,11,254
340350801,119,2,4,20,3,3,15,166
340350802,216,19,1,3,5,4,13,261
340350803,182,34,1,13,0,0,36,266
340350804,239,30,0,1,0,2,10,282
340350805,272,35,0,0,0,0,20,327
340350806,174,21,2,4,3,2,4,210
340350901,162,22,0,6,0,0,4,194
340350902,197,30,0,1,2,0,2,232
340350903,260,21,6,6,2,4,10,309
340350904,228,26,4,4,5,6,18,291
340350905,159,12,4,3,5,2,13,198
340350906,276,64,7,2,3,0,30,382
340350907,191,25,1,2,0,2,24,245
340350908,245,15,3,1,1,4,8,277
340350909,285,50,1,3,4,4,12,359
340350910,150,23,1,2,2,2,7,187
340350911,178,17,1,6,6,2,75,285
340351001,168,10,1,3,5,4,6,197
340351002,285,18,1,4,2,0,19,329
340351003,207,44,1,2,4,0,8,266
340351004,297,16,1,2,3,2,20,341
340351005,193,23,7,2,6,3,12,246
340351006,196,23,4,1,0,0,17,241
340351007,150,4,3,0,0,0,23,180
340351101,26,1,0,0,0,0,1,28
340351102,24,4,0,0,0,0,2,30
340351103,187,49,1,4,0,0,7,248
340351104,170,19,2,3,4,1,12,211
340351105,161,11,3,2,1,0,23,201
340351201,288,34,2,4,0,3,7,338
340351202,312,23,0,5,0,0,16,356
340351203,241,28,3,1,11,0,3,287
340351204,169,24,1,0,0,0,5,199
340351205,245,22,1,5,2,3,10,288
340351206,195,13,3,1,0,0,5,217
340351207,275,33,0,1,0,0,13,322
340351208,157,12,0,1,0,1,6,177
340351209,145,15,9,4,0,0,28,201
340351210,92,9,2,0,0,1,45,149
340351301,43,0,0,0,0,0,0,43
340351302,25,9,0,0,0,0,0,34
340351303,24,3,0,0,0,0,2,29
340351401,56,10,0,0,0,0,10,76
340351402,46,18,0,0,0,0,1,65
340351403,32,5,0,0,0,0,6,43
340351501,2,0,0,0,0,0,0,2
340351502,81,16,0,3,0,0,6,106
340351503,98,17,0,1,0,1,4,121
340351601,85,22,0,0,0,0,5,112
340351701,36,9,0,0,0,1,2,48
340351702,19,2,0,0,0,0,2,23
340351703,8,1,0,0,0,0,4,13
340351704,18,0,0,0,0,1,1,20
340351801,133,18,0,1,0,0,1,153
340351802,121,1,0,0,0,0,7,129
340351803,46,14,0,0,0,0,0,60
340351804,49,2,0,0,0,0,1,52
340351805,112,36,0,1,2,0,9,160
340351806,169,12,1,1,0,0,5,188
340351807,153,12,4,0,1,0,10,180
340351808,190,25,0,0,0,0,17,232
340351809,113,0,0,0,0,0,0,113
340351810,130,39,0,1,0,3,2,175
340351811,118,7,0,0,0,0,1,126
340351812,91,4,2,2,0,0,0,99
340351901,42,15,0,1,0,1,2,61
340351902,43,6,0,0,0,3,3,55
340351903,109,0,0,0,0,0,1,110
340351904,175,34,1,3,0,0,1,214
340351905,213,28,2,2,0,0,5,250
340351906,228,65,1,9,0,2,14,319
340351907,121,5,0,0,0,0,0,126
340351908,173,20,1,6,1,0,4,205
340351909,47,2,0,1,0,0,24,74
340352001,62,9,0,0,1,0,2,74
340352002,105,10,0,0,0,2,9,126
340352003,48,11,0,0,0,1,3,63
340352101,35,0,0,0,0,0,0,35
340352102,9,6,0,0,0,0,4,19
340352103,60,10,0,1,0,0,1,72
340420101,37,1,0,0,0,0,1,39
340420102,165,1,0,0,1,1,11,179
340420103,64,3,0,0,0,3,4,74
340420104,155,9,0,1,0,2,27,194
340420105,189,22,0,0,0,2,3,216
340420106,107,7,0,2,1,0,0,117
340420107,121,43,0,8,2,0,16,190
340420108,141,3,1,1,1,0,113,260
340420109,329,35,0,6,0,2,44,416
340420110,258,36,1,3,3,0,21,322
340420111,319,35,5,3,3,4,15,384
340420112,88,3,1,0,0,5,6,103
340420201,14,0,0,0,0,1,1,16
340420202,79,5,0,0,0,3,0,87
340420203,37,0,0,0,0,0,3,40
340420204,270,20,0,19,0,2,46,357
340420205,240,26,0,6,0,1,8,281
340420301,90,11,0,0,0,1,3,105
340420302,13,4,0,0,0,0,0,17
340420303,165,23,0,0,0,0,5,193
340420304,25,1,0,0,0,1,5,32
340420305,328,57,0,0,0,2,9,396
340420306,249,23,1,3,0,1,56,333
340420307,150,25,2,3,0,0,45,225
340420401,144,15,0,3,0,1,5,168
340420402,16,6,0,0,0,0,0,22
340420403,13,2,0,0,0,0,0,15
340420501,166,4,0,0,0,0,2,172
340420502,13,12,0,0,0,0,0,25
340420503,10,6,0,0,0,0,0,16
340420504,240,16,1,3,0,5,38,303
340420505,245,12,2,3,1,5,24,292
340420506,216,21,0,3,4,0,9,253
340490101,236,16,0,6,3,0,25,286
340490102,356,9,6,13,0,0,5,389
340490103,227,6,2,2,0,0,4,241
340490104,204,25,4,2,0,0,12,247
340490105,175,1,9,3,0,0,12,200
340490106,296,12,5,3,1,2,12,331
340490107,223,9,4,6,1,1,1,245
340490108,219,11,1,3,0,0,2,236
340490109,377,19,4,9,3,0,10,422
340490110,230,8,1,1,0,1,5,246
340490111,232,18,13,5,5,0,13,286
340490112,189,12,2,2,10,0,3,218
340490113,229,16,1,0,0,1,0,247
340490114,353,16,1,5,1,0,3,379
340490115,294,15,4,2,0,0,4,319
340490116,241,21,1,4,1,0,2,270
340490117,244,8,2,3,1,3,9,270
340490118,201,5,3,1,0,1,2,213
340490119,289,2,2,5,0,1,13,312
340490120,266,0,5,8,0,0,24,303
340490121,305,19,0,1,0,1,15,341
340490122,293,11,1,14,2,0,9,330
340490123,217,4,0,0,0,0,6,227
340490124,297,16,2,6,0,0,0,321
340490125,246,7,2,5,0,0,9,269
340490126,185,8,0,2,0,0,0,195
340490127,145,3,0,1,0,1,1,151
340490128,218,9,4,1,0,3,6,241
340490201,3,1,0,0,0,0,0,4
340490301,13,9,0,0,0,0,0,22
340490302,141,6,0,1,0,0,7,155
340490303,34,5,0,1,0,0,0,40
340490304,42,1,0,0,0,0,4,47
340490305,35,7,0,2,0,0,1,45
340490306,64,0,0,0,0,0,1,65
340490401,33,10,0,0,0,0,1,44
340490402,30,0,0,0,0,0,1,31
340490403,161,6,0,5,0,1,4,177
340490501,15,4,0,0,0,0,0,19
340490601,101,4,0,0,0,0,1,106
340490602,205,10,0,3,0,5,34,257
340490603,187,16,1,1,1,1,16,223
340490604,103,35,0,0,0,2,11,151
340490605,9,0,0,0,0,0,3,12
340490606,55,7,0,2,0,0,6,70
340490607,16,0,0,0,0,1,9,26
340490608,12,1,0,0,0,0,0,13
340490609,62,4,0,1,0,0,7,74
340490610,300,30,7,4,1,1,21,364
340490611,158,12,0,0,0,0,7,177
340490612,251,36,3,13,0,0,28,331
340490613,188,3,2,6,3,3,18,223
340490614,208,25,0,4,0,0,15,252
340490701,225,18,0,1,0,1,7,252
340490702,73,7,0,0,0,0,0,80
340490703,405,34,4,10,2,3,37,495
340490704,140,6,0,6,0,2,10,164
340490705,39,5,0,0,0,0,1,45
340490706,149,8,0,0,0,0,4,161
340490707,29,3,0,0,0,0,1,33
340490708,162,4,3,2,0,2,11,184
340490709,62,4,0,2,0,0,41,109
340490710,162,11,2,25,0,0,10,210
340490801,182,8,2,12,0,0,25,229
340490802,93,3,0,1,0,0,5,102
340490803,110,7,0,0,0,3,6,126
340490804,565,24,0,2,0,0,16,607
340490805,541,49,3,1,3,3,38,638
340490806,289,22,0,10,3,0,13,337
340490807,158,33,0,4,1,0,2,198
340490808,162,17,0,5,1,1,19,205
340490901,117,9,0,0,0,1,5,132
340490902,306,19,0,2,0,0,10,337
340490903,213,29,0,2,1,2,5,252
340490904,10,0,0,0,0,0,6,16
340491001,6,0,0,0,0,0,0,6
340491002,32,8,0,3,0,2,2,47
340491003,243,11,1,6,0,0,7,268
340491004,294,16,1,5,0,0,10,326
340491005,327,14,1,0,0,0,0,342
340491006,275,14,4,1,0,1,5,300
340491007,254,10,0,0,0,0,8,272
340491008,232,8,0,0,0,0,3,243
340491009,251,17,0,0,0,0,3,271
340491010,341,22,22,0,0,1,0,386
340491011,191,13,0,4,0,1,3,212
340491012,244,14,0,0,0,0,7,265
340491013,251,7,2,2,0,0,7,269
340491014,246,8,2,3,0,0,13,272
340491015,222,5,1,1,0,0,3,232
340491016,309,15,1,0,1,1,6,333
340491017,202,3,1,1,0,0,8,215
340491018,274,15,4,7,0,0,9,309
340491019,268,5,0,2,1,3,3,282
340491020,249,23,1,4,0,0,3,280
340491021,252,5,2,7,1,1,11,279
340491022,78,15,0,0,0,0,97,190
340491023,1,0,0,0,0,0,199,200
340491024,34,1,0,0,0,1,239,275
340491101,292,37,36,15,0,12,8,400
340491102,136,25,6,7,1,3,5,183
340491103,236,27,8,13,4,1,3,292
340491104,210,12,3,11,0,2,9,247
340491105,186,14,1,2,4,1,16,224
340491106,294,21,2,6,0,5,10,338
340491107,161,68,1,28,3,1,4,266
340491108,108,0,1,21,0,0,95,225
340491109,200,7,4,2,0,3,5,221
340560101,307,27,0,5,2,1,19,361
340560102,126,12,1,5,0,1,11,156
340560103,264,17,1,4,0,1,21,308
340560104,299,34,3,8,1,1,4,350
340560105,216,13,1,0,1,2,15,248
340560106,322,26,0,0,0,3,10,361
340560107,254,19,4,3,11,2,8,301
340560108,178,13,3,1,14,0,9,218
340560109,242,32,7,5,20,3,5,314
340560110,229,15,3,3,3,2,13,268
340560111,284,21,2,2,0,0,2,311
340560112,309,38,2,17,0,2,17,385
340560113,218,33,1,5,2,1,10,270
340560114,58,6,0,0,0,0,217,281
340560115,143,22,0,10,1,2,18,196
340560116,267,43,3,20,7,6,8,354
340560117,195,27,7,3,0,0,93,325
340560201,3,0,0,0,0,1,1,5
340560202,154,8,0,0,0,0,2,164
340560203,4,0,0,0,0,0,3,7
340560204,9,1,0,0,0,0,0,10
340560205,14,1,0,0,0,0,0,15
340560301,76,11,1,0,0,0,6,94
340560302,20,3,0,0,0,0,0,23
340560303,165,14,1,4,1,0,19,204
340560304,3,0,0,0,0,0,4,7
340560401,9,4,0,0,0,1,0,14
340560402,204,25,0,1,0,2,14,246
340560403,70,8,0,0,0,0,2,80
340560404,13,2,0,0,0,1,7,23
340560405,251,67,0,3,0,5,10,336
340560406,210,6,5,5,0,0,2,228
340560407,193,24,1,5,0,5,30,258
340560408,298,35,4,3,0,7,14,361
340560409,296,35,0,8,1,3,16,359
340560501,182,15,0,0,0,2,11,210
340560502,109,8,0,0,0,3,8,128
340560503,87,11,0,6,0,2,15,121
340560504,180,28,1,0,0,3,34,246
340560601,82,1,0,0,0,0,4,87
340560602,70,3,0,1,0,1,8,83
340560603,76,11,0,0,0,0,0,87
340560604,35,1,0,0,0,0,6,42
340560605,85,14,0,0,0,0,3,102
340560701,209,28,2,0,0,4,21,264
340560702,50,2,0,0,0,2,12,66
340560703,27,11,0,0,0,0,0,38
340560704,27,4,3,0,0,2,0,36
340560705,224,11,0,0,0,4,27,266
340560706,211,26,2,9,5,8,14,275
340560707,261,33,4,7,1,0,13,319
340560708,315,49,0,15,2,1,23,405
340560709,181,13,2,11,3,1,12,223
340560801,47,2,5,1,0,0,8,63
340560802,58,7,0,0,0,0,3,68
340560803,15,4,0,0,0,0,2,21
340560804,18,5,0,0,0,1,4,28
340560805,51,8,0,0,0,1,8,68
340560901,66,9,0,0,0,1,8,84
340560902,44,3,0,0,0,0,0,47
340560903,15,2,0,0,0,1,3,21
340561001,117,9,0,0,0,1,11,138
340561002,32,12,0,0,0,0,0,44
340561003,91,10,4,1,0,0,4,110
340561004,51,5,0,0,0,0,0,56
340561005,30,3,0,0,0,0,0,33
340561101,239,18,1,0,0,0,7,265
340561102,244,24,0,0,1,0,6,275
340561103,199,7,6,1,5,1,33,252
340561104,195,18,1,5,0,1,7,227
340561105,251,10,0,5,1,2,18,287
340561106,160,7,6,2,0,2,3,180
340561107,195,16,0,2,0,0,7,220
340561108,280,18,6,1,0,0,15,320
340561109,226,18,0,3,0,1,4,252
340561110,214,4,0,0,0,4,19,241
340561111,193,20,0,2,0,1,1,217
340561112,228,19,3,4,6,1,12,273
340561113,190,12,0,2,3,0,6,213
340561114,155,15,0,3,0,0,7,180
340561115,201,24,2,7,3,4,12,253
340561116,225,14,2,1,1,1,7,251
340561117,232,16,0,8,2,3,12,273
340561118,208,26,3,22,4,2,8,273
340561119,268,38,1,25,0,1,51,384
340561120,161,18,4,1,7,1,20,212
340561121,217,30,0,2,0,4,9,262
340561122,158,10,0,0,0,0,95,263
340561123,122,23,3,18,0,0,70,236
340561201,12,1,0,0,0,0,8,21
340561202,106,1,2,3,0,4,8,124
340561203,9,2,0,0,0,0,1,12
340561301,54,21,0,0,0,4,0,79
340561302,33,0,0,0,0,0,1,34
340561401,88,17,0,0,0,0,2,107
340561402,186,6,1,1,0,1,15,210
340561403,38,1,0,0,0,0,6,45
340561404,22,0,0,0,0,0,0,22
340561405,34,0,0,0,0,0,0,34
340561406,50,7,0,0,0,0,0,57
340561407,57,3,0,0,0,0,1,61
340561408,195,11,0,0,0,3,1,210
340561409,304,22,0,4,0,2,8,340
340561501,156,9,0,0,0,0,7,172
340561502,28,0,0,0,0,0,13,41
340561503,69,14,0,0,0,1,13,97
340561504,27,0,0,0,0,0,1,28
340561505,7,0,0,0,0,0,0,7
340561506,159,11,0,0,0,1,3,174
340561507,181,21,1,1,6,1,10,221
340561508,242,17,0,6,3,0,16,284
340561509,233,9,4,2,0,4,19,271
340561510,246,11,1,1,1,2,8,270
340561511,233,10,0,2,0,1,10,256
340561512,260,20,0,2,0,4,9,295
340561513,198,61,1,3,0,0,3,266
340561601,60,4,0,1,0,4,7,76
340561602,16,6,0,0,0,1,0,23
340561603,20,5,0,2,0,0,6,33
340561604,63,4,0,2,0,1,3,73
340561701,30,7,0,0,0,1,1,39
340561702,30,6,0,0,0,0,1,37
340561801,67,8,0,1,0,2,2,80
340561802,57,3,1,0,0,3,1,65
340561803,14,0,0,0,0,0,0,14
340630101,369,19,0,5,1,1,6,401
340630102,432,13,0,1,0,0,1,447
340630201,270,24,0,0,0,0,1,295
340630202,345,13,0,0,0,0,2,360
340630203,234,22,0,0,0,1,0,257
340630204,326,11,1,1,1,1,11,352
340630205,304,7,0,0,1,0,4,316
340630206,188,26,0,29,1,0,4,248
340630207,197,35,1,2,1,0,21,257
380070101,164,56,2,0,0,13,10,245
380070102,38,49,0,0,0,14,46,147
380070103,9,21,1,0,0,6,1,38
380070104,55,52,0,0,0,8,16,131
380070105,216,58,7,11,1,5,22,320
380070106,156,55,7,4,7,3,27,259
380070107,213,60,0,8,16,2,42,341
380070108,283,51,4,7,1,13,11,370
380070109,252,50,1,4,1,3,12,323
380070110,143,8,0,2,1,18,14,186
380070111,173,33,0,1,0,7,15,229
380070201,62,44,0,1,0,0,13,120
380070202,41,30,0,0,0,2,6,79
380070203,44,61,0,0,0,3,14,122
380070204,268,46,0,25,1,11,21,372
380070205,134,57,0,24,0,6,36,257
380070301,52,24,0,0,0,8,5,89
380070302,46,50,0,1,0,6,23,126
380070303,86,53,0,1,0,15,38,193
380070401,22,10,0,0,0,21,14,67
380070402,65,41,4,0,2,7,28,147
380070403,126,72,0,4,1,47,13,263
380070404,62,32,0,0,0,1,4,99
380070405,40,17,0,6,0,0,11,74
380070501,79,11,0,0,0,6,6,102
380070502,36,14,0,0,0,20,9,79
380070503,92,29,0,0,0,29,8,158
380070504,78,48,0,0,0,33,10,169
380140101,50,9,0,1,0,1,3,64
380140102,47,22,0,19,0,3,1,92
380140103,105,16,0,3,0,0,4,128
380140104,84,15,0,0,0,2,6,107
380140105,180,68,0,9,1,2,66,326
380140106,73,9,0,2,1,1,6,92
380140107,228,32,0,0,1,29,115,405
380140108,100,15,0,1,0,39,8,163
380140109,174,72,0,1,0,0,19,266
380140115,12,1,0,0,0,0,3,16
380140116,121,7,0,0,0,0,1,129
380140117,176,12,0,7,1,1,16,213
380140201,182,42,1,3,0,1,8,237
380140202,19,2,0,0,0,0,19,40
380140203,299,41,0,5,0,10,55,410
380140204,197,17,1,3,0,11,30,259
380140205,201,8,0,3,2,0,4,218
380140206,90,5,0,2,0,0,5,102
380140301,131,43,0,0,0,0,40,214
380140302,186,37,0,7,0,4,128,362
380140303,138,25,0,3,0,8,113,287
380140304,476,44,1,6,2,1,17,547
380140305,285,18,0,4,4,1,12,324
380140401,337,67,1,114,1,3,55,578
380140402,239,43,0,3,1,32,16,334
380140403,288,50,0,3,1,38,22,402
380140404,361,29,1,1,0,6,39,437
380140405,284,61,0,140,0,7,18,510
380140406,302,9,0,21,0,1,0,333
380140407,291,16,0,4,5,0,5,321
380140408,201,5,0,2,0,0,3,211
380140409,309,15,5,7,1,2,3,342
380140410,220,9,1,1,2,2,6,241
380140411,252,20,3,18,5,1,5,304
380140412,122,3,0,32,2,0,5,164
380140413,224,25,0,21,1,1,8,280
380140414,259,20,0,21,0,0,31,331
380140501,204,29,1,58,0,2,15,309
380140502,131,22,0,0,2,2,28,185
380140503,323,100,0,2,2,30,74,531
380140504,76,27,0,5,0,42,7,157
380140505,29,15,0,6,0,24,3,77
380140506,139,14,0,64,0,0,9,226
380140507,291,13,5,3,4,2,9,327
380140508,389,20,5,7,6,0,13,440
380140509,269,7,1,7,3,1,1,289
380140510,250,19,1,7,8,2,14,301
380140511,306,21,0,2,7,9,9,354
380140512,202,15,1,7,0,2,3,230
380140513,233,14,4,12,3,1,3,270
380140514,245,5,0,0,0,0,3,253
380140515,279,5,0,0,0,0,0,284
380140516,221,19,1,0,1,2,8,252
380140517,115,4,0,60,2,0,37,218
380140601,263,13,2,3,4,0,19,304
380140602,252,14,3,2,1,3,8,283
380140603,250,26,3,3,23,1,18,324
380140604,286,16,1,4,14,0,6,327
380140605,231,18,2,2,8,0,3,264
380140606,196,13,2,0,3,0,11,225
380140607,191,8,0,0,4,0,1,204
380140608,189,9,4,0,5,0,1,208
380140609,423,10,1,0,0,1,3,438
380140610,205,5,0,0,0,1,1,212
380140611,222,4,0,0,0,0,0,226
380140612,238,8,0,0,0,1,2,249
380140613,203,3,1,0,0,0,5,212
380140614,185,10,1,7,0,1,4,208
380140615,283,12,1,3,0,0,3,302
380140616,244,12,1,0,12,0,8,277
380140617,190,8,0,4,0,0,1,203
380140618,203,2,0,0,0,1,1,207
380140619,204,8,0,3,0,0,3,218
380140701,172,1,0,13,0,0,1,187
380140702,75,2,0,48,0,1,114,240
380140703,55,1,0,24,1,4,142,227
380140704,58,0,0,19,0,0,200,277
380140705,176,1,0,1,0,0,4,182
380140706,198,21,0,3,0,0,4,226
380140707,256,19,0,6,0,1,8,290
380140708,300,11,0,0,0,0,0,311
380140709,264,7,0,3,1,1,2,278
380140710,357,9,1,0,0,0,4,371
380140711,373,6,0,4,2,0,10,395
380140712,363,10,0,0,1,2,5,381
380140713,295,9,3,2,1,0,8,318
380140714,209,11,0,28,2,2,11,263
380140715,206,6,0,0,0,0,4,216
380140716,324,36,1,24,0,1,9,395
380140717,154,13,0,27,0,0,2,196
380140718,78,9,0,5,0,0,2,94
380210101,21,7,0,1,0,0,5,34
380210102,32,4,0,0,0,0,0,36
380210103,128,16,0,6,0,68,36,254
380210104,9,11,0,0,0,0,0,20
380210105,132,13,0,2,0,7,22,176
380210106,172,18,5,7,0,44,12,258
380210107,160,13,2,5,1,42,14,237
380210108,309,29,0,17,2,59,93,509
380210109,72,10,0,6,0,82,5,175
380210110,164,22,1,0,0,5,3,195
380210201,47,7,0,0,0,1,4,59
380210202,48,30,0,0,0,0,0,78
380210203,4,2,0,0,0,0,0,6
380210204,5,0,0,0,0,0,0,5
380210301,12,0,0,3,0,2,0,17
380210302,18,3,0,0,0,3,9,33
380210303,36,17,0,1,0,2,8,64
380210304,25,2,0,0,0,3,2,32
380210305,38,8,0,1,0,7,3,57
380210306,12,3,0,0,0,0,0,15
380210307,279,24,1,15,1,1,15,336
380210401,4,0,0,0,0,0,15,19
380210402,95,14,0,0,0,3,15,127
380210403,12,1,0,0,0,2,4,19
380210404,71,18,0,4,0,4,8,105
380210405,239,10,2,6,0,15,68,340
380210406,206,26,2,63,6,11,15,329
380210407,45,0,0,0,0,0,0,45
380210408,86,9,0,7,0,0,2,104
380210409,372,28,1,15,3,1,10,430
380210410,217,14,1,8,0,4,4,248
380210411,265,20,1,10,2,20,7,325
380210412,277,31,4,13,3,23,16,367
380210413,251,26,0,8,2,0,14,301
380210414,205,13,1,8,0,12,37,276
380210415,275,37,1,13,2,2,4,334
380210416,135,19,0,0,0,4,2,160
380210417,270,21,0,14,3,5,4,317
380210418,117,3,0,14,0,4,22,160
380210419,89,24,2,20,0,0,0,135
380210501,276,14,2,13,1,8,30,344
380210502,263,6,4,13,2,0,6,294
380210503,373,17,2,2,2,0,14,410
380210504,377,18,2,12,5,2,10,426
380210505,228,9,1,2,3,0,7,250
380210506,167,14,1,4,3,0,19,208
380210507,248,7,6,2,1,5,5,274
380210508,206,5,1,2,0,0,4,218
380210509,220,0,0,0,0,0,4,224
380210510,395,12,0,12,1,4,7,431
380210511,218,9,2,7,0,1,4,241
380210512,290,9,1,3,0,1,5,309
380210513,271,15,0,2,7,0,8,303
380210514,293,18,1,4,1,0,6,323
380210515,228,3,0,0,0,0,2,233
380210516,283,5,12,41,0,0,9,350
380210517,265,5,3,15,1,0,5,294
380210518,186,19,0,4,0,0,6,215
380210519,202,6,0,0,0,1,1,210
380210520,351,21,4,48,3,0,4,431
380210521,310,46,1,16,4,18,5,400
380210522,243,3,0,1,1,0,7,255
380210523,271,7,0,1,0,1,4,284
380210524,381,22,1,3,1,3,9,420
380210525,173,35,12,17,2,0,5,244
380210526,150,4,0,2,0,1,4,161
380210527,199,18,7,39,0,1,2,266
380210601,182,8,1,0,1,1,7,200
380210602,198,0,2,3,0,2,5,210
380210603,364,36,0,11,0,3,7,421
380210604,283,0,0,0,0,0,1,284
380210605,148,35,2,0,62,1,35,283
380210606,60,2,3,1,23,0,17,106
380210607,246,79,11,1,41,1,22,401
380210608,213,13,0,1,0,0,1,228
380210609,170,23,4,3,23,2,20,245
380210610,244,54,13,0,51,0,31,393
380210611,236,20,0,1,1,2,6,266
380210612,153,52,14,1,25,3,14,262
380210613,193,25,9,0,12,1,14,254
380210614,245,11,0,1,0,0,6,263
380210615,169,63,11,1,27,1,51,323
380210616,220,35,22,3,70,2,19,371
380210617,209,5,0,0,0,0,1,215
380210618,264,4,0,3,0,0,2,273
380210619,232,6,0,1,0,0,3,242
380210620,160,8,1,1,1,0,4,175
380210621,223,6,2,1,0,0,8,240
380210701,303,33,16,21,2,4,18,397
380210702,185,9,7,8,1,0,3,213
380210703,43,1,1,0,0,0,3,48
380210704,213,3,0,2,0,0,2,220
380210705,351,23,2,1,4,0,9,390
380210706,164,46,12,3,30,0,10,265
380210707,343,48,3,1,5,0,8,408
380210708,186,26,11,4,0,0,0,227
380210709,225,77,8,1,27,1,19,358
380210710,203,23,10,2,89,2,12,341
380210711,206,8,2,4,0,0,4,224
380210712,254,16,2,1,4,0,4,281
380210713,206,22,5,1,8,2,8,252
380210714,263,10,1,2,6,0,9,291
380210715,370,34,1,4,2,0,16,427
380210716,385,28,5,4,4,2,11,439
380210717,333,30,4,6,0,0,6,379
380210718,195,16,1,1,3,1,3,220
380210719,234,13,4,1,0,0,6,258
380210720,198,29,6,7,2,3,4,249
380210721,190,15,8,2,0,1,4,220
380210801,189,21,15,9,15,0,5,254
380210802,288,12,2,5,1,1,7,316
380210803,131,8,5,4,18,0,10,176
380210804,196,10,0,0,0,0,17,223
380210805,213,10,1,1,2,0,10,237
380210806,322,12,1,0,0,0,12,347
380210807,325,23,2,2,0,0,8,360
380210808,369,23,8,1,0,4,10,415
380210809,256,25,3,1,0,0,8,293
380210810,223,19,1,0,0,0,1,244
380210811,213,30,0,0,2,0,11,256
380210812,352,16,4,3,12,0,16,403
380210813,203,10,2,2,2,1,1,221
380210814,276,4,0,1,0,0,8,289
380210815,175,11,0,5,0,1,4,196
380210816,312,11,1,2,0,0,9,335
380210817,229,9,4,1,1,0,6,250
380210818,247,6,2,0,2,0,4,261
380210819,211,7,1,1,0,0,7,227
380210820,123,10,1,1,0,0,1,136
380210821,212,7,1,1,0,0,2,223
380210822,217,17,1,2,1,0,2,240
380210823,223,12,0,2,3,2,6,248
380210824,221,7,0,1,2,0,3,234
380210825,215,3,3,0,3,3,7,234
380210826,198,11,0,3,1,0,5,218
380210827,220,13,1,3,29,0,7,273
380210901,320,32,3,1,10,0,6,372
380210902,164,26,12,6,27,0,15,250
380210903,180,16,7,0,0,1,1,205
380210904,87,11,0,1,0,0,3,102
380210905,323,11,3,4,3,1,10,355
380210906,228,20,3,2,6,0,5,264
380210907,227,12,5,0,7,0,6,257
380210908,234,18,1,2,1,0,7,263
380210909,214,25,5,5,11,0,5,265
380210910,244,21,7,7,2,0,13,294
380210911,331,25,2,7,3,1,3,372
380210912,318,27,3,6,3,1,7,365
380210913,317,13,5,2,0,3,0,340
380210914,223,9,0,1,0,1,2,236
380210915,303,7,1,0,0,0,4,315
380210916,358,10,0,1,1,1,2,373
380210917,268,9,3,3,0,1,8,292
380210918,375,22,3,7,3,3,6,419
380210919,160,8,3,0,0,0,1,172
380210920,275,9,1,0,0,3,12,300
380210921,178,8,3,0,2,0,2,193
380210922,253,9,3,0,0,0,4,269
380210923,120,17,2,10,1,2,11,163
380211001,310,23,14,2,3,5,11,368
380211002,320,12,6,2,0,1,11,352
380211003,241,12,0,0,0,0,6,259
380211004,217,10,1,4,1,1,21,255
380211005,305,24,1,5,0,0,9,344
380211006,246,15,4,1,3,3,6,278
380211007,299,14,10,1,0,0,7,331
380211008,263,17,11,8,31,5,26,361
380211009,339,28,8,1,13,3,14,406
380211010,282,10,2,4,3,0,9,310
380211011,207,19,4,1,6,0,11,248
380211012,222,13,7,6,1,5,7,261
380211013,265,15,1,8,5,0,14,308
380211014,309,9,0,5,0,3,3,329
380211101,282,7,0,0,0,2,1,292
380211102,272,16,1,11,0,4,2,306
380211103,266,30,2,5,1,0,11,315
380211104,201,11,3,2,1,0,3,221
380211105,328,19,4,0,0,0,4,355
380211106,224,3,1,0,1,0,0,229
380211107,248,6,0,0,3,1,2,260
380211108,362,21,3,4,14,5,4,413
380211109,149,14,0,7,0,1,5,176
380211110,316,17,9,0,6,1,9,358
380211111,267,11,1,1,0,2,0,282
380211112,213,17,4,5,5,0,8,252
380211113,264,20,9,4,3,2,5,307
380211114,204,21,1,2,0,0,3,231
380211115,187,14,5,2,1,0,3,212
380211116,237,19,5,4,2,0,5,272
380211117,280,22,3,0,2,0,9,316
380211118,130,6,1,3,0,0,6,146
380211201,258,12,2,9,4,3,8,296
380211202,347,25,3,0,0,3,5,383
380211203,345,12,0,4,2,1,6,370
380211204,255,11,2,1,0,0,5,274
380211205,215,3,0,0,0,0,3,221
380211206,305,12,2,4,2,2,9,336
380211207,330,8,0,0,0,1,1,340
380211208,199,14,1,1,9,0,4,228
380211209,288,10,3,3,0,0,5,309
380211210,283,12,2,0,0,0,2,299
380211211,225,24,0,0,3,2,12,266
380211212,244,11,5,7,4,2,7,280
380211213,171,9,0,10,1,0,3,194
380211214,370,33,4,6,6,4,5,428
380211215,284,14,5,13,6,2,5,329
380211216,202,17,0,0,0,0,3,222
380211217,237,20,0,4,2,1,8,272
380211218,216,9,1,1,0,1,6,234
380211219,346,32,1,15,0,1,12,407
380211220,314,10,2,1,0,0,3,330
380211221,342,18,0,49,0,0,7,416
380211301,374,33,2,18,2,1,15,445
380211302,11,7,0,0,2,0,0,20
380211303,41,7,3,4,1,2,111,169
380211304,220,8,0,0,0,1,0,229
380211305,282,27,2,11,1,1,2,326
380211306,225,16,1,17,3,1,7,270
380211307,385,34,6,33,1,5,13,477
380211308,351,8,0,2,0,1,8,370
380211309,279,1,0,0,1,0,4,285
380211310,254,11,1,2,0,0,9,277
380211311,270,4,0,0,0,0,3,277
380211312,296,9,4,0,5,1,4,319
380211313,368,14,1,1,1,0,7,392
380211314,198,10,1,1,0,0,3,213
380211315,318,11,0,0,0,0,5,334
380211316,280,9,1,0,0,4,5,299
380211317,284,11,1,0,0,0,3,299
380211318,196,9,1,0,0,0,6,212
380211319,275,6,0,0,1,1,1,284
380211320,209,11,1,0,1,0,5,227
380211321,194,8,0,0,1,0,1,204
380211322,263,3,0,1,0,0,0,267
380211401,270,12,0,0,0,1,8,291
380211402,311,11,0,0,0,2,5,329
380211403,316,18,1,0,1,0,2,338
380211404,310,9,0,0,1,2,3,325
380211405,330,10,0,0,0,0,6,346
380211406,213,8,0,3,0,0,2,226
380211407,399,7,0,1,1,2,2,412
380211408,261,9,2,1,2,0,2,277
380211409,346,14,1,1,0,0,7,369
380211410,194,5,0,0,0,0,2,201
380211411,224,15,0,0,2,1,6,248
380211412,304,14,0,0,0,2,5,325
380211413,193,6,0,1,0,1,2,203
380211414,376,20,0,3,1,0,7,407
380211415,338,5,1,0,0,1,5,350
380211416,235,5,2,1,3,0,8,254
380211417,422,23,1,3,2,4,5,460
380211418,307,12,0,1,0,1,2,323
380211419,270,20,0,1,0,0,9,300
380211501,373,17,0,5,0,2,6,403
380211502,178,22,0,190,2,3,23,418
380211503,82,33,0,86,0,3,18,222
380211504,95,11,0,69,0,1,152,328
380211505,187,41,2,24,0,0,44,298
380211506,216,5,0,10,0,0,45,276
380211507,244,15,0,41,1,0,6,307
380211508,280,20,0,3,0,0,17,320
380211509,186,5,0,139,0,3,6,339
380211510,298,30,0,12,0,0,10,350
380211511,380,44,2,1,1,26,17,471
380211512,276,9,0,0,0,2,7,294
380211513,186,20,0,31,0,0,16,253
380211514,281,11,0,0,0,2,1,295
380211515,234,7,0,24,0,0,8,273
380211516,90,13,0,47,0,1,318,469
380211517,150,20,0,0,0,0,215,385
380211518,395,43,0,11,0,0,21,470
380211519,185,30,0,191,0,1,15,422
380211520,38,3,0,0,0,0,0,41
380280101,83,70,1,1,1,13,45,214
380280102,58,66,0,0,0,11,28,163
380280103,77,59,1,1,1,4,27,170
380280201,75,65,0,0,0,6,35,181
380280202,58,37,0,0,0,6,22,123
380280203,117,69,0,1,0,14,64,265
380280204,40,20,0,1,0,2,29,92
380280205,39,24,0,0,0,3,10,76
380280301,147,44,0,0,0,2,32,225
380280302,100,58,0,0,0,10,62,230
380280303,123,52,0,1,2,14,4,196
380280401,138,73,0,0,0,29,11,251
380280402,87,28,2,1,0,13,29,160
380280403,197,40,1,14,1,1,6,260
380280404,184,40,4,5,69,32,12,346
380280405,175,25,0,13,0,3,11,227
380280406,186,83,7,7,8,13,10,314
380280407,227,62,0,16,2,4,6,317
380280408,151,61,0,2,2,5,9,230
380280409,148,29,1,1,0,5,8,192
380280410,259,42,0,44,1,16,10,372
380280411,273,73,1,2,1,5,11,366
380280412,126,56,0,21,0,6,13,222
380280413,234,55,0,10,0,2,4,305
380280414,144,24,12,87,0,0,10,277
380280415,187,21,3,25,1,15,11,263
380280501,33,18,0,0,0,3,17,71
380280502,81,72,0,0,0,15,36,204
380280503,169,61,0,2,2,0,17,251
380280504,173,56,0,5,6,1,8,249
380280505,186,39,0,7,0,0,9,241
380280601,40,21,0,0,0,2,0,63
380280602,107,60,0,0,2,10,49,228
380350101,262,30,0,3,0,4,52,351
380350102,58,17,0,0,0,0,5,80
380350103,3,2,0,0,0,0,1,6
380350104,10,4,0,0,0,0,0,14
380350105,291,14,0,4,0,1,20,330
380350106,339,20,2,7,1,1,6,376
380350107,246,9,2,0,1,1,4,263
380350108,215,20,1,6,0,0,59,301
380350109,270,33,0,10,2,1,10,326
380350110,204,21,1,4,2,0,4,236
380350111,233,23,0,1,0,2,14,273
380350112,176,3,3,6,2,1,20,211
380350113,201,4,0,0,5,0,3,213
380350114,180,11,0,2,0,0,8,201
380350115,105,12,0,0,0,0,5,122
380350201,1,1,0,0,0,0,0,2
380350202,2,0,0,1,0,0,1,4
380350203,0,0,0,0,0,0,1,1
380350204,194,6,1,5,3,0,2,211
380350205,184,25,3,1,0,0,7,220
380350206,56,59,0,0,1,0,242,358
380350207,56,180,0,0,4,0,43,283
380350208,57,3,0,0,0,2,144,206
380350209,84,0,0,0,0,0,157,241
380350210,256,14,1,1,0,0,5,277
380350211,363,13,0,5,10,4,23,418
380350212,228,12,5,2,1,3,5,256
380350213,159,7,0,1,0,0,16,183
380350214,188,20,0,4,0,0,14,226
380350215,194,17,0,0,0,1,8,220
380350216,156,13,0,38,0,1,48,256
380350217,266,17,0,11,0,1,7,302
380350301,41,20,0,0,0,0,0,61
380350302,18,1,0,0,0,0,0,19
380350303,16,0,0,0,0,0,0,16
380350304,14,8,0,0,0,1,0,23
380350305,13,8,0,0,0,0,0,21
380350306,190,5,0,42,1,0,0,238
380350401,122,145,0,0,0,1,7,275
380350403,72,13,0,0,0,3,15,103
380350404,232,22,0,0,0,1,2,257
380350405,0,0,0,0,0,0,212,212
380350406,0,0,0,0,0,0,280,280
380350407,213,13,0,0,0,0,6,232
380350408,350,16,1,2,0,0,5,374
380350409,300,20,2,1,7,0,2,332
380350410,275,9,0,1,1,0,8,294
380350411,220,19,0,1,0,0,2,242
380350412,319,13,1,2,1,0,7,343
380350413,275,21,0,0,0,1,3,300
380350414,223,12,0,1,0,0,0,236
380350415,202,5,0,0,0,0,1,208
380350416,339,35,2,36,0,1,15,428
380350501,335,13,1,19,0,0,5,373
380350502,271,10,0,0,0,0,1,282
380350503,278,11,0,0,0,0,2,291
380350504,297,5,0,0,0,1,1,304
380350505,237,3,0,0,0,0,3,243
380350506,212,7,0,0,0,0,2,221
380350507,327,16,4,1,2,0,7,357
380350508,188,14,0,1,1,0,2,206
380350509,147,12,1,3,35,0,11,209
380350510,274,25,1,3,7,1,10,321
380350511,193,13,7,0,0,0,2,215
380350512,121,20,1,3,6,1,3,155
380350513,204,38,2,2,28,2,11,287
380350514,273,18,1,5,5,0,9,311
380350515,335,17,3,0,0,0,12,367
380350516,426,17,0,10,1,1,3,458
380350517,184,7,5,0,13,0,7,216
380350601,282,8,0,1,0,0,1,292
380350602,336,14,1,1,1,1,5,359
380350603,289,13,1,2,2,0,130,437
380350604,330,11,3,1,1,0,6,352
380350605,247,6,1,0,3,0,12,269
380350606,304,44,0,1,0,0,2,351
380350607,234,13,0,0,0,0,2,249
380350608,232,19,0,0,0,0,3,254
380350609,173,8,1,0,1,1,2,186
380350610,278,24,2,3,0,1,3,311
380350611,241,8,0,0,0,0,7,256
380350612,269,7,0,1,0,1,4,282
380350613,315,4,0,0,0,0,1,320
380350614,334,6,0,9,0,1,4,354
380350615,291,9,0,1,1,0,0,302
380350616,312,6,0,4,0,0,2,324
380350617,396,27,0,3,1,0,11,438
380350618,321,8,1,0,0,0,4,334
380350619,197,7,0,0,1,1,0,206
380420101,61,12,0,2,0,2,5,82
380420102,10,4,0,0,0,0,1,15
380420103,14,3,2,0,0,2,2,23
380420104,153,59,1,2,0,18,120,353
380420105,104,10,0,0,0,0,1,115
380420201,59,7,1,1,0,0,0,68
380420202,44,4,0,0,0,3,4,55
380420203,3,1,0,0,0,0,1,5
380420204,65,14,0,2,1,0,18,100
380420205,201,24,2,6,0,1,8,242
380420206,114,14,0,7,0,0,1,136
380420207,122,12,0,12,0,1,0,147
380420208,330,27,0,11,0,0,4,372
380420301,95,19,0,0,0,2,35,151
380420302,32,1,0,0,0,0,2,35
380420401,349,18,3,14,0,4,10,398
380420402,313,30,6,9,1,2,4,365
380420403,280,24,1,9,1,1,12,328
380420404,319,13,3,14,1,0,10,360
380420405,222,11,2,5,0,0,0,240
380420406,219,13,1,7,3,0,9,252
380420407,323,16,1,12,2,0,5,359
380420408,321,19,0,8,0,0,9,357
380420409,258,9,0,1,0,1,0,269
380420410,254,24,0,1,0,0,1,280
380420411,311,19,0,0,0,3,7,340
380420412,137,7,1,124,0,4,16,289
380420413,221,20,0,11,0,4,35,291
380420414,351,32,2,4,0,6,18,413
380420501,302,18,1,3,0,1,6,331
380420502,247,12,3,5,1,1,14,283
380420503,262,16,4,5,5,1,6,299
380420504,231,23,0,4,1,0,6,265
380420505,243,12,0,7,0,0,11,273
380420506,273,14,0,7,1,6,19,320
380420507,192,15,6,4,6,0,11,234
380420508,197,9,5,4,3,1,5,224
380420509,307,8,3,5,1,1,16,341
380420510,241,8,2,6,0,1,8,266
380420511,203,6,0,1,4,1,20,235
380420512,330,15,4,8,0,5,5,367
380420513,232,24,0,9,1,0,14,280
380420601,234,0,0,3,1,0,7,245
380420602,267,14,2,2,16,0,16,317
380420603,251,15,1,4,1,1,6,279
380420604,289,25,2,6,8,3,3,336
380420605,228,9,1,0,8,0,4,250
380420606,225,6,5,3,15,3,3,260
380420607,348,4,0,0,1,1,4,358
380420608,250,13,1,18,1,0,4,287
380420609,345,7,0,0,1,0,4,357
380420610,301,10,0,0,0,0,2,313
380420611,195,6,0,0,0,0,2,203
380420612,184,6,0,0,0,1,0,191
380420613,269,9,0,1,0,2,5,286
380490101,18,18,0,0,0,0,2,38
380490102,57,33,0,0,0,11,1,102
380490103,13,1,0,0,0,0,9,23
380490104,27,13,0,0,0,0,4,44
380490105,39,31,0,2,0,0,1,73
380490106,85,35,0,7,0,8,31,166
380490201,36,6,0,0,0,4,14,60
380490202,45,13,0,0,0,13,9,80
380490301,60,32,0,1,1,51,4,149
380490302,89,67,0,4,0,4,8,172
380490303,51,4,1,4,0,2,11,73
380560101,15,2,0,0,0,8,3,28
380560102,147,20,0,32,0,12,17,228
380560103,64,18,0,6,0,43,7,138
380560104,181,21,2,4,0,25,9,242
380560105,171,9,2,5,1,13,9,210
380560201,130,37,2,30,1,85,29,314
380560202,197,71,0,28,0,11,17,324
380560203,53,9,0,15,1,9,18,105
380560204,130,4,0,2,0,0,1,137
380560301,7,1,0,0,0,0,1,9
380560302,6,6,0,0,0,0,0,12
380560303,24,4,0,0,0,3,1,32
380560304,11,2,0,0,0,0,3,16
380630101,23,5,0,0,0,0,0,28
380630102,99,39,0,8,0,0,1,147
380630103,285,37,0,5,0,0,21,348
380630104,260,103,1,6,0,17,17,404
380630106,262,18,0,4,0,0,5,289
380630107,144,17,0,0,2,1,4,168
380630108,36,2,0,0,0,0,9,47
380630109,158,19,0,100,1,3,3,284
380630110,244,12,0,0,1,1,2,260
380630111,204,3,0,1,0,0,2,210
380630112,23,7,0,0,0,1,0,31
380630119,191,12,0,1,0,1,9,214
380630124,254,114,0,28,0,0,7,403
380630201,35,11,0,0,0,0,1,47
380630202,97,40,0,0,0,1,51,189
380630203,147,31,1,1,3,0,15,198
380630204,105,4,0,4,0,1,8,122
380630205,43,10,0,0,0,0,31,84
380630206,344,21,0,0,0,1,16,382
380630207,337,21,1,2,2,5,12,380
380630208,215,26,0,7,0,0,0,248
380630209,89,6,0,0,0,0,1,96
380630301,109,29,0,1,0,0,8,147
380630302,50,12,0,0,0,0,8,70
380630303,168,37,0,2,2,6,9,224
380630401,334,15,1,0,0,1,7,358
380630402,234,9,0,2,0,0,4,249
380630403,258,17,3,3,1,0,9,291
380630404,325,25,2,3,0,0,15,370
380630405,321,18,4,6,1,0,5,355
380630406,289,10,5,2,0,0,10,316
380630407,309,17,5,2,0,1,7,341
380630408,165,13,1,5,0,0,7,191
380630409,255,20,1,0,2,0,15,293
380630410,233,20,1,7,0,0,5,266
380630411,209,15,0,2,2,0,15,243
380630412,217,10,0,2,0,0,2,231
380630413,332,13,2,3,2,1,6,359
380630414,275,14,0,2,0,0,11,302
380630415,379,27,0,11,1,0,12,430
380630416,218,23,14,4,18,1,5,283
380630417,215,29,6,4,8,2,26,290
380630418,242,10,0,7,1,0,12,272
380630419,241,18,1,0,0,2,8,270
380630420,309,10,0,7,0,1,4,331
380630421,253,20,0,0,0,0,3,276
380630501,309,20,2,1,0,1,5,338
380630502,332,34,1,5,0,3,3,378
380630503,255,9,2,8,0,0,0,274
380630504,240,33,15,12,12,0,20,332
380630505,256,32,1,3,12,2,16,322
380630506,155,4,1,3,2,0,8,173
380630507,272,13,2,3,0,0,5,295
380630508,263,24,1,3,2,0,7,300
380630509,243,11,1,1,0,1,3,260
380630510,261,14,1,2,0,0,2,280
380630511,389,26,0,0,0,0,3,418
380630512,247,25,1,0,1,0,11,285
380630513,183,16,6,6,0,0,2,213
380630514,252,17,3,4,2,0,7,285
380630515,280,26,2,1,0,1,5,315
380630516,293,16,0,2,0,0,6,317
380630517,199,7,0,0,0,0,3,209
380630518,206,5,0,1,0,0,0,212
380630519,236,17,1,1,0,0,2,257
380630520,194,13,0,8,0,0,0,215
380630601,282,2,1,12,0,0,4,301
380630602,279,26,0,2,0,0,15,322
380630603,0,0,0,0,0,0,175,175
380630604,24,0,0,6,0,0,301,331
380630605,169,56,0,29,0,0,67,321
380630606,94,10,61,52,0,0,10,227
380630607,311,20,4,6,0,0,3,344
380630608,0,0,0,0,0,0,261,261
380630609,150,5,0,73,0,0,2,230
380630610,94,12,0,2,0,0,2,110
380630611,226,7,0,1,0,0,0,234
380630612,207,17,0,6,0,0,14,244
380630613,298,9,0,0,0,2,5,314
380630614,274,14,0,0,0,0,6,294
380630615,308,15,1,1,0,0,7,332
380630616,259,16,1,1,0,0,2,279
380630617,206,9,0,2,0,0,6,223
380630618,223,12,0,0,1,1,5,242
380700101,121,40,0,8,1,6,26,202
380700102,13,5,0,0,0,0,0,18
380700105,309,32,1,0,3,1,3,349
380700106,336,43,1,2,0,0,5,387
380700107,113,10,0,11,2,0,12,148
380700201,45,22,0,0,0,0,10,77
380700202,163,50,0,1,0,2,26,242
380700203,162,48,0,0,0,4,6,220
380700204,384,45,0,3,1,0,24,457
380700205,171,23,0,3,1,1,3,202
380700206,168,35,0,27,0,1,7,238
380700207,116,32,0,19,0,2,4,173
380700301,26,17,0,0,0,0,0,43
380700302,13,4,0,0,0,0,1,18
380700303,13,5,1,0,0,0,0,19
380700401,21,2,0,0,0,0,4,27
380700402,34,2,0,0,0,1,4,41
380700403,255,13,0,1,1,0,13,283
380700404,301,14,0,5,0,13,17,350
380700501,200,18,0,1,0,1,21,241
380700502,76,20,0,0,1,0,126,223
380700503,18,14,0,0,0,0,0,32
380700504,109,18,0,5,1,9,8,150
380700505,43,9,0,0,1,17,6,76
380700506,310,21,0,0,7,1,4,343
380700507,202,19,0,0,0,0,2,223
380700508,146,5,0,2,0,0,0,153
380700601,33,12,0,2,0,2,7,56
380700602,22,3,0,0,0,10,0,35
380770101,73,35,0,2,0,10,19,139
380770102,51,23,0,0,0,3,36,113
380770103,78,25,0,1,2,54,20,180
380770201,49,27,0,3,0,19,8,106
380770202,64,64,0,0,0,4,6,138
380770203,59,11,0,0,0,31,2,103
380770204,60,23,0,3,0,7,23,116
380770301,116,88,0,3,1,13,31,252
380770302,69,50,0,3,0,11,17,150
380770303,77,41,0,0,0,0,8,126
380770304,63,23,4,4,0,1,35,130
380840101,71,29,0,0,0,2,20,122
380840102,49,61,0,0,0,1,11,122
380840201,78,49,0,0,0,10,37,174
380840202,61,67,0,0,0,0,0,128
380840301,20,6,0,0,0,10,20,56
380840302,112,42,6,27,1,1,18,207
380840303,185,42,1,9,1,2,7,247
380840401,36,15,3,7,3,7,12,83
380840402,8,13,0,0,0,0,0,21
380840403,40,11,1,1,0,16,9,78
380840501,12,48,0,0,0,0,6,66
380840502,56,20,0,2,1,3,7,89
380940101,10,17,0,0,0,0,3,30
380940102,163,67,1,7,0,21,40,299
380940103,195,111,2,14,0,11,38,371
380940104,142,44,1,2,0,10,14,213
380940201,30,30,0,0,0,0,0,60
380940202,23,31,0,0,0,0,0,54
380940203,10,4,0,0,0,0,0,14
380940301,19,16,0,0,0,0,0,35
380940302,39,39,0,0,0,0,1,79
380940401,69,37,0,1,0,3,11,121
380940402,195,51,6,16,0,11,22,301
380940403,106,41,0,34,0,1,4,186
380940404,149,32,1,8,19,18,4,231
380940405,283,60,1,10,0,32,20,406
380940406,195,22,3,14,22,67,13,336
380940407,148,35,1,8,2,5,19,218
380940408,162,43,0,9,0,9,6,229
380940501,150,81,0,22,0,6,13,272
380940502,34,10,0,2,1,1,3,51
380940503,142,39,7,3,3,17,2,213
380940504,191,55,0,5,1,21,23,296
380940505,147,60,1,10,0,10,11,239
380940506,178,51,0,50,0,8,8,295
380940507,161,57,0,43,0,4,3,268
380940601,18,2,0,0,0,0,0,20
380940602,20,20,0,0,0,0,0,40
380940603,16,24,0,0,0,0,0,40
380980101,65,24,0,13,0,14,7,123
380980102,38,34,0,0,0,0,7,79
380980201,10,2,0,0,0,0,0,12
380980202,11,0,0,0,0,0,13,24
380980203,122,38,2,4,1,30,20,217
380980204,112,36,2,4,31,18,6,209
380980205,58,3,2,7,1,1,7,79
380980301,39,9,0,1,0,4,8,61
380980302,30,4,0,0,0,16,3,53
380980303,31,2,0,0,0,24,2,59
380980401,29,21,0,0,0,2,3,55
380980402,53,20,0,2,0,5,6,86
380980403,64,21,0,0,0,12,10,107
380980404,124,48,0,16,1,15,5,209
380980405,274,50,1,11,1,26,16,379
380980501,62,8,0,0,3,1,8,82
380980502,27,17,0,0,0,4,0,48
381050101,13,50,0,0,0,0,0,63
381050102,74,32,0,3,0,0,72,181
381050103,104,83,4,15,4,2,5,217
381050201,30,16,0,1,0,0,0,47
381050202,70,85,0,3,0,0,2,160
381050203,8,19,0,1,0,0,1,29
381050204,80,27,6,14,2,7,12,148
381050205,168,62,0,7,3,18,12,270
381050301,64,71,0,7,11,4,5,162
381050302,22,16,0,0,0,6,7,51
381050303,20,7,0,0,0,0,10,37
381050401,17,80,0,0,0,1,2,100
381050402,57,68,0,0,0,0,11,136
381120101,87,17,0,1,0,6,7,118
381120102,187,41,2,2,22,2,21,277
381120103,201,31,2,3,0,1,22,260
381120104,229,33,6,6,0,2,28,304
381120105,194,77,2,7,21,0,10,311
381120106,195,24,4,1,0,1,31,256
381120107,225,38,0,6,0,1,5,275
381120108,245,33,0,2,2,0,9,291
381120109,223,63,0,10,0,1,18,315
381120110,228,31,3,1,3,4,10,280
381120111,227,29,1,6,2,4,9,278
381120112,201,46,2,7,0,7,7,270
381120113,229,32,0,2,0,2,1,266
381120114,185,36,9,2,9,4,29,274
381120115,202,22,4,3,1,3,14,249
381120116,187,24,3,0,2,2,9,227
381120117,227,49,1,23,0,0,53,353
381120201,46,40,0,0,0,6,16,108
381120202,122,51,0,42,0,18,18,251
381120203,47,52,0,1,0,1,2,103
381120204,50,23,0,5,0,13,7,98
381120205,215,27,0,91,1,0,11,345
381120206,50,62,0,2,0,0,11,125
381120301,40,44,0,0,0,5,15,104
381120302,116,79,0,3,0,15,43,256
381120303,109,130,0,1,0,11,18,269
381120304,51,29,0,1,0,4,26,111
381120401,19,33,0,0,0,5,7,64
381120402,48,74,1,0,0,5,14,142
381120501,68,74,0,2,0,16,15,175
381120502,112,165,0,0,0,3,33,313
381120503,51,39,0,5,3,11,7,116
381120601,41,5,0,0,0,9,10,65
381120602,50,3,0,0,0,10,5,68
381120603,27,11,0,0,0,1,18,57
381120604,59,42,0,1,0,8,21,131
420070101,214,7,0,4,2,4,8,239
420070102,136,22,3,1,0,1,16,179
420070103,8,0,0,0,0,3,3,14
420070104,20,14,0,0,0,0,0,34
420070105,7,0,0,0,0,0,10,17
420070106,13,0,0,0,0,0,1,14
420070107,8,1,0,0,0,3,14,26
420070108,22,11,0,0,0,3,9,45
420070109,16,0,0,0,0,1,17,34
420070110,186,15,2,0,3,3,27,236
420070201,132,11,0,2,0,0,11,156
420070202,158,11,1,2,1,1,16,190
420070203,15,2,0,0,0,0,1,18
420070204,37,0,0,2,1,16,9,65
420070205,8,14,0,0,0,0,1,23
420070206,6,0,0,0,0,11,0,17
420070207,217,20,1,3,5,3,17,266
420070208,163,10,4,2,1,2,11,193
420070301,99,16,1,2,0,0,2,120
420070302,23,26,0,0,0,0,0,49
420070303,5,12,0,0,0,0,0,17
420070401,255,23,7,3,3,0,8,299
420070402,266,13,5,1,0,2,6,293
420070403,173,17,1,1,1,1,14,208
420070404,170,16,4,2,5,1,10,208
420070405,171,19,4,3,2,1,8,208
420070406,240,24,7,6,3,2,17,299
420070407,17,15,0,0,0,1,0,33
420070408,9,10,0,0,0,2,0,21
420070409,250,43,2,10,0,2,13,320
420070410,4,3,0,0,0,0,2,9
420070411,10,6,0,0,0,4,11,31
420070412,0,0,0,0,0,0,6,6
420070413,182,10,0,1,1,0,10,204
420070501,128,14,2,0,3,2,9,158
420070502,5,2,0,0,0,0,0,7
420070503,2,0,0,0,0,2,7,11
420070504,5,2,0,0,0,0,0,7
420070505,14,3,0,0,1,0,18,36
420070506,2,3,0,0,0,0,4,9
420070507,4,7,0,0,0,0,0,11
420070508,99,9,1,0,0,2,7,118
420140101,13,0,0,0,0,0,11,24
420140102,15,4,0,0,0,2,14,35
420140103,23,0,0,0,0,0,30,53
420140201,179,23,2,5,6,3,7,225
420140202,7,0,0,0,0,0,4,11
420140203,48,57,0,0,0,2,50,157
420140204,0,9,0,0,0,0,1,10
420140205,31,3,0,5,1,15,1,56
420140206,8,0,0,0,0,0,2,10
420140207,1,5,0,0,0,0,0,6
420140208,0,7,1,0,0,0,1,9
420140209,9,8,0,0,0,0,3,20
420140210,222,42,2,1,8,0,5,280
420140211,139,23,0,17,0,13,3,195
420210101,46,0,0,0,0,17,29,92
420210102,13,0,0,0,0,8,0,21
420210103,20,0,0,0,0,6,8,34
420210104,9,0,0,0,0,2,21,32
420210105,109,2,0,0,0,14,5,130
420210106,33,0,0,1,1,10,3,48
420210107,28,0,0,10,3,1,5,47
420210108,19,1,1,1,0,5,7,34
420210109,11,0,0,0,0,9,1,21
420210110,37,0,1,1,0,14,0,53
420210111,260,0,0,0,0,0,2,262
420210112,270,1,0,0,0,0,3,274
420210113,230,14,4,0,0,0,3,251
420210114,174,27,2,15,0,1,3,222
420210115,0,0,0,327,0,0,2,329
420210116,0,0,0,363,0,0,13,376
420210117,118,5,0,2,0,6,11,142
420210118,200,17,2,28,1,36,26,310
420210201,115,17,2,10,1,0,11,156
420210202,17,2,0,0,0,4,6,29
420210203,3,7,0,0,0,0,0,10
420210204,12,14,0,0,0,0,1,27
420210205,18,6,0,0,0,1,12,37
420210206,27,13,0,1,2,3,11,57
420210207,12,0,0,0,0,0,8,20
420210208,14,2,0,0,0,2,14,32
420210209,230,26,6,3,2,4,9,280
420210210,153,21,0,0,4,0,11,189
420210301,234,18,1,2,0,0,4,259
420210302,226,20,0,2,0,0,13,261
420210303,268,38,3,17,2,28,5,361
420210304,257,37,10,8,0,5,10,327
420210305,234,23,2,8,0,2,11,280
420210306,276,12,3,1,1,0,7,300
420210307,245,24,0,1,0,0,3,273
420210308,243,12,3,6,1,2,5,272
420210309,238,25,1,4,0,0,2,270
420210310,287,20,4,11,3,3,3,331
420210311,330,25,0,1,2,0,3,361
420210312,359,16,1,0,1,0,1,378
420210401,220,27,3,1,0,0,2,253
420210402,221,12,2,2,0,2,3,242
420210403,196,15,0,0,1,1,5,218
420210404,228,10,0,0,0,0,1,239
420210405,176,18,0,1,1,0,1,197
420210406,249,19,6,8,1,0,11,294
420210407,375,29,10,2,1,0,5,422
420210408,261,20,8,4,1,2,5,301
420210409,13,0,0,0,0,0,1,14
420210410,138,6,5,5,0,0,5,159
420210411,168,29,11,1,7,0,2,218
420210412,193,37,6,1,6,0,4,247
420210413,281,49,14,4,10,3,7,368
420210414,307,31,17,1,1,2,2,361
420210415,203,19,0,1,2,2,10,237
420210416,180,28,5,1,6,3,2,225
420210417,213,39,9,3,5,0,8,277
420210418,202,18,3,5,0,16,5,249
420210419,187,9,6,12,0,9,3,226
420210420,244,39,4,16,1,24,4,332
420210421,163,6,2,9,0,75,11,266
420210501,229,21,1,4,0,1,3,259
420210502,338,6,6,4,1,0,5,360
420210503,342,23,2,2,1,1,16,387
420210504,255,21,5,1,3,0,3,288
420210505,258,26,1,3,0,0,9,297
420210506,385,39,3,3,0,2,5,437
420210507,366,42,4,2,2,1,23,440
420210508,2,0,0,0,0,0,0,2
420210509,207,6,3,0,1,0,10,227
420210510,266,34,3,5,1,0,9,318
420210511,238,14,0,2,0,0,6,260
420210512,258,15,1,1,0,0,1,276
420210513,238,24,4,1,1,1,9,278
420210514,196,33,5,2,2,0,6,244
420210515,332,56,16,4,0,0,11,419
420210516,422,65,20,11,5,0,12,535
420210601,199,23,0,3,0,0,6,231
420210602,205,34,2,0,3,0,4,248
420210603,317,30,11,5,2,0,8,373
420210604,323,60,9,2,8,3,25,430
420210605,171,36,2,4,7,0,9,229
420210606,171,35,15,2,9,0,9,241
420210607,236,41,6,0,3,0,6,292
420210608,143,37,14,2,14,1,7,218
420210609,163,43,1,0,15,1,3,226
420210610,2,0,0,0,0,0,0,2
420210611,203,51,8,2,16,5,38,323
420210612,189,68,14,0,23,8,8,310
420210613,283,63,17,5,44,2,23,437
420210614,284,60,14,7,16,2,17,400
420210615,191,85,5,2,19,0,3,305
420210616,165,55,10,0,5,5,12,252
420210701,186,30,4,1,6,1,3,231
420210702,159,28,10,3,11,0,5,216
420210703,273,71,7,2,20,2,8,383
420210704,272,52,8,1,19,0,3,355
420210705,296,84,24,0,37,3,22,466
420210706,201,61,13,3,33,1,1,313
420210707,234,31,16,5,22,1,11,320
420210708,267,16,2,0,2,0,2,289
420210709,193,26,2,2,4,2,11,240
420210710,178,22,3,2,0,0,0,205
420210711,151,17,0,4,0,6,10,188
420210712,200,13,2,0,0,0,1,216
420210713,232,20,4,2,0,0,2,260
420210714,286,29,15,3,3,0,2,338
420210715,303,22,1,0,1,0,4,331
420210716,183,18,2,0,1,2,2,208
420210717,215,22,5,0,1,3,2,248
420210718,183,7,3,0,0,0,11,204
420210719,296,16,7,2,0,0,11,332
420210720,258,27,5,4,1,0,15,310
420210721,258,25,4,2,0,0,9,298
420210722,278,22,4,6,0,1,2,313
420210723,239,30,0,10,0,3,4,286
420210724,184,12,0,14,0,38,7,255
420210725,139,16,5,16,0,24,16,216
420210801,167,24,7,7,48,6,8,267
420210802,193,49,16,2,6,4,1,271
420210803,191,63,25,1,9,0,8,297
420210804,238,26,10,1,13,1,5,294
420210805,290,51,15,5,5,1,9,376
420210806,246,35,5,7,2,2,14,311
420210807,246,27,2,2,1,0,6,284
420210808,332,31,16,10,3,1,13,406
420210809,245,46,1,0,1,0,3,296
420210810,284,17,2,1,2,1,14,321
420210811,196,24,7,2,1,0,4,234
420210812,186,19,11,4,3,3,2,228
420210813,205,35,8,1,6,0,8,263
420210814,252,52,5,6,4,0,3,322
420210815,264,15,1,1,0,1,14,296
420210816,274,30,3,1,0,0,7,315
420210817,196,12,1,0,3,0,6,218
420210818,201,9,4,0,0,1,1,216
420210819,201,9,2,4,1,0,4,221
420210820,189,19,0,1,1,0,1,211
420210821,294,10,1,3,0,0,3,311
420210822,183,7,1,0,0,0,0,191
420210823,146,12,6,2,1,0,2,169
420210824,202,18,4,12,1,2,0,239
420210901,136,19,18,0,3,15,1,192
420210902,297,39,8,2,7,1,21,375
420210903,345,33,9,4,8,6,3,408
420210904,328,32,12,2,2,2,6,384
420210905,308,19,0,7,0,0,6,340
420210906,135,11,0,0,0,0,9,155
420210907,323,19,3,3,3,1,3,355
420210908,344,17,24,18,0,0,6,409
420210909,195,30,11,3,1,1,6,247
420210910,204,19,15,25,0,1,7,271
420210911,236,25,3,4,1,0,10,279
420210912,362,26,7,13,0,1,6,415
420210913,262,44,8,1,0,6,12,333
420210914,172,8,6,0,1,2,15,204
420210915,216,25,3,0,2,0,9,255
420210916,310,25,6,2,1,2,7,353
420210917,170,16,4,7,1,2,105,305
420211001,319,16,2,0,0,0,5,342
420211002,330,10,1,0,1,0,2,344
420211003,192,9,0,2,0,0,9,212
420211004,292,6,0,0,0,0,4,302
420211005,282,10,1,0,0,0,6,299
420211006,270,8,0,0,0,0,4,282
420280101,147,31,1,1,2,3,8,193
420280102,20,9,0,0,3,1,8,41
420280103,54,36,0,0,0,10,23,123
420280104,23,18,0,0,1,1,15,58
420280105,149,21,2,0,1,1,5,179
420280201,313,17,1,3,1,1,22,358
420280202,88,32,0,0,0,3,6,129
420280203,192,21,9,6,0,1,12,241
420280301,270,24,0,4,2,0,5,305
420280302,210,15,4,5,2,0,0,236
420280303,329,27,1,3,2,18,42,422
420280304,246,14,7,39,1,0,7,314
420280305,200,26,2,4,3,0,1,236
420280401,35,1,0,0,0,35,3,74
420280402,28,13,0,1,1,12,11,66
420350101,78,0,1,3,0,3,5,90
420350102,1,0,0,0,0,0,0,1
420350103,8,4,0,0,0,0,0,12
420350104,12,10,0,0,0,5,3,30
420350105,17,12,0,0,0,1,0,30
420350106,9,16,0,0,0,0,0,25
420350201,140,16,0,3,0,2,8,169
420350202,78,26,0,0,0,1,37,142
420350301,3,8,0,0,0,4,0,15
420350302,10,7,1,0,0,7,3,28
420350303,7,2,0,0,0,0,0,9
420350304,5,11,0,0,0,0,7,23
420350305,3,4,0,0,0,0,3,10
420350306,149,36,3,6,1,12,64,271
420350307,8,2,0,0,0,0,4,14
420350308,22,21,0,1,0,5,4,53
420350309,139,13,1,0,0,0,0,153
420350310,315,23,0,2,2,2,8,352
420350401,178,18,5,2,0,0,7,210
420350402,171,16,5,0,0,1,6,199
420350403,262,14,11,11,4,9,9,320
420350404,194,16,2,2,2,1,5,222
420350405,256,18,0,11,2,3,16,306
420350406,180,18,4,6,3,1,5,217
420350407,197,16,9,5,0,1,14,242
420350408,151,20,2,2,2,1,10,188
420350409,181,9,2,4,1,1,12,210
420350410,156,16,1,1,0,1,5,180
420350411,137,14,1,3,0,1,14,170
420350412,258,27,6,1,2,1,8,303
420350413,237,34,7,2,1,0,8,289
420350501,75,24,1,0,0,0,17,117
420350502,26,19,1,0,0,7,14,67
420350503,17,5,0,0,0,0,5,27
420350504,16,9,0,0,0,0,8,33
420350505,89,12,0,2,0,0,9,112
420350601,216,28,3,6,2,0,24,279
420350602,207,16,5,1,0,0,10,239
420350603,14,0,0,0,0,0,16,30
420350604,20,0,2,0,0,0,19,41
420350605,23,3,0,0,0,9,0,35
420350606,15,4,0,0,0,5,2,26
420350607,13,5,0,0,0,5,3,26
420350608,59,19,0,2,0,6,6,92
420350609,216,30,7,2,1,0,10,266
420350610,164,19,9,5,0,0,3,200
420350701,113,10,0,2,0,0,28,153
420350702,8,0,0,0,0,0,13,21
420350703,7,0,0,0,0,0,13,20
420350704,17,0,0,0,0,0,14,31
420350705,16,0,0,0,0,0,19,35
420420101,2,6,0,0,0,1,4,13
420420102,1,0,0,0,0,0,0,1
420420103,1,0,0,0,0,0,1,2
420420104,2,3,0,0,0,0,1,6
420420105,0,1,0,0,0,0,0,1
420420106,2,1,0,0,0,0,2,5
420420107,6,2,0,0,0,0,0,8
420420201,138,33,3,6,0,0,8,188
420420202,55,36,0,0,0,3,10,104
420420301,107,14,1,4,0,0,2,128
420420302,14,22,0,0,0,0,0,36
420420303,3,1,0,0,0,0,0,4
420420304,0,3,0,0,0,0,0,3
420420305,1,0,0,0,0,2,0,3
420420306,8,1,0,0,0,0,1,10
420420307,3,2,0,0,0,0,0,5
420420308,4,1,0,0,0,0,0,5
420490101,166,15,5,0,0,2,2,190
420490102,259,42,0,2,0,0,15,318
420490103,138,65,2,11,0,5,14,235
420490104,11,0,0,0,0,0,4,15
420490105,54,8,0,0,1,1,6,70
420490106,38,26,0,0,0,0,1,65
420490107,145,22,3,1,1,0,4,176
420490108,89,20,1,9,0,2,1,122
420560101,238,25,0,11,0,1,17,292
420560102,36,11,0,0,0,4,1,52
420560201,52,1,0,0,1,1,15,70
420560202,16,6,0,0,0,1,32,55
420560301,131,16,1,12,1,0,6,167
420560302,54,23,0,0,0,8,43,128
420560303,288,23,1,5,0,1,1,319
420560304,106,8,1,2,4,2,12,135
420560401,102,8,0,2,0,0,15,127
420560402,33,24,0,1,0,11,29,98
420560501,286,24,16,2,7,3,15,353
420560502,296,27,9,6,8,4,18,368
420560503,195,12,1,0,1,0,0,209
420560504,183,16,8,1,0,1,7,216
420560505,27,6,0,1,1,6,16,57
420560506,123,8,1,13,0,6,47,198
420560507,25,7,0,0,0,0,0,32
420560508,14,6,0,0,0,0,6,26
420560509,15,10,0,0,0,8,6,39
420560510,26,4,0,0,0,2,3,35
420560511,223,11,0,4,0,0,0,238
420560512,131,14,2,35,7,3,5,197
420560513,130,3,2,1,0,4,6,146
420560514,199,20,2,2,0,0,6,229
420560515,294,18,1,12,0,2,8,335
420560516,241,9,0,0,0,0,1,251
420560517,167,14,0,2,0,0,6,189
420560601,238,13,1,5,2,1,22,282
420560602,21,0,0,0,0,9,26,56
420630101,91,7,0,0,0,0,8,106
420630102,110,15,2,0,0,2,7,136
420630103,125,60,0,3,1,2,22,213
420630104,1,3,0,0,0,0,0,4
420630105,7,0,0,0,0,0,0,7
420630106,31,5,2,0,0,1,2,41
420630107,97,32,0,1,0,14,6,150
420700101,184,27,0,1,2,1,14,229
420700102,7,1,0,0,0,0,2,10
420700103,89,3,1,0,0,55,48,196
420700104,148,27,0,4,0,2,21,202
420700105,183,11,0,0,0,0,7,201
420700106,175,15,8,1,0,0,13,212
420700201,348,33,6,13,0,2,6,408
420700202,46,33,2,0,0,5,21,107
420700203,1,8,0,0,0,0,0,9
420700301,10,1,0,0,2,0,3,16
420700302,28,26,0,0,0,1,0,55
420700401,178,13,1,1,0,1,22,216
420700402,51,4,1,0,0,5,43,104
420700501,335,25,3,7,2,1,9,382
420700502,281,42,5,2,0,3,1,334
420700503,222,24,3,1,1,0,2,253
420700504,206,12,1,1,0,3,8,231
420700505,146,44,1,3,0,11,13,218
420700506,36,1,0,0,0,0,1,38
420700507,280,28,1,40,0,0,5,354
420700508,210,11,0,5,2,1,4,233
420770101,108,8,3,3,2,9,14,147
420770102,2,0,0,0,0,2,9,13
420770103,6,5,0,0,0,0,1,12
420770104,5,1,0,0,0,0,7,13
420770105,10,9,0,0,0,0,0,19
420770106,8,1,0,0,0,6,0,15
420770107,20,13,0,0,1,4,2,40
420770108,41,38,0,0,0,2,26,107
420770201,198,15,0,0,1,0,5,219
420770202,184,17,2,0,1,0,7,211
420770203,146,13,0,3,0,0,3,165
420770204,17,16,0,0,0,5,19,57
420770205,11,16,0,0,0,1,0,28
420770206,17,15,0,0,0,0,1,33
420770207,25,8,0,0,0,8,14,55
420770208,15,11,2,0,0,6,0,34
420770209,5,3,0,0,0,11,6,25
420770210,162,14,8,14,0,1,22,221
420770211,150,24,0,4,0,2,6,186
420770212,136,18,1,0,0,3,6,164
420770301,240,68,4,5,0,5,7,329
420770302,169,13,9,7,1,2,20,221
420770303,9,2,0,0,0,0,19,30
420770304,25,4,0,2,0,7,30,68
420770305,23,11,0,0,0,5,27,66
420770306,80,5,4,0,0,0,5,94
420770307,133,13,1,0,0,3,2,152
420770401,283,27,5,23,5,2,6,351
420770402,207,15,8,1,0,1,11,243
420770403,7,10,0,0,0,0,0,17
420770404,11,1,0,0,0,3,15,30
420770405,4,0,0,0,0,0,4,8
420770406,13,6,0,0,1,0,13,33
420770407,3,1,0,0,0,0,1,5
420770408,5,3,0,0,0,6,0,14
420770409,205,24,2,1,0,0,12,244
420770410,178,22,5,4,2,2,10,223
420840101,68,23,3,1,1,4,6,106
420840102,43,102,0,0,0,0,1,146
420840201,16,0,0,0,0,4,7,27
420840202,27,0,0,0,0,0,17,44
420840203,12,19,0,0,0,0,2,33
420840204,0,3,0,0,0,0,0,3
420840205,3,1,0,0,0,0,0,4
420840206,6,1,0,0,0,0,0,7
420840207,4,1,0,0,0,1,2,8
420910101,27,10,0,0,0,0,3,40
420910102,40,1,1,0,0,0,10,52
420910103,32,26,0,0,0,0,5,63
420910104,21,6,0,0,0,0,6,33
420910105,69,23,1,0,0,0,1,94
420980101,188,24,1,2,4,1,15,235
420980102,130,14,0,5,2,1,62,214
420980103,169,13,0,1,0,1,3,187
420980104,139,3,3,1,0,0,44,190
420980105,157,20,1,3,1,0,5,187
420980106,131,8,3,1,2,3,7,155
420980107,166,19,1,4,2,2,14,208
420980108,149,18,10,1,4,0,24,206
420980109,215,36,1,0,3,0,4,259
420980110,189,27,4,2,0,0,5,227
420980111,188,30,0,2,3,0,10,233
420980112,24,5,6,0,0,0,0,35
420980113,35,29,0,0,1,1,11,77
420980114,20,21,0,0,0,0,0,41
420980201,217,39,1,4,1,2,23,287
420980202,26,22,0,0,0,2,0,50
420980301,189,24,0,0,2,4,29,248
420980302,65,28,1,1,0,5,35,135
420980303,199,37,1,0,3,0,13,253
420980401,93,16,5,2,0,1,12,129
420980402,98,52,2,1,0,15,15,183
421050101,116,0,5,5,1,6,15,148
421050102,2,0,0,0,0,7,0,9
421050103,40,0,0,0,0,8,2,50
421050201,15,2,2,0,0,0,0,19
421050202,28,13,0,1,0,6,10,58
421050203,48,28,0,0,0,6,19,101
421050204,13,0,0,0,0,6,10,29
421050205,9,24,0,0,0,1,3,37
421050206,202,29,6,402,1,40,27,707
421050207,171,31,1,21,3,34,5,266
421050301,264,35,5,15,1,6,5,331
421050302,190,9,3,3,2,0,3,210
421050303,217,29,5,4,0,0,2,257
421050304,221,36,13,2,1,0,5,278
421050305,216,16,6,4,1,1,15,259
421050306,182,33,5,1,5,0,24,250
421050307,147,22,3,1,22,1,6,202
421050308,210,32,4,2,7,2,12,269
421050309,197,24,6,3,2,1,7,240
421050310,226,32,5,5,2,1,12,283
421050311,202,27,4,6,0,0,4,243
421050312,235,33,5,5,2,0,15,295
421050313,189,13,5,2,6,1,15,231
421050314,156,26,2,2,15,0,14,215
421050401,315,24,2,9,3,17,5,375
421050402,309,10,2,6,1,0,2,330
421050403,282,7,0,0,0,0,1,290
421050404,339,24,0,3,1,1,2,370
421050405,291,10,11,1,0,1,8,322
421050406,388,19,6,0,2,1,8,424
421050407,32,4,0,0,0,0,0,36
421050408,218,13,14,2,2,0,6,255
421050409,256,33,7,4,4,0,4,308
421050410,204,22,5,3,15,0,10,259
421050411,201,25,1,1,3,1,11,243
421050412,188,25,1,1,5,0,9,229
421050413,204,22,12,0,9,1,10,258
421050414,231,34,19,2,24,8,15,333
421050415,174,58,6,3,27,5,10,283
421050416,154,33,11,0,13,2,20,233
421050417,188,33,1,2,2,0,5,231
421050418,183,26,4,4,3,0,12,232
421050419,182,12,4,2,1,2,12,215
421050501,128,23,2,6,0,1,7,167
421050502,11,8,0,0,0,0,0,19
421050503,50,19,0,0,0,1,3,73
421050504,12,3,0,0,0,1,0,16
421050601,97,6,0,0,0,0,15,118
421050602,34,15,1,0,0,3,15,68
421050701,282,14,1,3,1,1,8,310
421050702,189,19,4,2,2,2,6,224
421050703,282,35,4,3,6,1,6,337
421050704,237,25,7,1,3,2,18,293
421050705,311,23,6,3,1,1,13,358
421050706,276,14,1,1,0,0,8,300
421050707,108,14,0,1,0,0,1,124
421050708,207,7,1,0,0,0,0,215
421050709,295,19,1,0,0,0,4,319
421050710,249,18,3,7,1,1,4,283
421050711,264,20,2,2,1,0,6,295
421050712,292,13,5,2,1,0,2,315
421050713,250,7,4,1,1,0,10,273
421050714,254,17,1,3,0,3,3,281
421050715,222,10,2,0,0,10,7,251
421050716,230,20,3,5,1,8,1,268
421050717,319,21,5,11,1,4,23,384
421050718,211,7,0,1,1,9,4,233
421050801,423,14,0,0,0,1,7,445
421050802,178,3,2,12,0,2,2,199
421050803,226,8,0,0,0,0,4,238
421050804,360,9,0,0,0,0,4,373
421050805,301,15,0,0,0,0,2,318
421050806,243,8,0,0,0,0,88,339
421050807,383,29,7,15,0,3,5,442
421050808,219,25,13,8,0,1,2,268
421050901,225,21,2,5,0,9,9,271
421050902,112,8,0,2,0,1,4,127
421050903,99,0,0,0,0,0,0,99
421050904,226,16,0,4,1,0,2,249
421050905,246,14,0,0,0,0,3,263
421050906,234,9,0,0,0,0,2,245
421051001,293,23,11,5,1,0,0,333
421051002,265,28,15,1,0,2,7,318
421051003,331,77,8,2,1,0,7,426
421051004,208,12,2,4,0,0,3,229
421051005,293,31,4,6,1,0,1,336
421051006,223,28,3,0,2,0,6,262
421051007,178,9,0,0,0,0,4,191
421051008,200,28,10,3,3,1,8,253
421051009,166,24,14,0,0,0,2,206
421051010,237,52,9,3,4,1,6,312
421051011,250,20,13,0,0,3,7,293
421051012,340,45,15,8,3,2,16,429
421120101,67,41,1,8,0,0,8,125
421120102,149,46,1,0,0,2,16,214
421120201,25,2,0,0,0,1,2,30
421120301,217,20,2,4,0,0,0,243
421120302,176,17,1,2,3,0,5,204
421120303,264,36,0,1,4,0,5,310
421120304,63,9,6,3,3,0,1,85
421120305,293,29,3,2,0,0,4,331
421120306,317,19,0,1,0,0,5,342
421120307,238,11,4,2,1,0,0,256
421120308,278,6,1,1,1,0,6,293
421120309,177,11,0,19,0,0,44,251
421120310,45,44,6,7,1,7,5,115
421120311,10,2,0,0,0,1,4,17
421120312,278,34,9,12,12,27,40,412
421120313,13,5,0,0,0,0,9,27
421120314,9,0,0,0,0,1,0,10
421120315,18,12,0,0,0,1,1,32
421120316,9,1,0,0,0,0,2,12
421120317,1,2,0,0,0,0,0,3
421120318,3,0,0,0,0,0,0,3
421120319,5,0,0,0,0,0,1,6
421120320,5,0,0,0,0,1,1,7
421120321,4,2,0,0,0,0,0,6
421120322,4,0,0,0,0,0,1,5
421190101,206,15,2,2,2,3,13,243
421190102,3,4,0,0,0,0,0,7
421190103,9,4,0,0,0,3,6,22
421190104,14,5,0,0,0,1,16,36
421190201,154,12,0,1,5,0,7,179
421190202,109,21,0,3,3,0,15,151
421190203,295,25,5,2,3,3,17,350
421190204,240,34,3,0,0,1,5,283
421190205,22,0,0,0,0,6,11,39
421190206,18,2,0,0,0,3,12,35
421190207,5,0,0,0,0,2,9,16
421190208,12,0,3,1,0,15,23,54
421190209,10,0,0,0,0,3,10,23
421190210,10,9,0,0,0,1,0,20
421190211,177,15,2,0,0,0,4,198
421190212,284,16,1,1,0,0,28,330
421190301,240,20,12,3,2,3,40,320
421190302,288,31,8,1,2,5,16,351
421190303,15,7,0,0,0,0,11,33
421190304,3,1,0,0,0,0,2,6
421190305,16,2,0,0,0,11,12,41
421190306,16,1,0,0,0,0,17,34
421190307,20,2,0,0,0,15,18,55
421190308,23,5,0,0,0,7,9,44
421190309,1,2,0,0,0,0,0,3
421190310,3,0,0,0,0,9,0,12
421190311,273,23,5,0,2,4,28,335
421190312,254,18,6,5,0,2,11,296
421190401,278,19,5,5,3,7,14,331
421190402,34,4,0,0,0,0,2,40
421190403,23,12,0,0,0,6,13,54
421190404,15,19,0,0,0,10,7,51
421190405,13,12,0,0,0,0,0,25
421260101,230,24,3,5,3,2,8,275
421260102,235,30,9,13,20,5,17,329
421260103,250,35,0,2,0,2,13,302
421260104,8,1,0,0,0,1,0,10
421260105,12,12,0,0,0,0,3,27
421260106,9,7,0,0,0,1,0,17
421260107,20,2,0,1,0,3,3,29
421260108,46,6,0,0,0,3,17,72
421260109,16,1,0,0,0,1,5,23
421260110,23,4,0,0,0,0,9,36
421260111,192,22,0,1,1,0,4,220
421260112,118,9,0,0,0,1,2,130
421260201,249,15,3,0,3,3,13,286
421260202,153,9,4,16,7,4,8,201
421260203,134,23,3,0,0,0,4,164
421260204,6,0,0,0,0,0,25,31
421260205,107,24,0,0,0,1,22,154
421260206,8,0,0,0,0,0,25,33
421260207,82,4,0,0,2,0,2,90
421260208,150,17,6,2,2,3,5,185
421260301,8,0,0,0,0,1,25,34
421260302,20,0,0,0,0,0,25,45
421260303,8,9,0,0,0,1,8,26
421260304,7,12,0,0,0,0,9,28
421260401,164,16,3,6,1,2,7,199
421260402,12,3,0,0,0,0,1,16
421260403,12,0,0,0,0,0,8,20
421260404,14,5,0,0,0,0,0,19
421260405,32,20,0,0,0,0,1,53
421260406,16,0,0,0,0,0,13,29
421260407,169,29,0,24,0,0,11,233
421260501,156,23,0,13,4,2,18,216
421260502,70,17,0,0,0,0,0,87
421260503,35,56,0,0,0,0,15,106
421260504,11,0,0,0,0,0,10,21
421260505,8,9,0,1,0,7,2,27
421260506,72,12,0,0,2,4,23,113
421260507,4,0,0,0,0,8,10,22
421260508,4,1,0,0,0,3,7,15
421260509,180,16,1,5,0,1,7,210
421260510,221,14,4,4,1,2,13,259
421260511,137,23,2,1,2,2,6,173
421330101,101,13,4,7,1,4,16,146
421330102,8,1,0,1,0,3,26,39
421330103,13,0,0,0,0,0,35,48
421330201,273,27,12,5,3,2,8,330
421330202,151,33,0,2,1,3,4,194
421330203,236,19,7,1,0,0,7,270
421330204,199,24,3,7,3,2,6,244
421330205,267,35,6,16,4,3,12,343
421330206,19,4,0,0,0,3,9,35
421330207,327,49,10,8,2,12,16,424
421330208,0,2,0,0,0,3,6,11
421330209,2,0,0,0,0,0,12,14
421330210,1,4,0,0,0,0,0,5
421330211,176,17,1,1,1,0,14,210
421330212,113,13,0,0,0,0,2,128
421330213,110,2,1,0,1,0,4,118
421330214,200,21,4,4,1,3,6,239
421330215,209,25,3,3,3,1,2,246
421330216,214,16,2,1,1,0,0,234
421330301,97,7,0,5,0,3,3,115
421330302,13,18,0,0,0,0,4,35
421330401,57,2,2,4,1,0,6,72
421330402,18,4,0,0,0,0,4,26
421330403,11,8,0,0,0,1,2,22
421330501,173,16,1,0,0,2,7,199
421330502,188,24,8,3,1,0,9,233
421330503,199,15,6,21,1,8,19,269
421330504,180,10,2,3,0,1,13,209
421330505,176,22,2,3,0,1,5,209
421330506,9,1,0,0,0,17,7,34
421330507,24,3,0,0,0,11,16,54
421330508,283,20,6,2,1,2,2,316
421330509,148,24,2,2,0,1,3,180
421330510,195,13,3,14,1,1,4,231
421330601,161,10,1,3,2,1,10,188
421330602,242,14,3,2,2,0,11,274
421330603,6,12,0,0,0,0,7,25
421330604,49,6,1,7,0,0,18,81
421330605,8,3,0,0,0,0,11,22
421330701,243,16,1,0,0,1,20,281
421330702,221,19,2,5,2,1,17,267
421330703,14,7,0,0,0,0,0,21
421330704,39,2,0,1,0,7,24,73
421330705,11,3,0,0,0,11,3,28
421330706,7,20,0,0,0,4,1,32
421330707,5,5,0,0,0,4,8,22
421400101,13,11,0,0,0,1,0,25
421400102,33,0,0,0,0,22,0,55
421400103,17,0,0,0,0,17,0,34
421400104,2,1,0,0,0,0,2,5
421400201,194,33,1,6,0,0,14,248
421400202,198,35,3,6,0,0,17,259
421400203,172,13,6,1,0,1,4,197
421400204,232,12,5,0,0,1,4,254
421400205,174,9,3,0,0,0,2,188
421400206,209,20,4,2,0,2,5,242
421400207,176,28,1,8,0,1,0,214
421400208,179,32,2,1,0,0,3,217
421400209,199,23,2,3,1,1,11,240
421400210,234,21,7,4,1,2,19,288
421400211,303,18,3,6,0,5,7,342
421400212,191,20,1,13,2,5,15,247
421400213,52,4,1,0,0,0,55,112
421400214,55,2,0,0,0,0,17,74
421400215,139,16,5,27,1,43,12,243
421400216,165,26,1,4,1,49,1,247
421400217,153,32,9,15,0,37,2,248
421400218,144,14,2,9,1,41,8,219
421400219,138,11,3,28,0,39,5,224
421400220,75,6,0,0,0,55,0,136
421400221,35,5,0,0,0,21,2,63
421400222,146,53,7,18,2,20,10,256
421400223,56,13,0,5,0,36,0,110
421400301,1,2,0,0,0,1,0,4
421400302,54,21,0,0,0,46,1,122
421400303,4,0,0,0,0,4,0,8
421470101,164,15,2,1,1,1,6,190
421470102,2,0,0,0,0,11,0,13
421470103,3,4,0,0,0,0,0,7
421470104,11,7,0,0,0,25,4,47
421470105,7,20,0,0,0,0,4,31
421470106,16,0,0,0,0,27,0,43
421470107,12,34,0,0,0,0,12,58
421470108,15,4,0,0,0,8,3,30
421470109,194,15,3,3,0,0,21,236
421470201,221,18,0,3,0,0,7,249
421470202,172,22,6,3,1,10,12,226
421470203,14,2,0,0,0,0,12,28
421470204,1,9,0,0,0,0,0,10
421470205,7,5,0,0,0,1,0,13
421470206,12,4,0,0,0,5,7,28
421470207,7,24,2,0,0,5,2,40
421470208,9,8,0,0,0,0,0,17
421470209,16,4,0,0,0,10,2,32
421470210,31,12,0,0,0,4,17,64
421470211,9,11,0,0,0,5,21,46
421470212,6,13,0,0,0,0,0,19
421470213,3,5,0,0,0,5,5,18
421470214,229,14,2,1,1,2,7,256
421470215,288,31,11,5,3,7,8,353
421470216,199,14,3,5,2,2,14,239
421470301,159,26,4,1,3,0,13,206
421470302,8,9,0,1,0,1,8,27
421540101,70,12,3,0,0,0,1,86
421540102,39,22,0,0,0,2,12,75
421540103,46,15,2,0,0,15,22,100
421540201,148,23,0,1,1,1,5,179
421540202,88,24,2,0,0,5,17,136
421540301,241,30,2,11,0,6,17,307
421540302,52,0,0,0,0,16,29,97
421540401,38,5,0,0,0,10,9,62
421540402,24,16,2,0,0,3,22,67
421540403,56,18,4,4,1,28,17,128
421540404,29,15,1,0,0,12,10,67
421540501,89,18,0,5,2,14,3,131
421540502,268,38,6,14,0,1,26,353
421540503,231,42,17,2,1,2,20,315
421540504,207,47,2,5,0,3,11,275
421540505,280,51,8,2,2,0,18,361
421540506,205,51,4,3,5,2,17,287
421540507,234,38,5,5,6,4,18,310
421540508,213,25,4,1,1,0,9,253
421540509,231,28,3,1,1,0,2,266
421540510,196,21,2,1,1,1,15,237
421540511,220,34,4,2,3,0,17,280
421540512,290,26,0,9,0,5,27,357
421540513,287,23,0,28,0,0,68,406
421540514,213,18,4,1,0,4,5,245
421540515,263,13,1,0,1,0,8,286
421540516,239,19,1,2,0,0,4,265
421540517,238,20,0,0,0,0,0,258
421540601,115,12,2,2,0,2,13,146
421540602,13,19,0,0,0,0,0,32
421540701,28,14,0,0,0,0,7,49
421540702,36,32,0,0,0,1,5,74
460070101,311,12,0,2,0,3,19,347
460070102,242,41,7,11,9,6,14,330
460070103,374,27,3,4,4,3,18,433
460070104,299,22,2,9,0,2,2,336
460070105,306,14,2,6,0,1,6,335
460070106,96,8,1,4,0,5,14,128
460070107,245,21,4,6,2,2,23,303
460070108,301,18,2,5,2,0,12,340
460070109,218,30,3,16,0,2,10,279
460070110,180,14,4,7,0,3,4,212
460070111,345,21,0,17,2,2,14,401
460070112,403,31,1,45,0,1,51,532
460070201,292,64,0,6,1,18,28,409
460070202,108,18,0,0,0,2,27,155
460070203,15,15,0,0,0,0,9,39
460070204,182,15,0,1,1,1,27,227
460140101,178,1,0,8,4,124,44,359
460140102,27,2,0,0,0,4,0,33
460140103,484,3,18,77,4,60,85,731
460140104,173,6,3,39,2,8,29,260
460140105,229,0,1,59,2,0,11,302
460140106,356,19,6,24,1,6,14,426
460140107,335,36,1,8,0,0,12,392
460140108,228,22,1,15,0,0,14,280
460140109,490,40,1,20,0,9,32,592
460140110,501,44,8,36,2,6,26,623
460140111,367,41,8,19,6,3,25,469
460140201,26,6,0,0,0,4,8,44
460140202,102,0,0,13,0,17,26,158
460140301,43,6,1,0,0,6,6,62
460140302,83,4,0,0,0,11,6,104
460140401,271,33,0,2,3,0,16,325
460140402,266,19,1,4,2,3,11,306
460140403,240,18,0,5,1,1,9,274
460140404,369,26,8,11,0,0,8,422
460140405,251,9,1,1,1,0,7,270
460140406,265,19,4,4,2,1,6,301
460140407,232,10,4,5,3,0,9,263
460140408,348,20,8,3,3,1,6,389
460140409,263,24,0,7,2,0,13,309
460140410,238,52,5,5,6,1,10,317
460140411,392,34,13,4,4,2,17,466
460140412,254,33,6,8,2,2,10,315
460140413,327,10,4,2,0,0,17,360
460140414,217,13,3,2,0,6,7,248
460140415,231,13,0,6,0,1,4,255
460140416,275,14,1,5,1,2,12,310
460140417,207,19,8,0,3,0,22,259
460140418,208,14,3,3,3,5,9,245
460140501,228,4,2,7,2,0,8,251
460140502,233,15,1,4,1,4,18,276
460140503,254,12,15,7,0,4,13,305
460140504,415,33,11,49,0,6,14,528
460140505,313,2,6,1,1,1,7,331
460140506,196,7,2,0,0,0,1,206
460140507,378,23,3,0,0,1,7,412
460140508,403,16,5,3,4,1,18,450
460140509,404,38,3,9,0,1,5,460
460140510,331,5,2,9,0,4,8,359
460140511,255,16,0,3,0,0,4,278
460140512,238,6,0,2,0,0,10,256
460140513,295,13,3,1,0,0,20,332
460140514,322,6,4,4,1,1,9,347
460140515,341,7,2,6,0,0,11,367
460140516,315,5,1,3,0,0,11,335
460140517,386,12,5,11,2,5,14,435
460140518,345,13,5,6,5,1,8,383
460140519,284,24,16,0,2,2,18,346
460140601,352,14,8,2,4,3,11,394
460140602,264,16,11,6,32,5,20,354
460140603,204,27,6,1,26,4,5,273
460140604,240,23,3,0,22,1,26,315
460140605,296,51,89,8,69,13,29,555
460140606,266,43,31,3,33,6,19,401
460140607,265,26,19,8,64,0,23,405
460140608,215,23,31,18,23,4,13,327
460140609,232,44,2,5,12,1,9,305
460140610,315,59,21,4,20,1,10,430
460140611,273,42,67,3,16,0,19,420
460140701,94,11,2,12,1,80,5,205
460140702,437,22,5,15,0,4,29,512
460140703,462,22,5,11,0,0,41,541
460140704,353,33,5,13,0,6,17,427
460140705,419,17,2,5,1,5,19,468
460140706,258,13,6,0,0,1,1,279
460140707,258,19,0,5,2,4,4,292
460140708,321,21,3,7,2,13,11,378
460140709,269,18,3,20,1,46,4,361
460140710,339,32,8,20,4,6,8,417
460140711,271,13,0,0,0,0,12,296
460140712,318,27,5,7,0,0,4,361
460140713,344,16,6,7,0,2,6,381
460140714,379,31,3,5,1,0,4,423
460140715,268,14,5,3,3,1,4,298
460140716,249,26,2,26,0,20,58,381
460140717,111,14,4,33,0,52,19,233
460140718,175,20,2,16,5,40,7,265
460140801,340,32,5,1,2,0,22,402
460140802,287,32,3,2,2,1,7,334
460140803,392,38,15,8,0,2,9,464
460140804,404,64,35,2,3,0,12,520
460140805,265,45,4,1,2,1,2,320
460140806,364,42,5,6,8,2,6,433
460140807,311,23,4,1,8,1,4,352
460140808,212,16,6,10,0,2,2,248
460140809,338,37,5,4,3,2,15,404
460140810,418,50,11,6,1,3,5,494
460140811,381,18,10,3,1,0,5,418
460140812,280,30,3,9,0,1,0,323
460140813,320,54,4,18,1,0,26,423
460140814,435,30,8,8,1,6,27,515
460140901,324,16,6,28,2,5,13,394
460140902,314,46,21,10,0,1,8,400
460140903,195,23,21,25,1,1,5,271
460140904,226,19,3,2,13,2,14,279
460140905,213,27,2,4,0,1,4,251
460140906,423,43,4,26,1,6,23,526
460140907,366,25,1,13,1,1,6,413
460140908,408,41,3,0,2,2,5,461
460140909,323,48,2,16,0,1,1,391
460140910,550,29,0,0,0,1,12,592
460140911,54,8,0,14,0,0,60,136
460140912,385,46,9,40,2,5,11,498
460140913,278,51,9,4,0,0,7,349
460140914,406,53,3,4,1,4,12,483
460140915,399,23,0,1,0,5,13,441
460140916,327,12,2,0,0,0,32,373
460140917,437,15,0,0,1,1,6,460
460140918,334,38,0,25,0,0,73,470
460140919,392,18,1,19,0,3,20,453
460140920,352,42,1,70,4,0,14,483
460140921,325,33,3,30,1,10,34,436
460140922,341,19,1,199,2,5,22,589
460141001,288,20,7,1,10,0,7,333
460141002,145,7,3,0,0,0,1,156
460141003,243,8,7,11,5,1,18,293
460141004,195,23,8,7,18,3,9,263
460141005,427,20,4,47,0,1,31,530
460141006,369,20,6,24,1,2,11,433
460141007,212,8,0,0,0,1,5,226
460141008,361,19,6,1,2,0,20,409
460141009,209,10,4,0,1,0,6,230
460141010,246,6,0,3,1,1,14,271
460141011,228,10,1,2,3,0,9,253
460141012,571,20,2,1,0,1,9,604
460141013,384,20,5,3,2,1,7,422
460141014,329,15,4,4,2,0,17,371
460141015,216,13,1,1,1,0,4,236
460141016,269,9,0,0,0,0,1,279
460141017,572,32,2,23,1,3,18,651
460141018,282,22,15,19,1,3,14,356
460141101,385,31,6,9,0,1,9,441
460141102,350,15,5,7,3,1,9,390
460141103,200,17,1,2,0,0,2,222
460141104,336,39,1,0,0,0,6,382
460141105,451,18,2,8,2,1,8,490
460141106,311,7,0,0,0,1,9,328
460141107,293,34,3,3,24,3,17,377
460141108,366,39,3,3,24,0,28,463
460141109,362,37,21,11,11,0,26,468
460141110,441,17,4,4,1,0,7,474
460141111,391,34,7,14,6,1,14,467
460141112,349,39,3,3,3,0,15,412
460141113,352,80,20,6,20,1,19,498
460141114,396,58,15,9,1,1,14,494
460141115,472,98,9,43,2,3,11,638
460210101,221,27,7,16,3,59,25,358
460210102,318,61,3,9,6,24,15,436
460210103,94,8,0,5,0,26,33,166
460210104,157,39,2,6,0,23,14,241
460210105,121,9,0,6,2,50,48,236
460210106,125,31,3,5,1,58,15,238
460210201,128,0,2,8,5,63,56,262
460210202,138,9,1,25,5,87,17,282
460280101,138,32,0,0,1,0,14,185
460280102,284,76,2,2,3,4,7,378
460280103,278,38,5,16,4,3,17,361
460280104,149,25,0,6,0,5,41,226
460280105,246,53,2,17,2,19,34,373
460280106,134,46,1,7,1,19,32,240
460280107,184,20,0,3,0,0,4,211
460280108,197,31,3,3,2,3,10,249
460280109,117,7,18,75,0,2,17,236
460280201,102,2,1,4,0,2,14,125
460280202,332,29,4,17,10,6,38,436
460280203,161,23,3,4,0,11,50,252
460280204,191,21,1,21,1,5,21,261
460350101,356,34,6,2,1,0,15,414
460350102,283,20,11,4,2,3,18,341
460350103,509,51,9,17,1,3,6,596
460350104,499,29,4,14,0,5,23,574
460350105,217,11,3,2,6,2,18,259
460350106,304,34,7,0,0,1,8,354
460350107,364,33,15,15,1,2,17,447
460350108,416,20,4,16,0,19,15,490
460350109,379,26,5,12,2,2,0,426
460350201,358,36,7,17,3,80,21,522
460350202,178,32,0,7,0,20,35,272
460350203,48,14,0,0,0,5,27,94
460420101,499,36,6,25,2,7,22,597
460420102,211,27,4,10,9,2,13,276
460420103,246,45,7,3,4,2,9,316
460420104,246,22,4,8,17,4,26,327
460420105,214,10,2,1,13,0,89,329
460420106,432,49,15,10,16,6,22,550
460420107,276,32,3,10,18,2,16,357
460420108,283,33,9,11,2,0,8,346
460420109,377,9,4,3,1,1,17,412
460420110,428,44,5,20,6,0,9,512
460420111,284,17,4,3,14,0,14,336
460420112,324,11,0,0,1,3,7,346
460420113,638,23,1,15,0,3,3,683
460420114,371,30,0,16,1,0,20,438
460420115,304,33,2,10,6,0,7,362
460420116,344,32,3,15,1,0,12,407
460420117,259,27,2,1,5,2,12,308
460420118,306,5,0,0,0,0,8,319
460420119,232,22,4,9,2,0,8,277
460420120,590,46,4,23,1,11,30,705
460420121,348,13,6,5,2,3,16,393
460420122,272,31,0,119,0,0,12,434
460420123,366,33,0,2,0,0,8,409
460420201,376,27,1,18,2,8,33,465
460420202,421,41,2,6,4,7,27,508
460420203,215,19,1,35,1,7,12,290
460420204,359,37,3,24,3,3,9,438
460420205,185,13,1,8,0,6,18,231
460420206,179,29,0,25,2,19,13,267
460420301,505,49,6,24,3,6,19,612
460420302,553,19,6,24,1,11,22,636
460420303,232,16,0,6,1,54,13,322
460420304,235,54,7,2,2,2,10,312
460420305,196,51,2,5,1,38,35,328
460420306,504,54,2,41,2,1,11,615
460420401,338,30,3,18,2,2,25,418
460420402,367,36,1,46,5,4,53,512
460420403,125,28,0,53,0,2,36,244
460490101,381,63,2,31,2,16,46,541
460490102,301,52,9,7,10,20,18,417
460490103,184,40,0,12,0,12,48,296
460490104,32,37,0,4,0,2,5,80
460490201,243,76,1,31,8,5,45,409
460490202,250,40,2,5,9,11,50,367
460490203,57,19,0,2,1,15,13,107
460490204,137,40,0,1,4,31,55,268
460490205,74,10,3,13,4,5,11,120
460560101,319,43,2,8,2,2,27,403
460560102,258,42,3,4,1,24,41,373
460560103,95,6,0,0,0,5,31,137
460560104,183,51,1,2,0,5,6,248
460630101,292,34,1,15,2,7,32,383
460630102,410,30,12,11,3,6,4,476
460630103,313,53,3,25,0,6,14,414
460630104,261,30,1,5,10,1,4,312
460630105,189,16,2,6,4,10,27,254
460630106,244,40,2,4,2,47,46,385
460630201,254,44,2,8,0,3,20,331
460630202,26,0,2,0,0,1,9,38
460630203,88,17,0,1,0,6,18,130
460700101,349,44,3,1,0,6,5,408
460700102,277,11,2,2,0,18,68,378
460700103,102,15,0,1,0,11,13,142
460700201,261,48,2,12,2,6,34,365
460700202,26,2,0,0,0,3,12,43
460700203,85,22,0,0,0,5,8,120
460770101,213,54,1,5,6,7,16,302
460770102,5,0,0,0,0,2,5,12
460770103,11,1,0,3,0,1,3,19
460770104,246,45,0,9,1,5,18,324
460840101,247,30,1,12,0,7,21,318
460840102,194,15,0,2,3,22,43,279
460840103,234,34,0,3,1,28,46,346
460840104,223,16,3,5,0,7,12,266
460840201,252,24,5,7,3,6,28,325
460840202,207,14,3,5,4,5,21,259
460840203,66,5,0,0,0,2,18,91
460840204,69,12,0,2,0,15,15,113
460840205,228,16,2,5,3,4,22,280
460840206,327,24,2,10,0,1,24,388
460910101,68,12,0,0,0,0,15,95
460910102,122,20,0,7,0,9,35,193
460910201,362,42,3,13,2,7,22,451
460910202,168,37,0,4,0,11,19,239
460910203,132,14,0,0,0,1,8,155
460910204,417,29,2,14,1,10,27,500
460980101,370,45,0,16,3,21,91,546
460980102,275,30,0,11,8,4,50,378
460980103,11,0,0,0,0,2,2,15
460980104,78,17,0,4,2,5,26,132
460980105,15,1,0,0,0,0,7,23
461050101,245,51,1,7,4,13,16,337
461050102,198,26,1,3,0,8,15,251
461050103,132,50,0,3,0,2,15,202
461050104,54,9,0,0,0,7,8,78
461120101,405,46,13,13,4,2,24,507
461120102,281,38,5,3,1,0,5,333
461120103,278,40,2,3,5,2,11,341
461120104,394,38,4,6,1,2,15,460
461120105,258,35,1,13,1,2,11,321
461120106,344,45,9,3,5,5,25,436
461120107,300,45,3,15,2,3,15,383
461120108,352,44,6,3,1,6,20,432
461120109,337,25,3,9,0,3,14,391
461120201,198,27,1,1,0,0,11,238
461120202,299,38,0,0,0,46,30,413
461120203,45,8,0,0,0,6,15,74
461120301,172,18,1,0,0,6,16,213
461120302,131,27,0,0,0,2,12,172
461190101,169,30,1,16,0,23,58,297
461190102,306,59,1,6,2,18,43,435
461190103,326,70,1,14,5,45,29,490
461190104,114,40,4,1,1,12,30,202
461190201,132,32,0,6,0,28,69,267
461260101,283,64,2,18,7,160,45,579
461260102,29,35,1,3,0,22,6,96
461260103,292,106,1,4,5,108,43,559
500070101,337,51,18,1,3,1,10,421
500070102,226,33,4,5,14,3,17,302
500070103,310,44,13,1,4,1,8,381
500070104,244,19,16,0,2,2,13,296
500070105,252,37,17,1,2,1,16,326
500070106,256,29,18,1,11,3,14,332
500070107,196,91,15,2,21,0,10,335
500070108,187,46,20,7,17,0,17,294
500070109,184,42,9,4,27,1,14,281
500070110,108,21,7,3,13,5,3,160
500070111,149,63,19,1,10,4,33,279
500070112,159,18,27,0,21,20,17,262
500070113,126,19,23,0,143,10,7,328
500070114,160,51,20,2,0,3,8,244
500070115,191,33,32,1,12,2,13,284
500070116,111,50,23,1,45,3,3,236
500070117,146,38,19,0,23,1,17,244
500070201,347,30,6,2,15,1,18,419
500070202,244,17,11,3,2,0,15,292
500070203,342,15,10,2,3,0,13,385
500070204,255,15,10,0,14,0,17,311
500070205,227,12,9,2,4,0,6,260
500070206,338,32,18,4,21,1,13,427
500070207,230,29,10,1,10,1,15,296
500070208,194,29,10,2,12,1,1,249
500070209,262,27,11,5,24,0,20,349
500070210,250,17,20,3,4,3,11,308
500070211,312,27,14,3,7,0,20,383
500070212,152,15,12,6,8,1,20,214
500070213,299,27,8,12,13,2,23,384
500070214,245,16,20,6,19,2,15,323
500070215,165,12,13,3,0,0,3,196
500070301,248,13,13,4,15,0,19,312
500070302,292,34,24,1,6,0,26,383
500070303,279,46,37,6,20,3,19,410
500070304,215,25,17,3,13,1,7,281
500070305,125,0,22,0,20,2,36,205
500070306,111,19,21,0,30,32,36,249
500070307,93,0,46,2,37,61,7,246
500070308,123,19,21,1,37,101,12,314
500070309,131,37,28,0,62,19,8,285
500070310,160,37,37,3,16,1,8,262
500070311,170,5,16,2,18,12,24,247
500070312,134,9,7,3,30,5,18,206
500070313,141,45,45,3,80,0,9,323
500070314,132,49,27,1,85,14,79,387
500070315,202,71,25,0,34,2,8,342
500070316,156,18,22,0,9,22,17,244
500070317,96,46,35,0,39,6,15,237
500070401,226,41,23,1,61,7,23,382
500070402,196,45,27,0,197,3,16,484
500070403,120,14,13,0,107,15,50,319
500070404,177,17,51,0,182,10,14,451
500070405,124,23,19,0,89,7,3,265
500070406,59,20,8,0,68,0,2,157
500070407,177,49,26,0,102,1,5,360
500070408,163,33,28,0,42,5,12,283
500070409,187,47,36,2,83,11,8,374
500070410,141,40,27,0,31,1,3,243
500070411,163,34,19,1,10,1,3,231
500070412,219,57,76,1,77,3,11,444
500070501,247,1,8,6,8,5,11,286
500070502,242,0,13,3,16,2,7,283
500070503,263,0,14,2,11,2,58,350
500070504,153,1,9,1,13,1,13,191
500070505,193,0,4,0,8,0,35,240
500070506,294,13,27,1,28,8,13,384
500070507,149,40,14,1,14,0,23,241
500070508,261,42,19,1,35,2,36,396
500070509,235,19,18,5,30,10,22,339
500070510,282,41,13,5,43,0,30,414
500070511,230,35,23,6,62,2,36,394
500070512,111,30,6,3,11,0,21,182
500070601,181,22,8,2,3,0,10,226
500070602,218,19,7,0,12,0,8,264
500070603,228,18,12,10,7,0,6,281
500070604,206,10,6,4,6,0,17,249
500070605,183,20,5,1,1,0,8,218
500070606,408,19,19,6,9,1,19,481
500070607,282,37,23,2,15,1,15,375
500070608,338,40,11,4,9,4,3,409
500070609,170,11,14,4,1,2,7,209
500070610,322,38,27,9,7,1,44,448
500070611,133,24,3,0,9,4,15,188
500070701,205,16,10,6,1,1,2,241
500070702,325,25,7,1,8,1,12,379
500070703,228,16,2,1,6,0,12,265
500070704,225,24,5,1,2,2,9,268
500070705,234,12,9,1,1,0,4,261
500070706,293,45,69,3,4,0,10,424
500070707,227,7,4,2,10,1,14,265
500070708,159,10,1,0,3,0,25,198
500070709,169,14,4,0,0,0,5,192
500070710,275,29,9,3,23,1,14,354
500070711,336,55,6,1,40,4,22,464
500070801,164,21,13,4,34,1,8,245
500070802,140,3,9,2,12,0,44,210
500070803,343,37,14,0,4,0,15,413
500070804,107,6,22,0,28,0,14,177
500070805,168,19,10,0,31,2,17,247
500070806,245,37,19,2,20,2,27,352
500070807,208,14,11,8,44,0,49,334
500070808,137,11,11,3,30,1,14,207
500070809,185,15,10,2,54,1,10,277
500070810,236,24,4,2,15,0,31,312
500070811,142,41,8,3,32,3,11,240
500070901,221,26,21,6,23,1,8,306
500070902,188,23,7,3,13,1,21,256
500070903,196,39,20,0,17,0,11,283
500070904,269,55,15,3,32,6,21,401
500070905,289,51,17,3,20,2,16,398
500070906,262,28,13,3,12,1,22,341
500070907,249,33,16,7,17,2,15,339
500070908,209,25,8,6,10,1,21,280
500070909,80,7,1,0,1,0,7,96
500070910,263,35,11,3,19,4,27,362
500070911,213,12,7,2,11,2,20,267
500070912,140,17,14,1,3,1,3,179
500071001,323,22,1,27,0,0,12,385
500071002,239,35,14,1,5,0,9,303
500071003,270,19,5,7,1,1,6,309
500071004,296,10,0,0,0,0,0,306
500071005,260,9,0,0,3,1,3,276
500071006,345,4,0,0,0,1,2,352
500071007,237,29,13,0,3,1,7,290
500071008,246,7,2,2,1,0,4,262
500071009,294,28,5,2,2,0,3,334
500071010,246,9,1,2,0,0,3,261
500071011,127,3,0,0,0,0,1,131
500071012,232,21,12,1,0,0,21,287
500071013,1,0,0,0,0,0,0,1
500071014,205,4,1,0,0,0,0,210
500071015,132,1,0,0,0,0,5,138
500071016,112,1,0,0,0,0,2,115
500071017,302,14,8,7,1,1,4,337
500071018,0,0,0,0,0,0,0,0
500071019,347,28,4,10,1,2,10,402
500071020,250,31,4,17,0,0,16,318
500071021,183,4,0,0,0,0,4,191
500071022,102,2,0,0,0,0,1,105
500071101,205,18,17,4,4,0,2,250
500071102,305,20,10,0,2,1,14,352
500071103,234,18,7,0,5,1,7,272
500071104,282,11,5,0,3,1,15,317
500071105,302,14,1,1,3,0,10,331
500071106,346,19,7,7,5,2,15,401
500071107,249,13,11,1,3,1,12,290
500071108,370,13,13,6,11,0,25,438
500071109,226,26,5,3,7,0,13,280
500071110,279,17,6,5,5,0,15,327
500071111,182,2,10,5,4,1,21,225
500071112,169,18,2,0,6,0,8,203
500071113,152,8,8,3,1,0,2,174
500071201,150,21,15,5,100,14,8,313
500071202,89,10,12,1,42,34,13,201
500071203,152,54,12,2,104,12,2,338
500071204,114,54,7,2,42,6,5,230
500071205,137,53,50,0,64,8,5,317
500071206,194,43,30,7,118,7,41,440
500071207,134,67,19,2,262,6,11,501
500071208,183,80,26,2,220,5,12,528
500071209,238,55,42,0,148,21,27,531
500071210,226,58,38,4,120,2,20,468
500071301,371,0,0,1,0,0,3,375
500071302,279,0,0,1,0,0,3,283
500071303,248,0,0,0,0,0,5,253
500071304,280,0,0,0,0,0,0,280
500071305,194,0,0,0,0,0,5,199
500071306,215,0,0,0,0,0,2,217
500071307,334,8,0,3,0,0,6,351
500071308,266,6,0,3,0,0,3,278
500071309,310,0,2,2,0,2,6,322
500071310,0,0,0,0,0,0,0,0
500071311,7,2,0,0,0,16,5,30
500140101,111,45,0,1,0,8,16,181
500140201,57,23,0,0,0,4,9,93
500140301,33,8,0,1,0,3,9,54
500140302,93,8,0,3,0,10,32,146
500140303,81,11,0,3,0,3,18,116
500140304,277,12,2,7,0,7,35,340
500140305,66,55,0,0,0,13,9,143
500140401,185,34,0,1,0,14,30,264
500140402,113,6,0,1,0,4,40,164
500140403,8,0,0,0,0,0,3,11
500140404,274,42,0,5,1,5,21,348
500140405,317,43,0,2,0,6,50,418
500140406,333,16,3,3,0,2,7,364
500140407,10,0,0,0,0,0,0,10
500140408,372,34,4,2,1,1,3,417
500140409,332,20,4,1,0,3,23,383
500140410,307,26,4,3,0,2,8,350
500140411,183,4,0,2,0,1,27,217
500140412,150,6,1,2,0,10,24,193
500140501,320,14,5,5,1,29,46,420
500140502,205,12,1,2,1,9,20,250
500140503,193,0,6,1,3,6,19,228
500140504,254,14,4,3,0,4,35,314
500140505,219,7,4,3,1,4,24,262
500140506,151,7,2,2,3,4,33,202
500140601,325,16,8,14,0,0,11,374
500140602,229,11,6,1,0,1,7,255
500140603,242,18,2,2,3,1,2,270
500140604,299,22,10,13,25,3,12,384
500140605,243,25,18,8,14,0,16,324
500140606,250,9,1,2,1,0,6,269
500140607,241,17,0,4,0,1,6,269
500140608,193,14,11,1,6,1,13,239
500140609,305,17,6,2,0,2,8,340
500140610,262,15,11,5,9,4,20,326
500140611,349,14,0,11,0,3,10,387
500140612,323,18,9,7,1,3,16,377
500140613,275,24,5,2,1,2,6,315
500140614,160,6,4,0,0,2,6,178
500140615,454,25,2,2,1,6,18,508
500140616,346,22,5,15,3,0,11,402
500140617,251,18,5,2,1,1,3,281
500140701,312,17,2,9,4,4,12,360
500140702,305,24,0,3,0,0,8,340
500140703,468,19,4,2,1,14,15,523
500140704,147,13,3,2,0,0,2,167
500140705,364,19,0,1,0,1,13,398
500140706,246,13,6,0,2,1,4,272
500140707,287,10,5,28,0,0,1,331
500140708,299,13,1,4,0,1,2,320
500140709,291,16,1,1,0,0,3,312
500140710,339,24,6,3,5,0,19,396
500140711,263,23,3,2,13,0,37,341
500140712,274,46,22,1,8,1,10,362
500140713,223,16,10,7,2,7,10,275
500140714,250,28,3,1,1,0,2,285
500140715,298,11,8,8,0,1,9,335
500140716,356,28,1,5,0,0,2,392
500210101,206,1,0,0,0,0,9,216
500210102,270,11,3,2,1,0,2,289
500210103,106,0,1,5,0,0,0,112
500210104,308,13,2,0,0,0,5,328
500210105,259,12,2,1,0,0,3,277
500210106,194,2,0,0,0,0,1,197
500210107,603,23,1,0,0,1,19,647
500210108,306,12,3,0,0,0,8,329
500210109,278,14,15,13,16,0,4,340
500210110,238,9,2,1,0,0,5,255
500210111,360,9,3,1,0,0,4,377
500210112,196,4,1,5,1,0,1,208
500210113,293,12,3,3,1,0,1,313
500210114,233,10,1,0,0,0,3,247
500210115,327,3,0,0,0,1,2,333
500210116,272,10,1,2,0,0,6,291
500210117,148,5,1,1,2,0,5,162
500210118,176,5,0,1,1,0,4,187
500210119,124,4,1,0,0,0,3,132
500210201,241,8,4,4,2,0,3,262
500210202,187,10,8,1,0,0,11,217
500210203,195,6,0,0,1,0,0,202
500210204,317,7,3,0,0,0,1,328
500210205,227,3,1,0,4,1,4,240
500210206,229,5,8,3,4,0,5,254
500210207,295,11,2,3,3,0,10,324
500210208,265,4,4,1,1,0,7,282
500210209,291,8,10,0,1,0,8,318
500210210,213,9,3,0,1,0,6,232
500210211,240,9,8,1,3,0,4,265
500210212,332,9,13,1,10,0,3,368
500210213,253,12,5,2,2,1,8,283
500210214,204,14,3,9,1,0,6,237
500210215,305,10,1,2,2,0,19,339
500210216,311,10,3,3,3,1,11,342
500210217,246,8,1,5,1,0,2,263
500210218,64,2,0,0,0,0,4,70
500210219,115,5,0,0,0,0,1,121
500210301,303,35,19,0,20,3,10,390
500210302,156,27,44,7,18,1,10,263
500210303,166,22,15,3,8,1,4,219
500210304,300,23,19,4,5,0,9,360
500210305,170,17,15,4,18,0,3,227
500210306,244,27,24,3,12,0,10,320
500210307,178,24,16,0,1,0,8,227
500210308,323,17,12,7,5,0,10,374
500210309,306,9,10,3,5,0,5,338
500210310,235,27,7,5,10,0,15,299
500210311,282,18,9,1,18,0,12,340
500210312,200,21,17,0,10,0,4,252
500210313,196,15,17,0,0,0,8,236
500210314,229,17,16,0,6,4,17,289
500210315,152,8,11,2,10,0,1,184
500210316,161,22,21,0,7,0,9,220
500210317,208,40,12,6,12,0,12,290
500210401,272,10,0,0,0,0,2,284
500210402,225,7,8,8,0,0,2,250
500210403,261,13,10,7,4,0,5,300
500210404,295,25,15,13,5,2,12,367
500210405,181,12,4,3,7,0,11,218
500210406,208,3,3,2,6,0,7,229
500210407,207,7,7,1,0,0,12,234
500210408,256,6,0,2,0,0,3,267
500210409,284,4,2,4,3,0,5,302
500210410,211,19,9,1,3,0,7,250
500210411,343,6,1,1,8,0,5,364
500210412,332,2,1,7,3,1,20,366
500210413,234,13,19,0,0,1,6,273
500210414,297,2,0,0,0,0,4,303
500210415,148,7,0,2,0,0,3,160
500210416,181,13,6,5,6,0,10,221
500210417,209,3,2,3,1,0,7,225
500210418,308,5,2,9,3,0,13,340
500210419,121,2,0,2,0,0,1,126
500210420,161,1,4,6,2,0,6,180
500210501,145,5,3,1,1,0,3,158
500210502,194,4,1,0,3,0,1,203
500210503,240,4,0,3,0,0,6,253
500210504,41,1,0,1,0,1,0,44
500210505,242,9,1,1,8,0,0,261
500210506,293,5,2,0,3,0,2,305
500210507,284,6,1,5,4,0,3,303
500210508,361,20,6,6,5,0,4,402
500210509,356,6,1,0,2,0,5,370
500210510,255,3,2,2,0,0,5,267
500210511,233,9,2,0,2,0,5,251
500210512,262,11,1,2,1,0,2,279
500210513,229,12,2,0,4,1,2,250
500210601,311,14,3,5,11,1,7,352
500210602,249,17,4,3,0,0,9,282
500210603,256,6,5,6,1,1,2,277
500210604,305,6,12,1,3,0,13,340
500210605,327,14,14,4,1,1,4,365
500210606,329,17,9,0,1,0,1,357
500210607,311,8,9,0,2,0,4,334
500210608,382,20,5,4,1,1,8,421
500210609,186,6,2,6,7,1,5,213
500210610,199,8,7,0,1,0,7,222
500210611,259,17,0,2,0,0,8,286
500210612,256,8,2,7,0,0,3,276
500210613,227,17,3,0,0,0,3,250
500210701,257,17,9,3,7,1,16,310
500210702,303,15,4,4,11,1,9,347
500210703,303,21,2,4,7,0,15,352
500210704,251,8,2,1,1,0,12,275
500210705,243,17,2,2,4,0,17,285
500210706,313,31,4,1,0,1,9,359
500210707,219,7,1,1,1,0,10,239
500210708,249,11,1,1,3,0,3,268
500210709,217,14,1,5,0,0,4,241
500210710,152,10,2,2,1,1,3,171
500210801,251,0,0,0,0,0,2,253
500210802,186,4,1,3,2,0,11,207
500210803,238,1,0,0,0,0,1,240
500210804,91,1,0,0,0,0,2,94
500210805,183,2,0,0,0,0,1,186
500210806,294,8,2,0,0,0,5,309
500210807,325,10,1,0,1,0,3,340
500210808,280,7,0,1,0,2,8,298
500210809,193,4,2,0,1,0,3,203
500210810,245,11,1,4,3,0,2,266
500210811,289,13,3,0,0,0,3,308
500210812,153,4,0,0,1,0,1,159
500210813,143,7,0,0,0,0,4,154
500210901,177,4,11,1,16,0,2,211
500210902,284,27,10,2,6,0,12,341
500210903,219,39,8,88,1,5,17,377
500210904,249,30,13,3,4,1,13,313
500210905,300,22,14,5,8,0,10,359
500210906,256,13,10,3,8,2,23,315
500210907,237,12,4,4,17,1,30,305
500210908,132,8,0,2,4,0,9,155
500210909,255,12,2,7,1,0,8,285
500210910,260,15,9,3,5,1,21,314
500210911,317,13,5,3,3,0,16,357
500210912,251,18,5,3,4,0,10,291
500210913,238,16,15,4,5,0,13,291
500210914,179,19,9,6,1,0,8,222
500210915,303,38,20,0,11,3,29,404
500210916,191,17,8,1,6,0,7,230
500210917,156,5,2,4,4,0,6,177
500211001,252,3,7,1,2,1,2,268
500211002,307,2,3,3,8,0,21,344
500211003,200,1,5,1,4,1,6,218
500211004,297,21,11,0,4,0,9,342
500211005,156,13,1,2,4,1,6,183
500211006,338,1,5,2,8,0,15,369
500211007,360,8,11,2,1,0,11,393
500211008,282,16,11,1,12,2,8,332
500211009,286,13,1,7,3,6,16,332
500211010,187,9,1,2,2,1,4,206
500211011,174,7,2,0,3,0,6,192
500211012,160,7,0,0,7,0,5,179
500211101,201,24,18,15,52,1,9,320
500211102,46,7,67,7,15,2,8,152
500211103,143,15,11,0,4,0,7,180
500211104,183,24,16,3,7,0,11,244
500211105,144,13,18,1,10,0,6,192
500211106,248,38,15,2,17,0,12,332
500211107,207,14,3,3,13,1,5,246
500211108,200,22,15,0,13,0,9,259
500211109,240,27,18,9,16,2,16,328
500211110,226,25,19,4,13,0,35,322
500211111,177,5,12,4,23,3,9,233
500211112,203,22,25,56,2,1,6,315
500211201,141,6,1,2,4,1,3,158
500211202,302,17,1,5,2,1,8,336
500211203,156,10,2,0,0,2,1,171
500211204,192,4,4,4,0,0,9,213
500211205,300,11,0,0,0,0,11,322
500211206,176,3,0,0,0,0,3,182
500211207,240,5,0,0,0,0,0,245
500211208,204,6,0,1,0,0,1,212
500211209,256,15,7,5,4,1,5,293
500211210,234,10,0,1,0,0,7,252
500211211,251,16,8,4,13,3,15,310
500211301,194,9,2,8,1,2,5,221
500211302,161,0,1,3,1,1,6,173
500211303,339,0,11,1,2,0,8,361
500211304,300,2,4,9,3,0,12,330
500211305,312,21,11,1,10,0,3,358
500211306,223,9,3,0,0,0,10,245
500211307,330,2,2,4,0,0,3,341
500211308,223,1,8,6,0,1,3,242
500211309,303,1,1,0,3,0,3,311
500211310,242,0,3,2,5,0,7,259
500211311,322,20,1,1,0,1,9,354
500211312,268,2,3,4,0,0,9,286
500211313,395,1,15,4,3,2,11,431
500211314,219,13,1,2,1,1,3,240
500211315,215,3,3,1,0,2,5,229
500211401,125,0,0,0,0,0,0,125
500211402,201,4,1,0,0,0,0,206
500211403,291,3,0,0,2,0,1,297
500211404,201,0,0,1,0,0,1,203
500211405,262,4,1,1,0,0,0,268
500211406,296,7,2,0,0,0,1,306
500211407,325,8,0,0,0,0,3,336
500211408,223,1,1,0,0,0,6,231
500211409,181,4,0,21,0,0,4,210
500211410,265,22,0,13,0,1,5,306
500211501,411,13,29,10,13,2,23,501
500211502,283,21,37,3,32,1,21,398
500211503,123,2,9,3,24,3,13,177
500211504,172,11,6,1,18,4,12,224
500211505,188,18,25,1,3,3,7,245
500211506,171,24,14,1,3,0,6,219
500211507,293,16,19,4,9,2,24,367
500211508,156,15,2,6,10,1,9,199
500211509,156,7,5,2,2,4,8,184
500211601,398,8,1,0,0,0,2,409
500211602,325,0,0,0,1,0,0,326
500211603,210,4,0,0,0,0,3,217
500211604,347,5,3,0,0,0,3,358
500211605,253,2,2,1,2,0,3,263
500211606,324,14,0,0,0,1,3,342
500211607,301,1,1,0,1,0,6,310
500211608,293,3,0,0,0,1,3,300
500211609,177,1,1,0,0,0,4,183
500211610,147,5,0,1,1,0,1,155
500280101,115,5,5,2,8,0,3,138
500280102,197,9,9,0,5,1,10,231
500280103,219,10,2,2,9,0,15,257
500280104,173,6,22,2,5,0,18,226
500280105,230,6,29,3,12,1,18,299
500280106,317,23,27,4,6,2,23,402
500280107,235,13,12,0,18,1,18,297
500280108,251,8,12,0,37,2,13,323
500280109,216,22,8,1,8,0,11,266
500280110,267,11,16,6,10,0,12,322
500280111,320,20,7,3,14,3,24,391
500280112,163,18,12,5,1,3,10,212
500280201,257,3,4,6,1,2,7,280
500280202,236,5,7,0,7,0,9,264
500280203,230,5,6,2,1,1,3,248
500280204,175,5,2,0,2,0,6,190
500280205,276,13,3,2,6,0,8,308
500280206,321,26,8,5,7,0,6,373
500280207,234,12,15,5,6,0,7,279
500280208,199,17,3,1,3,6,26,255
500280209,275,7,6,4,2,1,31,326
500280210,197,9,3,1,4,0,11,225
500280211,280,17,22,3,5,2,7,336
500280212,309,15,17,4,10,0,20,375
500280213,175,9,3,0,0,0,12,199
500280214,182,12,1,2,2,0,10,209
500280301,319,6,4,29,3,2,2,365
500280302,310,7,2,1,0,0,6,326
500280303,180,1,0,1,0,0,2,184
500280304,305,12,0,2,0,0,1,320
500280305,208,5,0,0,0,0,0,213
500280306,251,12,0,5,1,0,5,274
500280307,280,9,8,1,3,0,2,303
500280308,292,9,0,3,0,0,5,309
500280309,245,24,5,0,0,0,9,283
500280310,328,20,3,3,2,0,10,366
500280311,313,16,4,2,1,0,5,341
500280312,315,14,6,2,2,1,8,348
500280313,371,14,13,6,2,0,4,410
500280314,353,10,6,3,6,0,5,383
500280315,466,19,4,4,4,0,5,502
500280316,210,3,0,1,0,0,5,219
500280317,296,9,6,7,3,0,5,326
500280401,205,6,0,5,1,12,5,234
500280402,204,4,5,3,4,1,6,227
500280403,402,11,7,17,1,16,13,467
500280404,223,4,2,2,1,2,4,238
500280405,228,5,4,11,3,1,5,257
500280406,260,12,3,5,2,5,7,294
500280407,251,2,4,10,0,2,6,275
500280408,248,8,1,3,1,1,5,267
500280409,333,10,6,14,2,0,11,376
500280410,216,3,0,1,0,0,3,223
500280411,250,2,0,0,0,0,3,255
500280412,251,1,3,1,0,1,1,258
500280413,352,6,7,1,0,0,5,371
500280414,279,8,3,2,1,0,10,303
500280415,286,14,7,3,3,0,8,321
500280501,156,1,1,0,0,0,0,158
500280502,324,3,1,2,1,0,6,337
500280503,325,6,3,12,0,2,11,359
500280504,240,8,2,3,0,0,5,258
500280505,167,5,1,0,0,0,5,178
500280506,249,7,1,7,0,0,9,273
500280507,493,20,8,7,1,11,28,568
500280508,470,13,0,5,0,3,10,501
500280509,316,18,4,9,0,6,10,363
500280510,335,24,0,8,4,21,5,397
500280511,417,15,3,12,0,7,22,476
500280512,178,7,0,2,1,1,4,193
500280513,297,20,0,8,0,23,3,351
500280514,286,15,2,3,0,8,3,317
500280515,204,5,4,2,0,1,4,220
500280516,415,8,1,12,0,8,15,459
500280517,517,13,4,13,0,1,9,557
500280518,148,1,0,1,0,0,3,153
500280519,261,3,2,0,0,3,4,273
500280520,173,10,0,4,0,10,24,221
500280601,216,0,1,0,0,0,1,218
500280602,188,0,2,1,0,0,2,193
500280603,184,0,4,0,1,0,0,189
500280604,355,0,5,4,2,0,11,377
500280605,240,1,1,126,0,0,10,378
500280606,402,0,0,1,1,0,2,406
500280607,287,3,0,2,1,0,3,296
500280608,243,0,3,3,1,0,4,254
500280609,95,0,0,0,0,1,2,98
500280610,260,2,3,3,2,0,7,277
500280611,210,0,2,1,2,0,2,217
500280612,85,0,0,0,0,1,2,88
500280613,269,0,1,0,0,0,9,279
500280614,312,0,2,0,1,0,1,316
500280701,209,12,1,4,3,0,4,233
500280702,221,15,2,8,1,1,2,250
500280703,219,10,4,5,0,2,4,244
500280704,302,18,3,21,1,0,8,353
500280705,159,12,0,11,1,1,3,187
500280706,282,6,11,6,3,0,14,322
500280707,266,16,12,3,3,0,3,303
500280708,253,10,9,2,1,0,0,275
500280709,308,7,0,0,1,0,2,318
500280710,202,9,1,3,6,1,1,223
500280711,270,19,32,31,0,2,2,356
500280712,295,11,12,31,0,3,3,355
500280801,266,14,33,4,11,0,4,332
500280802,169,10,0,2,4,0,2,187
500280803,195,8,7,0,5,0,6,221
500280804,195,21,5,0,0,1,6,228
500280805,282,34,12,8,5,0,11,352
500280806,235,10,21,6,3,3,12,290
500280807,271,12,6,6,1,0,10,306
500280808,266,8,4,1,1,0,13,293
500280809,267,9,4,1,1,0,3,285
500280810,234,15,4,8,1,0,2,264
500280811,336,8,4,0,1,0,2,351
500280812,298,8,15,0,1,0,43,365
500280813,290,22,3,3,1,0,5,324
500280814,164,10,2,3,0,0,5,184
500280815,309,6,10,5,3,0,7,340
500280816,213,19,2,3,2,9,5,253
500280817,220,12,15,1,2,0,5,255
500280818,144,3,2,2,3,0,3,157
500280819,155,13,20,1,4,0,6,199
500280820,185,19,10,8,3,0,6,231
500280901,289,19,18,2,8,0,4,340
500280902,238,17,8,2,8,0,4,277
500280903,296,15,3,2,15,0,4,335
500280904,176,5,4,2,2,2,5,196
500280905,304,15,2,0,2,0,3,326
500280906,349,10,6,2,2,0,4,373
500280907,165,20,17,35,2,0,0,239
500280908,360,13,1,2,13,0,8,397
500280909,261,6,10,3,8,1,11,300
500280910,334,17,11,8,6,0,3,379
500280911,152,17,17,2,6,1,7,202
500280912,274,10,3,6,3,0,9,305
500280913,282,13,2,1,4,1,2,305
500280914,174,8,3,3,2,0,1,191
500281001,289,6,4,2,6,1,21,329
500281002,208,8,1,1,0,0,8,226
500281003,184,6,4,3,0,0,13,210
500281004,322,9,5,2,0,0,9,347
500281005,183,5,3,3,2,1,12,209
500281006,301,11,13,7,2,1,3,338
500281007,343,23,7,5,9,0,20,407
500281008,365,7,6,8,6,2,7,401
500281009,234,5,6,4,2,0,13,264
500281010,320,26,12,11,3,1,7,380
500281101,199,1,0,0,0,0,1,201
500281102,223,5,1,0,0,0,1,230
500281103,357,10,5,4,2,1,6,385
500281104,314,13,0,2,1,0,7,337
500281105,259,7,1,1,0,0,4,272
500281106,235,10,0,0,0,0,4,249
500281107,256,1,1,1,0,0,2,261
500281108,261,13,0,0,2,0,8,284
500281109,281,12,7,1,1,0,3,305
500281110,320,13,4,2,0,0,6,345
500281111,202,10,5,2,0,2,6,227
500281112,278,11,6,2,2,0,9,308
500281113,186,10,9,1,0,0,4,210
500281114,196,10,3,0,0,0,1,210
500281115,235,6,4,1,0,0,1,247
500281116,201,3,1,1,1,1,7,215
500281117,221,4,2,2,1,0,2,232
500281118,188,12,3,1,0,0,2,206
500281201,414,0,6,30,0,0,1,451
500281202,267,1,1,1,0,0,3,273
500281203,271,0,4,0,0,0,4,279
500281204,279,0,3,1,0,0,3,286
500281205,252,0,0,1,0,0,3,256
500281206,271,0,3,0,3,1,3,281
500281207,220,1,4,7,0,0,8,240
500281208,174,0,4,10,0,0,0,188
500281209,279,1,0,3,0,0,4,287
500281210,321,0,5,1,1,0,4,332
500281211,223,3,0,215,0,0,10,451
500281212,228,0,0,1,1,0,2,232
500281213,215,0,6,4,0,1,2,228
500281214,239,1,1,1,0,0,2,244
500281215,224,4,2,0,0,0,3,233
500281216,292,15,7,0,2,1,3,320
500281217,276,8,1,3,2,0,12,302
500281218,257,13,0,4,3,1,6,284
500281219,352,7,7,6,1,0,11,384
500281301,301,32,4,2,3,0,10,352
500281302,305,18,5,4,6,1,7,346
500281303,347,16,4,1,2,3,5,378
500281304,304,9,5,4,6,0,10,338
500281305,281,11,18,9,5,0,8,332
500281306,187,11,4,7,0,2,6,217
500281307,164,1,6,1,2,1,20,195
500281308,284,27,5,3,1,0,7,327
500281309,191,13,4,1,0,0,2,211
500281310,279,32,14,15,4,0,3,347
500281311,208,12,2,4,3,0,6,235
500281312,186,15,6,3,4,1,13,228
500281401,179,12,6,20,2,3,4,226
500281402,208,15,7,0,13,0,2,245
500281403,211,31,12,1,2,2,13,272
500281404,306,14,23,2,3,5,1,354
500281405,312,18,20,7,3,2,1,363
500281406,246,8,5,0,3,1,4,267
500281407,273,9,11,32,3,0,2,330
500281408,290,10,6,5,3,0,10,324
500281409,286,8,7,0,13,0,1,315
500281410,249,7,4,0,3,0,3,266
500281411,226,4,0,1,4,1,15,251
500281412,325,7,7,0,6,0,4,349
500281413,270,9,28,0,1,0,8,316
500281414,220,20,22,26,1,0,2,291
500281415,216,1,2,13,0,0,7,239
500281501,298,7,0,3,0,6,12,326
500281502,470,45,0,20,0,10,5,550
500281503,131,8,1,1,0,0,0,141
500281504,240,36,0,1,0,3,13,293
500281505,368,13,2,1,0,0,0,384
500281506,357,6,4,2,0,12,9,390
500281507,279,5,0,5,0,0,2,291
500281508,246,28,3,11,0,9,4,301
500281601,243,12,5,3,3,0,9,275
500281602,196,23,0,1,11,0,2,233
500281603,212,14,3,5,2,0,7,243
500281604,283,17,20,3,4,1,21,349
500281605,360,21,2,5,3,0,6,397
500281606,186,8,3,20,1,0,7,225
500281607,179,7,2,4,5,0,5,202
500281608,333,19,8,4,6,1,22,393
500281609,372,27,9,7,6,1,9,431
500281610,292,25,9,5,1,0,9,341
500281611,331,24,10,4,3,0,23,395
500281701,164,3,1,3,1,1,2,175
500281702,259,14,4,1,3,0,15,296
500281703,320,9,1,0,1,0,7,338
500281704,206,13,2,3,2,0,2,228
500281705,226,5,4,0,2,0,7,244
500281706,355,11,5,10,0,0,14,395
500281707,381,18,8,36,0,4,12,459
500281708,240,6,0,2,2,0,9,259
500281709,157,3,4,28,0,0,3,195
500281710,237,4,7,6,8,0,5,267
500281711,121,3,1,2,0,0,5,132
500281712,491,20,5,13,3,6,21,559
500281713,242,7,3,6,2,4,17,281
500281714,204,3,2,6,1,15,9,240
500281715,220,7,4,1,0,4,18,254
500281716,306,10,1,14,2,11,13,357
500281801,259,7,3,5,0,1,2,277
500281802,297,11,2,5,1,0,4,320
500281803,360,3,0,5,2,0,0,370
500281804,294,9,5,1,0,1,19,329
500281805,359,16,3,5,2,0,7,392
500281806,222,4,1,1,0,0,8,236
500281807,347,7,0,3,1,0,12,370
500281808,245,11,0,14,1,2,0,273
500281809,293,10,3,3,0,0,2,311
500281810,268,9,3,6,2,0,3,291
500281811,235,7,1,12,11,4,6,276
500281812,213,4,6,7,2,2,7,241
500281901,373,18,4,6,0,1,2,404
500281902,221,3,2,2,0,2,14,244
500281903,176,3,21,6,0,0,4,210
500281904,281,7,0,4,0,0,11,303
500281905,475,11,3,6,0,0,5,500
500281906,303,3,1,2,1,1,6,317
500281907,176,10,3,1,0,0,3,193
500281908,315,6,4,4,0,0,5,334
500281909,342,7,4,0,0,1,6,360
500281910,308,11,3,2,0,0,10,334
500282001,336,49,4,2,17,0,19,427
500282002,237,13,2,2,1,0,8,263
500282003,195,8,2,1,1,0,6,213
500282004,163,6,5,0,0,0,2,176
500282005,215,4,5,8,4,0,12,248
500282006,273,16,7,0,0,0,19,315
500282007,301,26,2,4,10,1,8,352
500282008,190,22,1,0,3,0,5,221
500282009,331,21,29,1,2,4,17,405
500282010,192,4,4,0,1,3,10,214
500282011,231,16,3,1,6,2,3,262
500350101,406,0,6,2,2,1,1,418
500350102,219,0,0,7,2,5,31,264
500350103,256,1,1,9,1,5,10,283
500350104,219,0,5,1,1,0,11,237
500350105,256,3,0,7,1,4,14,285
500350201,350,16,11,11,3,9,45,445
500350202,314,13,2,4,2,9,22,366
500350203,461,19,10,9,0,6,12,517
500350204,226,2,6,0,3,0,1,238
500350205,313,11,2,1,0,0,4,331
500350206,166,10,5,0,4,0,6,191
500350207,283,9,2,2,1,1,1,299
500350208,221,5,0,6,1,1,2,236
500350209,367,16,8,3,7,0,5,406
500350210,304,16,1,6,0,1,2,330
500350211,236,2,0,0,0,2,2,242
500350212,253,14,6,2,3,0,5,283
500350213,241,6,1,1,0,0,4,253
500350214,327,11,3,9,4,6,12,372
500350215,234,8,0,1,0,1,2,246
500350216,433,1,1,4,2,3,18,462
500350217,220,2,3,0,1,1,2,229
500350218,273,7,3,1,0,0,1,285
500350301,465,16,1,6,7,15,25,535
500350302,335,11,1,8,0,8,13,376
500350303,321,16,1,6,1,10,4,359
500350401,110,5,0,0,1,1,7,124
500350402,131,15,0,0,0,3,19,168
500350403,365,18,0,4,2,5,15,409
500350404,148,2,0,0,0,3,25,178
500350501,511,13,4,5,5,5,7,550
500350502,128,19,0,1,0,4,7,159
500350503,85,4,0,0,0,2,21,112
500350504,361,8,1,2,0,10,30,412
500350505,103,8,1,1,0,2,4,119
500350506,109,6,2,1,1,0,4,123
500350507,199,4,0,3,0,7,18,231
500420101,170,0,3,2,1,14,5,195
500420102,78,2,1,0,1,16,19,117
500420201,48,0,1,0,0,6,15,70
500420301,47,3,0,0,0,9,1,60
500420302,29,0,0,0,0,8,2,39
500420401,57,18,0,1,0,0,0,76
500420402,104,8,0,3,1,7,13,136
500420403,122,12,3,3,1,16,6,163
500420404,237,13,2,6,3,0,14,275
500420405,174,11,2,1,9,2,11,210
500420406,373,36,4,1,3,4,19,440
500420407,244,23,0,3,2,0,5,277
500420408,282,11,0,0,4,3,5,305
500420409,175,22,0,2,0,0,13,212
500420410,202,16,0,0,0,0,11,229
500420411,196,14,0,0,0,0,4,214
500420412,76,17,0,2,1,0,0,96
500490101,4,0,0,0,0,0,3,7
500490201,390,27,0,14,1,6,28,466
500490202,64,1,0,2,7,1,0,75
500490203,175,4,0,0,0,0,6,185
500490204,279,3,0,3,0,1,5,291
500490205,293,5,1,0,0,1,6,306
500490206,290,5,0,0,0,0,1,296
500490207,373,7,5,1,0,0,4,390
500490208,228,6,2,2,0,0,2,240
500490209,263,10,0,0,1,0,2,276
500490210,318,8,0,1,0,0,8,335
500490211,246,1,1,2,0,0,3,253
500490212,328,5,0,1,0,1,3,338
500490213,350,7,0,3,4,0,10,374
500490214,222,7,0,2,0,0,0,231
500490215,185,0,0,1,0,0,2,188
500490216,328,3,1,1,1,0,3,337
500490217,211,7,1,2,1,0,2,224
500490218,260,8,0,0,0,2,2,272
500490219,398,11,1,0,0,0,6,416
500490220,254,2,0,3,0,1,9,269
500490221,376,12,0,1,0,0,3,392
500490301,205,5,1,13,0,0,13,237
500490302,287,14,2,4,0,2,21,330
500490303,278,2,1,2,2,0,4,289
500490304,329,0,4,2,3,1,13,352
500490305,307,2,2,6,8,1,6,332
500490306,332,8,5,5,1,3,2,356
500490307,16,0,0,0,0,0,0,16
500490308,252,0,0,0,0,0,10,262
500490309,428,10,2,5,1,2,6,454
500490310,180,6,1,0,0,0,7,194
500490311,197,1,1,0,0,1,2,202
500490312,261,4,11,3,8,0,9,296
500490313,411,23,3,27,0,32,19,515
500490314,406,4,0,4,1,4,9,428
500490315,312,12,1,12,0,2,25,364
500490316,254,2,0,0,0,0,2,258
500490317,257,9,1,2,1,0,2,272
500490318,181,1,1,1,0,0,3,187
500490319,221,14,0,1,3,0,2,241
500490320,265,4,0,9,2,1,3,284
500490321,294,0,5,8,0,7,3,317
500490401,229,5,6,2,0,0,5,247
500490402,326,8,7,7,4,0,16,368
500490403,324,12,8,1,7,1,16,369
500490404,315,20,7,2,7,2,8,361
500490405,217,7,5,0,0,0,9,238
500490406,218,6,6,5,3,0,5,243
500490407,271,17,6,7,2,2,74,379
500490408,191,15,2,3,4,3,131,349
500490409,357,9,9,5,2,1,4,387
500490410,244,5,5,0,0,0,8,262
500490411,337,15,14,10,3,0,7,386
500490412,236,7,7,5,4,0,9,268
500490413,129,5,2,3,2,0,72,213
500490414,290,11,8,5,12,0,65,391
500490501,7,3,0,0,0,0,4,14
500490502,135,12,0,0,0,0,2,149
500490503,353,63,3,20,1,36,32,508
500490504,354,53,11,14,1,8,10,451
500490505,449,35,3,13,1,5,28,534
500490506,153,6,11,28,2,131,23,354
500490507,337,23,3,62,2,71,12,510
500490601,0,1,0,0,0,0,0,1
500490602,45,16,0,0,1,6,0,68
500490603,52,24,0,0,0,0,0,76
500490701,205,5,0,7,0,0,2,219
500490702,220,5,1,2,0,0,5,233
500490703,207,3,1,0,0,0,5,216
500490704,322,5,0,1,0,0,2,330
500490705,317,13,1,2,0,0,10,343
500490706,196,11,2,2,1,1,2,215
500490707,195,2,2,2,1,0,2,204
500490708,177,1,0,1,0,1,3,183
500490709,243,11,13,8,3,0,95,373
500490710,142,4,2,2,0,0,6,156
500490711,247,0,5,2,0,0,8,262
500490712,232,9,7,2,2,0,40,292
500490713,265,0,10,3,3,0,15,296
500490714,137,1,11,0,0,0,13,162
500490715,261,22,5,2,4,0,6,300
500490801,269,8,2,3,0,0,18,300
500490802,337,3,0,1,2,0,14,357
500490803,205,12,2,1,1,0,9,230
500490804,293,8,1,8,1,1,4,316
500490805,347,5,0,0,1,0,5,358
500490806,249,8,3,0,0,0,1,261
500490807,303,6,2,4,2,0,7,324
500490808,365,0,2,1,1,0,6,375
500490809,291,5,1,0,1,1,0,299
500490810,255,8,5,0,0,1,6,275
500490811,300,4,0,1,0,0,1,306
500490812,374,3,9,7,1,1,2,397
500490813,146,3,1,1,1,0,6,158
500490814,328,12,4,1,1,0,4,350
500490815,316,16,5,8,2,2,10,359
500490816,173,5,0,1,0,0,0,179
500490817,313,9,7,2,1,0,11,343
500490818,234,6,3,5,0,0,7,255
500490819,191,2,1,1,0,0,5,200
500490820,228,6,5,1,2,0,2,244
500490901,356,5,11,2,1,0,15,390
500490902,210,8,0,3,0,1,2,224
500490903,173,11,6,1,0,0,5,196
500490904,174,8,8,2,2,0,2,196
500490905,316,13,4,4,5,0,8,350
500490906,287,6,34,4,2,2,0,335
500490907,269,11,12,1,0,0,6,299
500490908,185,10,9,1,0,0,79,284
500490909,277,8,6,1,0,0,4,296
500490910,259,6,1,3,0,0,5,274
500490911,366,25,5,0,1,8,4,409
500490912,168,2,4,3,2,0,3,182
500490913,220,10,2,4,1,0,4,241
500490914,273,19,1,2,8,0,16,319
500490915,277,8,10,3,4,0,7,309
500490916,267,9,3,2,0,0,6,287
500490917,219,1,6,1,4,0,12,243
500490918,203,6,2,19,0,1,6,237
500490919,158,0,4,2,8,1,2,175
500491001,410,17,5,16,2,0,16,466
500491002,320,5,3,3,1,1,3,336
500491003,164,1,6,17,8,1,8,205
500491004,141,0,2,1,1,0,1,146
500491005,227,3,3,6,0,0,38,277
500491006,175,0,1,2,0,0,7,185
500491007,312,3,1,1,1,0,2,320
500491008,178,17,3,13,2,4,195,412
500491009,210,1,7,2,0,0,0,220
500491010,273,12,4,2,6,0,9,306
500491011,247,16,3,3,0,0,5,274
500491012,289,13,10,2,1,0,4,319
500491013,204,14,10,6,4,0,10,248
500491101,7,1,0,0,0,0,0,8
500491102,25,2,0,0,0,0,2,29
500491103,316,2,1,3,0,0,8,330
500491104,123,1,1,9,0,61,23,218
500491105,145,5,1,81,1,86,12,331
500491106,162,6,3,18,1,27,11,228
500491107,119,11,0,138,0,0,8,276
500491108,172,23,0,11,0,1,4,211
500491109,194,10,4,85,0,1,6,300
500491110,347,4,5,2,2,2,5,367
500491111,223,6,3,0,2,1,3,238
500491112,337,4,4,1,0,0,10,356
500491113,89,5,0,0,1,0,0,95
500491114,199,2,0,0,0,0,1,202
500491115,157,6,0,1,0,0,2,166
500491116,249,2,6,1,0,0,0,258
500491117,284,1,3,1,0,0,4,293
500491118,190,3,2,0,0,0,1,196
500491119,240,3,4,4,0,0,3,254
500491201,158,7,2,0,1,2,2,172
500491202,258,4,2,12,0,0,11,287
500491203,333,1,2,2,0,0,5,343
500491204,188,7,0,35,0,0,31,261
500491205,300,5,2,4,0,0,9,320
500491206,247,15,7,10,1,0,6,286
500491207,324,9,5,0,0,1,3,342
500491208,204,8,3,21,0,1,4,241
500491209,182,12,1,3,0,0,4,202
500491210,221,6,1,3,1,0,6,238
500491211,167,4,2,2,1,3,3,182
500491212,330,5,2,4,0,0,20,361
500491213,220,5,1,4,0,0,3,233
500491214,228,9,3,0,1,0,14,255
500491215,364,11,4,5,4,3,5,396
500491216,316,2,5,1,3,0,6,333
500491217,232,3,5,2,0,0,4,246
500491301,250,0,1,0,0,0,3,254
500491302,445,2,1,5,0,0,0,453
500491303,248,0,2,5,1,0,1,257
500491304,269,6,1,1,0,0,2,279
500491305,204,0,0,1,0,0,0,205
500491306,179,2,0,0,0,0,1,182
500491307,353,7,7,1,1,0,7,376
500491308,343,4,4,2,0,0,7,360
500491309,322,15,1,0,1,0,5,344
500491310,330,12,8,1,2,0,10,363
500491311,326,6,3,4,11,0,5,355
500491312,395,2,6,2,0,0,7,412
500491313,221,5,2,0,4,0,2,234
500491314,174,4,4,3,1,0,0,186
500491401,262,13,3,45,1,0,5,329
500491402,377,17,2,3,1,0,14,414
500491403,260,10,3,0,2,0,3,278
500491404,144,4,3,103,0,0,1,255
500491405,308,7,2,14,6,0,3,340
500491406,338,6,3,0,4,1,5,357
500491407,307,8,1,5,2,1,5,329
500491408,292,3,2,5,1,2,4,309
500491409,243,3,0,0,0,0,5,251
500491410,279,3,8,16,0,0,3,309
500491411,134,5,2,48,0,1,2,192
500491412,282,3,0,5,1,1,4,296
500491413,284,7,0,0,0,1,0,292
500491414,183,16,2,10,0,1,4,216
500560101,232,73,0,2,1,5,31,344
500560201,295,37,1,0,4,7,37,381
500560301,221,7,0,2,0,14,21,265
500560401,153,6,2,3,0,4,10,178
500560402,221,11,2,1,2,0,22,259
500560403,343,31,0,10,1,5,7,397
500560404,373,24,2,8,0,3,37,447
500560405,182,6,0,2,3,1,5,199
500560406,262,8,0,7,0,1,26,304
500560407,468,22,3,6,0,7,15,521
500560408,180,7,2,2,0,1,2,194
500560409,299,16,9,1,2,1,7,335
500560501,263,21,1,0,1,11,26,323
500560502,118,7,0,0,1,1,21,148
500560503,191,7,1,2,0,1,23,225
500560504,274,10,0,6,2,3,32,327
500560505,136,29,0,3,1,49,27,245
500560506,203,9,0,1,1,3,17,234
500560507,259,11,2,4,0,0,2,278
500560601,109,9,0,1,0,1,15,135
500560602,239,12,1,6,4,5,33,300
500560603,298,28,1,4,12,3,14,360
500560604,380,11,1,9,1,4,40,446
500560605,375,12,1,3,4,2,9,406
500560606,376,9,1,9,3,3,9,410
500560607,104,2,0,1,0,1,4,112
500560608,217,12,0,3,1,4,13,250
500560609,305,14,1,2,1,2,25,350
500560610,218,25,0,6,3,2,16,270
500560611,273,7,0,0,0,0,4,284
500560612,204,5,0,10,0,3,16,238
500560613,223,7,1,4,0,0,0,235
500560614,68,7,2,9,1,1,17,105
500560615,275,12,2,8,0,14,48,359
500560616,112,5,0,1,0,0,3,121
500560701,163,9,4,2,0,5,19,202
500630101,269,22,12,8,8,12,17,348
500630102,223,4,1,10,0,5,4,247
500630103,371,11,2,15,1,8,20,428
500630104,301,15,2,16,0,23,5,362
500630105,180,9,8,6,0,6,12,221
500630106,162,17,2,3,2,2,7,195
500630107,326,19,6,22,19,12,25,429
500630108,172,6,1,0,4,9,15,207
500630109,336,0,8,18,0,33,23,418
500630110,167,5,1,8,6,18,9,214
500630111,151,3,1,7,1,9,8,180
500630112,129,15,4,24,1,10,188,371
500630113,272,24,4,48,0,15,8,371
500630201,229,2,2,1,2,0,2,238
500630202,312,17,11,2,2,1,8,353
500630203,287,24,13,4,49,0,17,394
500630204,215,4,1,1,3,0,5,229
500630205,216,14,6,1,7,1,12,257
500630206,140,2,5,1,7,0,7,162
500630207,168,1,1,3,1,0,5,179
500630208,208,12,4,11,7,1,7,250
500630209,185,8,1,3,1,0,2,200
500630210,205,0,13,0,1,0,3,222
500630211,299,7,0,1,0,0,5,312
500630212,204,0,2,2,4,0,9,221
500630213,232,2,5,2,9,0,13,263
500630214,251,17,20,2,50,1,17,358
500630215,247,16,19,6,43,1,34,366
500630216,199,10,3,3,1,1,8,225
500630217,35,3,0,0,0,0,2,40
500630218,244,5,0,1,0,0,1,251
500630301,17,9,0,0,2,0,31,59
500630302,216,5,1,10,5,1,49,287
500630303,51,5,1,1,0,6,35,99
500630304,147,8,4,1,1,0,50,211
500630305,317,22,12,24,2,93,45,515
500630306,317,6,1,1,0,0,5,330
500630307,316,8,4,2,0,5,126,461
500630308,205,0,2,1,0,0,4,212
500630309,302,6,1,0,0,0,3,312
500630310,619,20,3,13,0,7,21,683
500630311,255,10,1,5,1,6,50,328
500630312,437,16,1,19,1,0,157,631
500630401,240,5,0,7,1,11,50,314
500630402,352,10,3,12,6,0,6,389
500630403,282,6,2,2,2,1,7,302
500630404,96,21,0,1,0,2,19,139
500630405,288,3,2,5,0,0,11,309
500630406,518,11,19,14,1,13,21,597
500630407,233,20,0,0,0,7,5,265
500630408,214,6,0,0,1,30,21,272
500630409,315,7,1,4,2,6,14,349
500630410,324,24,7,1,0,2,29,387
500630411,475,35,6,8,15,6,18,563
500630501,279,2,2,5,4,8,31,331
500630502,239,15,4,20,2,229,71,580
500630503,172,4,0,4,0,22,93,295
500630504,196,19,1,5,0,8,60,289
500630601,23,1,0,0,0,0,0,24
500630602,41,0,0,0,0,0,0,41
500630701,7,3,0,0,0,0,8,18
500630702,28,30,9,5,0,142,12,226
500630703,147,33,3,0,0,22,20,225
500630704,59,2,6,4,1,242,133,447
500630705,40,3,5,7,1,188,4,248
500630706,25,11,9,2,0,100,3,150
500630707,53,3,23,9,1,232,20,341
500630801,233,1,6,6,10,1,17,274
500630802,258,5,5,4,1,11,3,287
500630803,252,21,2,6,17,0,4,302
500630804,335,1,9,1,2,4,3,355
500630805,228,8,0,0,2,0,6,244
500630806,133,1,5,4,2,0,131,276
500630807,228,8,3,1,5,3,5,253
500630808,267,0,4,0,3,4,10,288
500630809,317,14,4,14,1,0,8,358
500630810,173,7,2,3,0,1,2,188
500630811,275,6,1,3,4,12,9,310
500630812,327,25,3,18,2,8,4,387
500630813,251,4,2,6,2,26,14,305
500630814,352,5,3,8,1,11,19,399
500630901,267,14,3,13,1,4,3,305
500630902,0,11,4,33,3,10,147,208
500630903,86,0,0,8,1,5,19,119
500630904,253,13,9,5,1,0,69,350
500630905,315,1,1,1,0,1,5,324
500630906,328,19,4,4,6,2,114,477
500630907,346,8,1,4,0,0,9,368
500630908,224,5,5,3,4,0,78,319
500630909,268,3,5,9,1,2,8,296
500630910,263,6,2,2,0,1,3,277
500630911,182,7,4,4,3,0,2,202
500630912,247,3,5,1,1,0,10,267
500630913,230,2,0,1,0,0,12,245
500630914,347,12,2,0,0,0,1,362
500630915,299,6,5,3,1,1,6,321
500631001,216,13,3,17,3,114,16,382
500631002,169,26,0,8,2,42,22,269
500631003,244,17,3,19,1,38,15,337
500631004,166,12,5,8,1,23,8,223
500631005,269,42,4,15,2,23,2,357
500631006,239,2,0,3,0,0,0,244
500631007,193,6,2,3,0,4,3,211
500631008,282,22,7,32,4,21,8,376
500631009,147,2,2,5,0,8,3,167
500631010,303,6,5,2,4,1,2,323
500631011,319,23,10,3,11,4,11,381
500631012,179,6,4,1,4,2,5,201
500631013,320,8,1,13,2,1,6,351
500631014,178,6,2,2,1,0,3,192
500631015,180,33,7,11,0,41,4,276
500631016,77,9,1,2,0,2,0,91
500631017,361,16,10,29,1,88,8,513
500631101,369,18,4,1,3,0,6,401
500631102,137,1,3,0,0,0,107,248
500631103,373,2,1,1,1,0,2,380
500631104,216,15,1,0,0,0,63,295
500631105,322,6,0,0,1,0,5,334
500631106,142,4,0,6,1,0,2,155
500631107,93,6,0,0,0,0,258,357
500631108,262,11,2,1,2,0,1,279
500631109,249,5,1,0,1,0,39,295
500631110,126,8,6,53,0,2,58,253
500631111,161,19,2,27,2,13,3,227
500631112,160,6,1,46,0,7,6,226
500631113,299,6,3,4,4,1,7,324
500631114,303,2,1,1,1,1,5,314
500631115,211,6,3,5,1,3,0,229
500631116,219,7,3,3,2,2,11,247
500700101,217,14,3,6,1,5,17,263
500700102,270,12,2,6,0,20,13,323
500700103,394,16,4,38,5,4,23,484
500700104,150,12,2,3,0,3,12,182
500700105,437,16,1,15,3,8,62,542
500700106,394,19,7,9,9,0,12,450
500700107,132,1,0,7,0,0,3,143
500700108,188,9,0,0,1,0,4,202
500700109,585,6,0,6,1,0,5,603
500700110,682,10,18,8,1,0,11,730
500700111,290,21,2,14,0,2,10,339
500700112,275,24,1,6,1,2,5,314
500700113,213,17,5,12,0,8,18,273
500700114,288,32,3,7,0,21,31,382
500700115,128,6,1,2,2,0,1,140
500700116,501,21,2,6,10,2,10,552
500700117,420,7,0,20,2,0,2,451
500700118,232,6,0,3,1,1,3,246
500700201,185,10,1,5,0,4,31,236
500700202,280,10,0,1,1,12,34,338
500700203,194,4,0,3,2,7,33,243
500700204,282,11,1,9,1,7,20,331
500700205,271,12,1,17,1,1,13,316
500700206,258,16,3,9,2,4,11,303
500700207,476,11,5,9,6,1,11,519
500700208,322,18,3,4,15,0,16,378
500700209,280,6,3,15,6,1,7,318
500700210,327,13,1,19,1,1,18,380
500700211,347,32,3,5,1,3,23,414
500700212,314,8,5,8,0,10,28,373
500700213,364,9,4,16,0,1,5,399
500700214,225,3,5,7,2,2,3,247
500700215,102,7,0,0,0,0,13,122
500700301,420,12,0,13,0,4,22,471
500700302,515,13,4,11,1,11,22,577
500700303,340,22,2,9,0,7,42,422
500700304,271,6,0,3,2,10,26,318
500700305,535,18,0,10,2,0,4,569
500700306,157,4,2,0,0,5,18,186
500700307,169,19,1,4,1,14,13,221
500700308,229,6,2,4,1,0,3,245
500700401,134,6,0,2,2,0,4,148
500700402,315,8,0,4,4,0,10,341
500700403,346,12,1,1,0,1,13,374
500700404,435,7,3,10,0,3,6,464
500700405,373,16,6,13,1,19,16,444
500700406,417,7,5,3,0,4,4,440
500700407,357,9,6,10,2,3,9,396
500700408,443,8,0,2,2,5,2,462
500700409,421,13,0,0,0,0,5,439
500700410,100,8,0,0,0,2,3,113
500700411,296,13,5,0,0,1,8,323
500700412,311,1,0,0,0,0,0,312
500700413,374,4,0,0,2,0,2,382
500700414,295,7,0,7,0,2,7,318
500700415,211,10,0,7,1,6,9,244
500700416,325,11,3,7,0,10,53,409
500700417,324,6,2,6,2,7,9,356
500700418,301,5,6,12,1,23,9,357
500700419,334,15,2,18,0,15,5,389
500700420,302,4,3,12,3,42,10,376
500700421,310,18,3,6,4,2,11,354
500700422,268,5,1,4,0,7,6,291
500700423,319,5,2,4,1,8,21,360
500700424,188,0,5,8,2,5,3,211
500700425,249,12,0,10,1,31,16,319
500700501,493,10,7,12,2,0,7,531
500700502,287,8,3,9,0,0,0,307
500700503,155,7,1,7,3,0,36,209
500700504,223,7,1,5,0,0,1,237
500700505,333,6,0,0,0,0,8,347
500700506,297,3,1,1,1,0,2,305
500700507,248,5,1,4,0,0,3,261
500700508,262,2,3,3,2,0,2,274
500700509,192,0,4,2,4,0,7,209
500700510,351,19,6,1,11,0,2,390
500700511,336,0,5,2,6,0,5,354
500700512,297,10,1,2,4,0,6,320
500700513,288,3,6,5,0,0,2,304
500700514,260,4,5,2,2,0,34,307
500700601,415,4,3,6,1,2,9,440
500700602,428,5,4,5,2,1,4,449
500700603,436,4,9,14,4,0,6,473
500700604,192,1,0,0,5,0,6,204
500700605,240,4,9,2,3,0,5,263
500700606,274,12,1,1,2,0,19,309
500700607,239,12,0,1,5,0,4,261
500700608,383,4,1,8,1,1,8,406
500700609,213,6,2,1,1,0,0,223
500700610,203,2,0,0,2,2,1,210
500700611,193,5,0,2,2,1,4,207
500700612,379,6,0,2,2,0,11,400
500700613,251,20,2,8,1,0,2,284
500700701,215,3,13,2,15,2,22,272
500700702,272,22,9,3,14,1,22,343
500700703,292,13,4,2,6,1,7,325
500700704,182,1,0,0,0,0,31,214
500700705,277,15,0,0,1,1,1,295
500700706,371,5,1,0,0,7,7,391
500700707,260,0,1,2,2,0,6,271
500700708,271,3,12,0,0,1,4,291
500700709,175,7,4,3,2,0,104,295
500700710,162,0,3,2,2,0,7,176
500700711,252,3,12,6,4,0,8,285
500700712,163,2,4,0,4,0,7,180
500700801,284,19,6,25,3,3,14,354
500700802,258,7,4,1,7,0,14,291
500700803,277,5,2,2,0,0,2,288
500700804,325,3,8,0,1,3,7,347
500700805,385,42,8,20,3,0,6,464
500700806,351,7,2,6,1,2,6,375
500700807,196,2,4,4,4,0,0,210
500700808,273,15,1,2,1,2,4,298
500700809,211,7,0,0,1,0,1,220
500700810,351,7,6,3,1,2,11,381
500700811,254,5,1,5,5,4,1,275
500700812,298,14,2,9,1,1,2,327
500700813,211,7,0,8,1,1,2,230
500700814,288,12,4,4,3,0,2,313
500700815,209,7,1,2,0,1,3,223
500700816,312,23,5,26,1,4,9,380
500700901,211,12,0,1,0,0,5,229
500700902,313,0,0,0,0,0,3,316
500700903,576,3,1,3,1,1,5,590
500700904,297,8,4,1,0,1,4,315
500700905,197,4,5,0,2,0,14,222
500700906,158,6,4,1,4,0,7,180
500700907,265,10,11,3,13,0,6,308
500700908,370,3,5,3,0,0,6,387
500700909,194,2,3,1,0,0,2,202
500700910,198,8,1,4,0,0,5,216
500700911,343,10,6,8,1,0,7,375
500700912,260,11,0,3,0,0,1,275
500700913,157,0,0,1,0,0,1,159
500701001,280,0,5,5,1,2,9,302
500701002,256,8,0,5,0,0,3,272
500701003,247,13,4,1,0,1,74,340
500701004,302,13,11,27,4,0,8,365
500701005,144,4,2,0,0,0,7,157
500701006,394,17,3,43,1,21,14,493
500701007,200,11,2,13,0,1,18,245
500701008,187,19,1,5,1,0,0,213
500701009,186,4,1,0,11,0,7,209
500701010,313,9,7,7,10,1,12,359
500701011,189,12,3,2,10,2,5,223
500701012,332,17,3,30,1,8,7,398
500701013,192,14,11,18,0,9,53,297
500770101,82,3,0,0,0,0,3,88
500770102,95,2,0,0,0,3,7,107
500770103,132,5,2,6,1,21,20,187
500770104,89,13,0,0,0,0,5,107
500770105,276,21,0,11,0,1,6,315
500770106,233,17,3,4,3,3,11,274
500770107,224,28,13,3,5,1,9,283
500770108,279,41,13,9,8,6,5,361
500770109,267,30,3,7,7,1,22,337
500770110,260,28,5,7,2,1,11,314
500770111,40,0,0,0,0,1,3,44
500770112,292,23,7,4,2,1,8,337
500770113,301,21,11,4,6,1,10,354
500770114,450,23,1,7,2,3,6,492
500770115,223,15,8,6,1,3,2,258
500770116,211,22,4,6,0,0,3,246
500770117,312,40,12,5,0,3,9,381
500770118,185,16,5,8,0,1,6,221
500770119,300,21,1,9,1,0,2,334
500770120,169,14,0,4,0,6,12,205
500770121,188,18,7,14,0,4,13,244
500770122,344,22,3,11,1,4,11,396
500770123,322,26,1,11,6,1,5,372
500770124,248,23,7,12,2,5,9,306
500770125,272,15,4,2,3,2,1,299
500770126,253,15,0,7,1,0,9,285
500770127,273,15,2,6,0,0,5,301
500770128,4,4,0,1,0,0,2,11
500770201,105,46,4,4,1,2,11,173
500770202,92,43,0,0,0,0,0,135
500770203,18,1,0,0,0,0,10,29
500770301,184,22,0,2,0,0,3,211
500770302,38,9,0,0,0,0,1,48
500770401,14,5,0,0,0,0,0,19
500770402,207,88,5,2,0,8,11,321
500770403,108,28,0,1,0,1,23,161
500840101,324,1,2,4,2,3,7,343
500840102,167,3,0,2,0,1,31,204
500840103,249,15,2,1,1,15,37,320
500840104,235,8,0,3,2,0,13,261
500840105,178,6,0,0,0,1,15,200
500840201,468,6,3,12,1,6,28,524
500840202,282,5,1,5,0,1,11,305
500840203,234,5,2,3,5,3,7,259
500840204,484,26,8,3,0,0,5,526
500840205,351,6,2,5,0,0,4,368
500840206,266,5,3,4,1,8,4,291
500840207,345,13,7,33,1,0,5,404
500840208,213,16,9,7,11,0,15,271
500840209,178,13,8,1,14,2,18,234
500840210,228,8,0,1,0,0,2,239
500840211,290,12,5,3,5,1,14,330
500840212,251,4,14,3,8,0,17,297
500840213,327,23,4,2,8,0,14,378
500840214,312,9,5,5,1,1,4,337
500840215,273,1,0,0,0,0,2,276
500840216,185,4,0,5,0,0,4,198
500840217,95,0,0,0,0,0,4,99
500840301,209,6,0,17,2,1,11,246
500840302,400,9,1,1,0,6,12,429
500840303,252,6,5,3,1,5,38,310
500840304,325,2,2,2,1,8,16,356
500840305,282,12,1,3,2,4,18,322
500840306,239,10,3,3,0,5,19,279
500840307,254,14,0,1,1,4,4,278
500840308,235,19,1,20,1,4,33,313
500840309,249,2,1,0,1,0,5,258
500840401,59,2,0,0,0,0,6,67
500840402,187,14,2,1,0,1,19,224
500840403,300,23,1,1,0,1,13,339
500840404,99,6,0,1,0,3,16,125
500840405,173,11,0,2,0,6,23,215
500840406,193,1,1,2,3,2,5,207
500840407,233,7,1,0,1,5,3,250
500840501,76,1,0,0,0,18,30,125
500840601,48,0,0,1,0,366,5,420
500840701,117,2,0,0,1,13,18,151
500840702,234,27,0,1,0,6,11,279
500840703,156,12,0,0,1,2,17,188
500840704,158,2,1,2,4,10,15,192
500840705,300,7,0,0,0,1,17,325
500840706,161,3,1,0,0,1,21,187
500840801,211,6,2,4,0,1,2,226
500840802,304,8,2,2,0,0,3,319
500840803,334,0,1,3,1,4,9,352
500840804,221,7,2,2,1,0,1,234
500840805,336,15,6,5,0,0,8,370
500840806,387,17,3,4,1,0,10,422
500840807,224,9,6,1,6,0,10,256
500840808,412,7,10,9,4,1,11,454
500840809,345,7,2,8,0,1,4,367
500840810,307,8,2,4,0,0,12,333
500840811,296,19,3,7,2,1,7,335
500840812,361,10,9,3,14,0,5,402
500840813,363,8,0,2,0,0,4,377
500910101,528,23,2,1,0,12,13,579
500910102,137,12,0,6,0,9,11,175
500910103,145,5,1,0,0,12,20,183
500910104,143,18,0,7,1,4,4,177
500910105,390,16,1,9,4,2,6,428
500910106,220,12,1,3,2,1,7,246
500910107,249,16,3,1,6,3,14,292
500910108,337,10,4,22,3,0,7,383
500910109,293,11,8,1,8,0,14,335
500910110,213,6,0,0,3,0,4,226
500910111,351,5,1,3,0,0,4,364
500910112,213,17,1,6,0,2,18,257
500910113,214,2,1,5,0,22,17,261
500910201,303,19,1,4,1,5,26,359
500910202,498,19,2,2,2,1,17,541
500910203,334,14,1,4,0,4,4,361
500910204,341,17,4,4,2,5,5,378
500910205,233,17,1,8,2,3,23,287
500910206,294,18,0,2,0,0,0,314
500910207,250,8,0,2,0,2,3,265
500910208,339,11,3,5,5,1,3,367
500910209,304,13,6,7,1,0,2,333
500910301,233,40,1,0,1,6,19,300
500910302,322,12,0,3,0,10,27,374
500910303,224,18,0,1,0,13,18,274
500910304,227,20,1,7,2,2,8,267
500910305,340,28,2,7,0,1,24,402
500910306,349,15,4,4,1,8,17,398
500910307,259,16,0,5,0,10,11,301
500910401,42,0,0,0,0,5,31,78
500910501,26,0,0,0,0,1,9,36
500910601,79,21,0,0,0,13,10,123
500980101,300,11,0,2,1,5,31,350
500980102,426,5,0,14,5,5,61,516
500980103,244,10,0,0,0,2,58,314
500980104,361,21,0,1,0,5,94,482
500980105,270,1,1,4,1,1,13,291
500980106,380,1,1,3,1,13,26,425
500980107,120,2,0,2,0,0,29,153
500980108,296,4,1,3,7,4,9,324
500980201,23,1,0,0,0,0,4,28
500980202,189,13,1,1,0,8,46,258
500980203,64,0,0,0,0,4,9,77
500980204,119,0,2,0,0,2,26,149
500980205,95,1,0,0,0,8,5,109
500980206,39,0,0,5,0,0,9,53
500980301,246,17,0,1,0,3,26,293
500980302,152,7,0,0,0,2,16,177
500980303,324,11,1,5,0,5,22,368
500980304,221,3,3,6,1,8,26,268
500980305,252,6,3,5,1,6,24,297
500980306,387,15,6,8,4,4,19,443
500980307,163,3,2,4,2,7,8,189
500980308,360,16,3,3,0,1,9,392
500980401,187,11,6,2,2,1,5,214
500980402,284,8,2,0,0,0,6,300
500980403,314,13,3,0,0,0,6,336
500980404,341,6,8,0,4,0,3,362
500980405,298,7,2,0,2,0,4,313
500980406,331,9,5,11,0,0,4,360
500980407,388,33,7,1,0,1,6,436
500980408,279,13,7,3,1,0,12,315
500980409,297,9,6,4,4,2,11,333
500980410,204,18,6,2,8,0,5,243
500980411,274,6,4,0,8,0,5,297
500980412,245,8,3,3,15,0,8,282
500980413,189,14,4,3,10,0,11,231
500980414,21,0,0,0,0,0,0,21
500980415,383,16,3,8,1,1,5,417
500980416,154,6,13,15,0,2,1,191
500980417,374,33,12,10,1,5,4,439
500980501,169,7,2,4,0,4,21,207
500980502,54,0,0,0,0,1,11,66
500980503,247,9,0,6,3,0,14,279
500980504,309,3,1,12,1,0,6,332
500980505,309,3,1,11,1,0,6,331
500980506,331,4,12,6,1,1,1,356
500980507,240,12,0,1,6,0,4,263
500980508,358,7,2,1,0,1,6,375
500980509,144,7,1,0,0,0,0,152
500980510,201,4,0,1,0,0,2,208
500980511,197,12,1,1,14,0,7,232
500980512,380,9,3,31,9,2,15,449
500980601,168,10,0,0,0,9,45,232
500980602,232,5,0,5,2,6,42,292
500980603,247,9,0,0,1,3,28,288
500980604,284,3,1,6,0,1,34,329
500980605,294,24,0,0,0,4,16,338
500980606,298,12,0,1,0,5,14,330
500980607,221,5,1,0,0,0,3,230
500980608,265,18,0,2,1,3,17,306
500980609,241,6,0,0,0,2,15,264
500980610,135,13,1,1,1,5,5,161
500980611,320,7,1,5,0,5,13,351
500980612,225,8,0,1,1,3,29,267
500980701,159,7,0,0,1,3,7,177
500980702,311,6,2,2,0,0,4,325
500980703,224,3,0,1,0,0,2,230
500980704,218,7,1,2,0,1,6,235
500980705,327,5,1,0,1,0,11,345
500980706,277,9,4,2,9,0,7,308
500980707,278,9,1,1,2,0,15,306
500980708,175,2,1,2,0,0,4,184
500980709,260,9,3,5,8,1,4,290
500980710,143,28,12,7,45,2,3,240
500980711,188,12,6,1,8,0,23,238
500980712,213,7,3,3,4,0,8,238
500980713,192,8,0,1,6,0,1,208
500980714,254,4,1,22,3,0,6,290
500980715,477,16,5,28,0,3,4,533
500980716,341,11,5,14,4,2,3,380
500980717,183,10,4,18,6,2,7,230
500980718,253,16,13,18,8,0,17,325
500980719,322,7,0,2,0,0,3,334
500980720,177,8,3,8,15,1,9,221
500980721,203,0,4,2,0,0,1,210
500980722,200,12,1,1,0,0,6,220
500980801,303,5,1,3,1,0,3,316
500980802,387,7,2,3,2,1,6,408
500980803,380,8,0,1,0,0,4,393
500980804,370,1,0,1,1,3,9,385
500980805,420,11,2,7,1,0,8,449
500980806,413,13,10,5,5,0,13,459
500980807,357,18,5,1,10,0,13,404
500980808,339,12,8,3,17,3,17,399
500980809,266,8,2,3,2,0,8,289
500980810,282,8,3,0,1,2,0,296
500980811,328,23,4,1,1,0,3,360
500980812,194,5,1,3,1,1,5,210
500980813,232,10,8,4,2,1,2,259
500980814,201,17,2,1,2,0,11,234
500980815,187,3,6,1,10,5,7,219
500980816,164,14,15,5,7,2,7,214
500980817,176,4,1,1,0,0,10,192
500980818,353,6,1,0,0,0,4,364
500980819,289,1,2,5,4,1,16,318
500980820,242,17,0,4,3,6,7,279
500980821,117,1,1,0,0,0,1,120
500980901,243,10,3,9,3,0,4,272
500980902,155,1,2,3,2,0,4,167
500980903,338,11,3,6,1,0,14,373
500980904,344,10,4,2,1,0,7,368
500980905,295,9,2,3,4,0,8,321
500980906,275,5,2,0,0,0,13,295
500980907,501,24,0,91,0,1,12,629
500980908,262,0,1,0,0,0,1,264
500980909,364,6,0,1,0,1,4,376
500980910,259,6,3,1,0,0,4,273
500980911,286,7,0,2,0,1,3,299
500980912,249,6,0,3,0,0,3,261
501050101,9,1,0,0,0,0,6,16
501050102,337,5,6,9,2,9,23,391
501050103,276,25,2,9,3,20,27,362
501050104,282,8,9,5,0,2,9,315
501050105,253,2,4,18,2,18,14,311
501050106,323,15,3,14,4,18,11,388
501050107,319,9,17,35,1,10,22,413
501050108,357,22,3,5,0,1,3,391
501050109,91,3,2,2,2,2,6,108
501050110,214,2,2,10,0,18,25,271
501050111,290,17,2,4,3,0,14,330
501050112,344,20,2,6,0,17,7,396
501050113,263,8,0,2,0,1,3,277
501050201,3,13,0,0,0,0,2,18
501050202,391,31,5,10,4,12,21,474
501050203,257,4,0,7,1,10,47,326
501050204,407,17,1,4,0,2,8,439
501050205,392,11,3,35,2,13,28,484
501050301,21,0,0,0,0,0,0,21
501050302,214,1,0,3,1,12,56,287
501050303,229,1,0,4,0,1,14,249
501050304,512,0,5,8,2,0,21,548
501050305,198,0,0,1,0,0,8,207
501050306,415,1,12,21,5,25,21,500
501050307,282,0,0,1,0,5,6,294
501050308,188,0,1,0,0,2,1,192
501050309,250,2,0,5,0,0,14,271
501050310,236,2,1,2,1,1,5,248
501050401,294,0,5,13,3,3,6,324
501050402,295,9,5,14,0,5,11,339
501050403,237,1,4,0,0,0,7,249
501050404,158,9,1,0,0,0,2,170
501050405,347,8,6,11,0,3,8,383
501050406,287,3,8,8,2,1,4,313
501050407,362,11,0,1,0,5,2,381
501050408,316,14,5,3,1,0,8,347
501050409,216,7,2,2,1,0,8,236
501050410,207,7,2,3,3,1,6,229
501050411,331,3,12,2,1,0,20,369
501050412,231,2,12,4,5,6,28,288
501050413,298,12,10,6,1,3,3,333
501050414,270,12,3,9,0,2,13,309
501050415,189,4,10,5,8,4,16,236
501050416,241,1,9,4,4,2,10,271
501050417,298,0,9,7,5,0,16,335
501050418,350,0,10,8,2,0,6,376
501050419,364,14,3,0,0,0,12,393
501050420,194,3,6,6,0,0,2,211
501050421,514,14,0,22,0,8,13,571
501050422,98,0,8,1,1,2,2,112
501050501,191,27,24,2,11,0,24,279
501050502,103,36,9,1,19,1,2,171
501050503,185,12,12,3,36,0,2,250
501050504,258,26,9,4,48,6,21,372
501050505,181,3,10,3,6,3,8,214
501050506,266,25,6,3,3,1,6,310
501050507,220,7,0,0,0,0,8,235
501050508,195,7,5,6,3,1,6,223
501050509,238,9,9,4,2,0,7,269
501050510,282,37,6,4,11,0,6,346
501050511,254,39,7,3,21,1,7,332
501050512,190,14,3,2,8,2,7,226
501050513,320,17,4,8,6,3,4,362
501050514,253,16,3,3,1,1,11,288
501050515,254,14,3,1,0,0,3,275
501050516,288,12,6,1,0,2,5,314
501050517,213,30,12,4,8,2,9,278
501050518,155,25,8,2,5,0,11,206
501050519,183,7,1,0,0,0,2,193
501050520,198,10,2,1,0,1,2,214
501050521,170,8,4,4,3,1,5,195
501050601,45,16,0,0,0,14,17,92
501050602,293,20,0,7,2,10,22,354
501050603,50,21,0,2,0,2,12,87
501050604,2,14,0,0,0,0,0,16
501050605,191,25,7,2,4,1,7,237
501050606,283,16,3,3,0,2,27,334
501050607,291,28,3,2,8,1,18,351
501050608,98,8,0,2,0,0,7,115
501050701,8,0,0,0,0,4,4,16
501050702,201,14,0,0,0,8,48,271
501050703,235,4,1,4,0,6,56,306
501050704,262,6,0,4,1,8,29,310
501050705,308,4,1,14,0,3,29,359
501050706,293,0,14,4,2,5,11,329
501050707,223,3,0,1,0,1,16,244
501050708,235,8,1,1,1,1,8,255
501050801,241,3,0,2,2,4,35,287
501050802,150,18,0,0,1,15,34,218
501050803,126,33,0,2,0,1,21,183
501050804,21,0,0,0,0,5,3,29
501050805,8,0,0,0,0,0,8,16
501050806,79,3,0,0,0,20,59,161
501050807,174,0,1,3,0,6,50,234
501050808,112,5,3,0,1,1,9,131
501050901,142,8,0,0,0,0,39,189
501050902,14,10,0,0,0,0,7,31
501050903,223,37,1,2,1,14,55,333
501050904,299,3,1,1,0,9,32,345
501050905,198,22,0,2,0,1,11,234
501050906,287,35,6,0,40,3,34,405
501050907,244,25,1,7,7,3,9,296
501051001,19,3,4,2,0,110,8,146
501051002,282,12,4,8,0,29,20,355
501051003,50,8,0,2,1,22,2,85
501051004,105,26,0,0,0,2,14,147
501051005,46,0,0,0,0,0,22,68
501051006,315,18,4,11,5,16,8,377
501051007,310,19,2,27,2,6,23,389
501051008,353,13,1,6,0,1,2,376
501051009,218,13,0,11,0,5,28,275
501051010,44,9,0,0,0,534,68,655
501051011,212,13,2,4,4,8,7,250
501051012,254,36,7,5,2,128,23,455
501051101,330,7,2,6,1,1,18,365
501051102,266,8,4,1,1,2,18,300
501051103,252,16,3,5,0,0,3,279
501051104,195,20,0,7,0,3,5,230
501051105,555,29,7,5,1,8,26,631
501051106,450,14,1,16,6,6,39,532
501051107,388,39,3,13,0,2,37,482
501051108,179,15,2,1,0,4,21,222
501051109,132,7,2,9,0,2,15,167
501051110,242,25,0,2,1,7,32,309
501051201,112,23,0,5,0,1,8,149
501051202,124,4,2,1,1,6,22,160
501051203,105,12,1,10,0,1,7,136
501051204,82,12,1,0,0,5,18,118
501051205,301,19,3,5,1,0,14,343
501051206,140,14,2,3,0,1,8,168
501051207,89,6,2,0,0,0,23,120
501051208,251,24,4,2,0,3,13,297
501051209,206,4,2,9,0,0,6,227
501051301,180,20,5,1,1,0,6,213
501051302,202,0,1,0,0,0,25,228
501051303,238,4,20,1,2,5,10,280
501051304,182,0,10,4,1,0,22,219
501051305,152,3,7,1,4,12,21,200
501051306,189,0,12,4,6,1,15,227
501051307,238,6,9,4,5,7,16,285
501051308,151,1,7,3,7,5,24,198
501051309,272,1,29,9,61,37,0,409
501051310,276,6,27,6,20,7,19,361
501051311,119,0,25,2,7,21,20,194
501051312,210,11,25,0,42,11,10,309
501051401,305,7,12,8,3,6,9,350
501051402,129,8,3,0,3,1,7,151
501051403,199,4,14,2,1,4,2,226
501051404,203,7,21,1,21,4,26,283
501051405,306,7,26,8,33,1,18,399
501051406,165,3,6,3,9,2,7,195
501051407,164,11,1,20,0,4,14,214
501051408,190,8,4,3,3,9,12,229
501051409,175,3,9,2,2,2,5,198
501051410,208,4,7,2,0,1,6,228
501051411,238,12,11,3,0,4,2,270
501051412,262,4,14,9,8,3,10,310
501051413,319,16,11,3,5,1,6,361
501051501,373,5,20,11,4,1,22,436
501051502,179,2,10,0,0,0,10,201
501051503,214,1,10,1,1,3,17,247
501051504,199,9,11,0,0,3,0,222
501051505,292,17,7,5,0,6,6,333
501051506,237,2,5,3,1,1,7,256
501051507,213,7,4,1,0,0,6,231
501051508,310,12,5,0,0,0,4,331
501051509,221,15,2,1,1,1,13,254
501051510,235,10,11,2,3,0,4,265
501051511,286,7,5,4,1,1,5,309
501051512,178,4,4,3,0,2,3,194
501051513,330,14,10,3,2,1,2,362
501051514,228,7,4,1,0,0,6,246
501051515,164,7,3,1,1,1,2,179
501051516,162,2,3,14,2,1,4,188
501051517,359,15,4,0,0,0,7,385
501051518,364,14,2,7,2,1,5,395
501051519,267,14,1,0,2,0,6,290
501051601,367,9,2,9,3,13,16,419
501051602,433,22,4,9,1,7,15,491
501051603,384,15,1,3,0,16,23,442
501051604,272,8,0,4,2,2,3,291
501051605,453,20,3,14,0,14,18,522
501051606,29,2,0,0,0,0,1,32
501051607,159,24,1,2,0,4,17,207
501051608,63,1,0,7,1,2,8,82
501051609,201,34,0,1,0,7,27,270
501051701,283,7,3,5,0,0,3,301
501051702,246,6,1,5,0,1,3,262
501051703,257,5,3,0,1,0,6,272
501051704,246,8,8,1,1,0,4,268
501051705,212,6,0,1,0,0,3,222
501051706,202,7,0,0,0,0,2,211
501051707,147,3,3,10,0,0,7,170
501051708,239,13,2,0,3,0,6,263
501051709,232,11,2,5,0,0,5,255
501051710,228,2,12,1,4,2,20,269
501051711,277,13,4,5,1,0,11,311
501051712,351,20,9,4,3,1,9,397
501051713,236,10,4,1,3,19,5,278
501051714,167,2,2,0,1,14,3,189
501051801,345,4,17,33,0,2,4,405
501051802,122,0,2,0,1,1,5,131
501051803,224,3,3,5,0,0,0,235
501051804,406,5,4,2,2,0,10,429
501051805,329,0,21,18,0,0,2,370
501051806,281,12,19,5,0,1,7,325
501051807,165,8,1,3,1,0,10,188
501051808,197,13,14,3,2,0,5,234
501051809,225,15,2,4,1,0,5,252
501051810,300,15,14,4,2,1,6,342
501051811,238,9,18,1,0,0,3,269
501051812,209,2,1,0,0,1,7,220
501051813,214,9,9,1,5,2,3,243
501051814,163,3,0,12,0,0,2,180
501051815,290,0,5,1,1,1,28,326
501051816,222,13,6,5,0,1,1,248
501051817,182,7,9,17,0,2,3,220
501051818,287,6,11,2,1,0,0,307
501051901,189,2,7,4,3,2,7,214
501051902,403,1,8,54,8,1,15,490
501051903,175,0,2,6,1,2,4,190
501051904,236,5,0,3,0,3,2,249
501051905,247,5,0,0,1,0,1,254
501051906,419,1,6,8,0,0,15,449
501051907,375,8,6,15,2,2,16,424
501051908,351,8,9,2,2,1,8,381
501051909,295,9,2,4,0,2,3,315
501051910,342,8,0,2,0,1,4,357
501051911,131,5,2,3,0,0,4,145
501051912,300,0,0,0,0,0,2,302
501051913,246,0,1,3,0,0,6,256
501051914,265,2,0,1,1,0,17,286
501051915,146,0,0,5,0,0,1,152
501120101,214,8,0,1,0,7,43,273
501120102,517,6,2,6,0,2,22,555
501120103,205,21,2,1,1,11,39,280
501120104,404,9,1,2,0,7,22,445
501120105,144,20,1,0,0,4,28,197
501120201,299,17,1,5,2,9,25,358
501120202,244,19,2,8,1,1,2,277
501120203,110,1,1,1,2,10,16,141
501120204,369,18,4,2,8,3,6,410
501120205,319,11,2,5,0,5,9,351
501120301,93,15,0,4,0,6,11,129
501120302,203,7,2,9,4,7,51,283
501120303,110,13,0,1,0,8,11,143
501120304,290,20,1,8,2,3,14,338
501120305,271,19,1,6,6,1,6,310
501120401,193,29,0,1,1,12,27,263
501120501,86,14,0,1,0,8,25,134
501120601,134,20,0,1,0,9,36,200
501190101,2,3,0,0,0,0,0,5
501190201,85,11,40,8,1,161,14,320
501190202,137,9,0,8,2,15,20,191
501190203,52,12,0,1,0,31,0,96
501190204,409,30,1,8,4,14,11,477
501190205,354,33,0,5,0,26,40,458
501190206,252,10,0,2,0,8,10,282
501190301,423,4,5,6,2,3,3,446
501190302,355,22,3,4,1,0,5,390
501190303,409,23,9,2,5,0,12,460
501190304,422,16,5,0,6,2,16,467
501190305,384,17,8,6,5,1,8,429
501190306,411,14,4,2,1,0,4,436
501190307,338,9,5,5,0,2,4,363
501190308,522,14,8,8,0,1,10,563
501190309,442,17,3,7,0,1,2,472
501190310,317,7,9,3,0,4,0,340
501190311,259,15,0,6,0,8,16,304
501190312,173,19,0,1,0,6,11,210
501190401,355,11,2,6,4,20,25,423
501190402,148,2,0,4,2,19,18,193
501190403,430,7,1,8,0,11,29,486
501190404,121,6,1,0,2,2,9,141
501190405,139,4,0,0,2,1,15,161
501190406,254,9,2,7,0,19,15,306
501190407,491,5,4,14,6,3,7,530
501190408,438,18,5,19,0,4,11,495
501190409,429,22,1,16,3,10,10,491
501190501,77,12,0,3,2,28,23,145
501190601,256,22,2,10,0,2,3,295
501190602,97,2,1,2,0,0,1,103
501190603,367,14,1,8,1,0,3,394
501190604,347,18,7,5,3,0,9,389
501190605,249,9,7,1,5,0,8,279
501190606,212,3,1,0,1,0,2,219
501190607,298,25,10,44,2,1,9,389
501190608,284,26,6,2,24,3,19,364
501190609,193,16,1,2,10,0,3,225
501190610,259,13,3,2,3,3,16,299
501190611,208,6,0,0,0,0,2,216
501190612,368,7,10,11,1,1,13,411
501190613,566,11,4,3,0,2,8,594
501190614,358,7,1,4,2,3,7,382
501260101,105,1,0,2,1,41,23,173
501260102,8,0,0,0,0,10,0,18
501260201,10,0,0,0,0,0,5,15
501260202,97,3,0,1,0,3,13,117
501260203,82,7,0,1,0,2,15,107
501260204,101,3,0,0,0,7,2,113
501260205,4,2,0,0,0,2,0,8
501260301,761,25,3,16,1,17,18,841
501260302,169,3,2,3,0,1,2,180
501260303,484,21,5,12,6,4,9,541
501260304,387,27,8,1,6,0,8,437
501260305,362,26,7,4,3,1,4,407
501260306,337,12,4,2,3,0,5,363
501260307,280,18,4,13,6,0,3,324
501260308,160,1,5,8,2,8,6,190
501260309,324,21,1,14,1,5,19,385
501260310,239,9,0,1,0,0,3,252
501260311,304,20,2,1,0,0,1,328
501260312,357,12,4,4,0,0,7,384
501260313,231,18,9,3,1,5,15,282
501260314,358,15,4,14,0,1,13,405
501260315,168,17,0,0,1,2,6,194
501260316,200,10,1,13,3,2,5,234
501260317,264,4,6,14,2,5,8,303
501260318,75,5,0,0,0,7,5,92
501260319,281,9,1,1,1,0,3,296
501260401,98,11,0,6,0,5,17,137
501260402,10,2,0,1,0,4,11,28
501260501,695,3,1,12,1,10,14,736
501260502,281,15,1,6,1,9,12,325
501260503,275,1,0,4,1,7,32,320
501260504,331,13,0,6,0,12,13,375
540070101,38,17,0,0,0,0,1,56
540070102,243,11,0,2,0,3,28,287
540070103,309,31,2,2,0,3,13,360
540070104,94,5,1,0,0,1,1,102
540070105,140,10,0,2,0,3,18,173
540070106,5,1,0,0,0,0,12,18
540070107,202,19,0,3,0,2,5,231
540070108,321,19,1,1,0,2,5,349
540070109,254,12,1,0,0,1,6,274
540070110,121,6,0,2,0,0,3,132
540070201,40,10,0,1,0,0,1,52
540070202,24,1,0,0,0,0,4,29
540070301,30,4,0,0,0,0,2,36
540070302,113,11,0,0,1,1,15,141
540070303,308,9,0,3,0,2,37,359
540070304,101,12,0,3,0,4,3,123
540070305,58,9,0,2,0,0,3,72
540070306,45,0,0,2,0,5,29,81
540070307,46,4,0,2,0,0,8,60
540070308,29,1,0,0,0,4,4,38
540070309,25,2,0,0,0,0,17,44
540070310,187,17,0,0,0,0,2,206
540070311,219,12,0,1,0,0,2,234
540070312,337,21,0,35,0,2,12,407
540070313,298,24,0,0,0,0,9,331
540070314,134,10,0,1,0,0,2,147
540070315,240,24,2,1,0,0,0,267
540070316,302,17,1,20,0,0,0,340
540070317,157,9,3,1,0,1,3,174
540070318,296,18,0,0,0,0,7,321
540070319,225,14,3,1,0,1,1,245
540070401,55,13,0,0,0,3,12,83
540070402,71,6,0,0,1,0,18,96
540070403,163,23,0,7,1,0,1,195
540070404,28,1,0,0,0,0,0,29
540070405,10,4,0,0,0,0,0,14
540070406,18,2,0,0,0,0,1,21
540070501,25,0,0,0,0,0,10,35
540070502,70,0,0,0,1,0,9,80
540070503,91,3,0,0,0,9,1,104
540070504,245,22,1,8,0,5,11,292
540070505,6,4,0,0,0,0,1,11
540070506,98,12,1,28,0,4,21,164
540070507,52,11,0,0,0,4,0,67
540070508,321,16,2,14,3,1,15,372
540070509,192,16,2,6,0,0,1,217
540070601,28,17,0,0,2,0,19,66
540070602,290,26,2,5,1,0,9,333
540070603,263,7,1,0,0,0,5,276
540070604,216,11,7,3,2,0,6,245
540070605,224,26,7,3,2,0,7,269
540070606,275,18,5,6,1,0,3,308
540070607,336,16,3,2,0,0,5,362
540070608,169,13,5,0,1,0,5,193
540070609,155,10,7,1,14,0,7,194
540070610,221,21,4,4,1,0,1,252
540070611,240,11,3,1,0,0,1,256
540070612,215,22,6,2,2,0,1,248
540070613,325,29,6,8,0,0,10,378
540070614,199,10,1,1,2,4,5,222
540070615,323,33,0,8,0,0,3,367
540070616,352,15,3,8,1,0,6,385
540070617,207,17,3,1,2,0,11,241
540070618,262,35,17,3,2,1,2,322
540070619,275,24,1,4,0,2,2,308
540070620,96,6,2,0,0,0,3,107
540140101,45,0,0,1,0,1,8,55
540140102,125,15,1,5,0,1,26,173
540140103,291,23,4,4,4,0,7,333
540140104,271,12,2,6,0,0,11,302
540140105,38,3,0,1,0,1,0,43
540140106,71,2,0,1,0,0,19,93
540140107,111,4,0,4,1,0,15,135
540140108,220,3,1,0,1,2,5,232
540140109,296,9,4,5,5,5,5,329
540140110,260,15,5,5,0,1,10,296
540140111,332,19,1,1,2,1,11,367
540140112,85,8,0,4,0,0,1,98
540140201,117,1,0,0,0,0,4,122
540140202,228,18,4,3,0,1,11,265
540140203,197,5,3,3,1,2,8,219
540140204,196,4,9,4,0,1,5,219
540140205,234,8,9,2,5,1,9,268
540140206,157,5,0,0,0,0,0,162
540140207,125,0,4,6,0,1,1,137
540140208,292,4,0,2,1,0,8,307
540140209,285,12,3,3,0,1,2,306
540140210,307,16,3,5,2,1,4,338
540140211,316,8,1,1,0,0,0,326
540140212,238,21,2,5,0,0,4,270
540140301,93,10,0,0,0,0,1,104
540140302,89,1,2,0,0,0,2,94
540140303,317,16,9,2,0,1,4,349
540140304,162,18,1,0,0,1,6,188
540140305,76,4,0,0,1,1,6,88
540140306,32,2,0,1,0,0,0,35
540140307,303,10,0,2,0,1,6,322
540140308,124,4,3,2,0,0,5,138
540140309,166,3,0,2,0,0,4,175
540140401,136,2,0,2,0,1,6,147
540140402,66,8,0,1,0,0,8,83
540140403,83,2,0,0,1,0,9,95
540140404,256,9,1,2,0,0,9,277
540140501,148,4,0,0,0,1,4,157
540140502,201,4,0,3,0,1,3,212
540140503,134,4,1,0,0,1,2,142
540140504,156,6,0,3,0,0,3,168
540140505,247,22,1,3,0,2,1,276
540140506,196,12,0,0,0,0,2,210
540140507,140,9,0,0,0,3,7,159
540140508,276,25,0,5,0,3,3,312
540140509,185,6,0,0,0,1,3,195
540140510,119,4,0,6,0,1,0,130
540140511,365,18,1,12,0,0,7,403
540140512,189,7,1,0,0,2,1,200
540140601,99,1,0,0,0,0,6,106
540140602,262,15,0,0,0,0,1,278
540140603,83,1,0,0,0,0,0,84
540140604,198,12,1,0,0,2,1,214
540140605,112,3,0,0,0,0,8,123
540140606,169,6,0,0,0,0,2,177
540140607,412,15,1,0,2,7,26,463
540140608,307,9,0,0,0,2,1,319
540140609,153,4,0,1,0,0,8,166
540140701,137,19,0,0,0,0,5,161
540140702,86,11,0,0,0,0,6,103
540140703,177,20,1,1,0,1,5,205
540140704,183,7,0,1,0,1,12,204
540140705,135,2,0,1,0,2,5,145
540140801,150,4,0,3,0,0,6,163
540140802,110,7,3,2,1,0,3,126
540140803,49,3,0,0,0,0,9,61
540140804,63,1,0,0,0,0,0,64
540140805,65,0,0,0,0,2,2,69
540140806,281,17,2,1,0,0,18,319
540140807,181,11,0,0,0,2,6,200
540140808,257,14,2,5,0,2,4,284
540140901,83,4,0,1,0,2,9,99
540140902,102,13,0,0,0,1,7,123
540140903,86,0,0,0,0,0,2,88
540140904,36,9,0,0,0,0,0,45
540140905,82,3,0,1,0,0,4,90
540140906,172,7,1,2,0,1,6,189
540141001,115,4,0,0,0,3,1,123
540141002,146,24,1,1,0,0,18,190
540141003,68,12,0,2,0,1,8,91
540141004,110,5,0,1,0,0,1,117
540141005,99,0,0,0,0,0,3,102
540141006,134,7,0,2,0,1,2,146
540210101,62,3,0,3,1,8,10,87
540210102,84,13,0,0,0,0,6,103
540210103,36,2,0,0,0,2,11,51
540210201,39,0,0,0,0,4,3,46
540210202,246,7,0,2,0,2,17,274
540210203,37,5,0,0,0,0,0,42
540210301,41,2,0,1,0,0,1,45
540210302,47,1,0,0,0,2,6,56
540210303,24,3,0,0,0,1,0,28
540210304,37,0,0,0,1,4,6,48
540210305,46,0,0,0,0,9,4,59
540210306,192,20,2,2,0,9,16,241
540210401,102,25,0,5,0,3,14,149
540210402,41,0,0,0,0,0,3,44
540210403,18,3,0,0,0,0,2,23
540210404,4,0,0,0,0,0,3,7
540210501,109,39,4,13,3,35,16,219
540210502,57,6,0,0,0,17,17,97
540210503,39,2,1,0,1,9,0,52
540210504,314,17,2,13,0,4,10,360
540210505,244,7,0,4,0,19,10,284
540210506,206,13,3,9,2,12,5,250
540210507,259,19,3,7,1,4,5,298
540210508,262,3,0,0,0,0,2,267
540210509,261,7,6,9,4,4,8,299
540210510,240,18,2,6,0,5,21,292
540210511,234,15,5,3,4,5,6,272
540210512,305,15,1,5,1,4,8,339
540210513,197,14,3,0,0,2,4,220
540210514,260,13,2,3,0,0,14,292
540210515,255,22,0,19,0,2,7,305
540210516,268,19,1,2,2,3,6,301
540210517,156,4,0,1,0,0,3,164
540210518,123,8,3,3,0,2,3,142
540210601,278,12,4,0,0,2,9,305
540210602,193,47,0,0,2,2,14,258
540210603,109,7,0,3,0,3,1,123
540210604,37,7,0,0,0,2,3,49
540210605,30,1,0,0,0,0,3,34
540210606,23,2,0,0,0,1,2,28
540210607,310,22,6,13,0,5,14,370
540210608,94,22,6,1,1,1,9,134
540210609,210,2,1,0,1,3,13,230
540210610,78,12,0,2,0,1,12,105
540210611,52,7,0,0,0,1,2,62
540210701,63,2,0,1,0,1,17,84
540210702,37,3,0,1,0,1,2,44
540210703,37,6,0,1,0,3,2,49
540210704,257,17,2,20,0,0,6,302
540210705,250,29,1,7,0,5,18,310
540280101,178,15,1,2,1,1,5,203
540280102,199,3,0,1,0,0,3,206
540280103,352,3,0,0,0,0,2,357
540280104,193,11,0,1,1,0,3,209
540280105,57,1,0,2,2,4,1,67
540280106,99,8,2,1,0,1,2,113
540280107,229,13,7,5,8,1,3,266
540280108,201,15,3,1,0,1,4,225
540280109,176,7,14,4,0,7,6,214
540280110,151,6,7,1,3,0,1,169
540280111,249,11,7,5,2,0,6,280
540280112,336,45,64,1,4,0,8,458
540280113,166,7,1,1,3,1,4,183
540280114,163,10,4,3,2,0,6,188
540280116,5,0,0,0,0,0,1,6
540280117,196,32,20,0,0,0,9,257
540280118,135,34,6,1,2,1,3,182
540280119,181,17,14,4,1,1,3,221
540280201,190,0,6,0,10,0,14,220
540280202,222,13,32,2,16,3,17,305
540280203,274,58,7,2,15,0,19,375
540280204,212,39,16,4,18,0,19,308
540280205,180,61,20,9,40,1,14,325
540280206,236,30,13,1,26,3,13,322
540280207,254,32,6,2,12,1,10,317
540280208,227,53,11,0,22,8,8,329
540280209,128,28,6,1,16,0,6,185
540280210,252,86,12,0,1,0,5,356
540280211,193,65,7,0,4,1,7,277
540280212,119,22,1,0,1,0,22,165
540280213,207,38,12,2,18,0,4,281
540280214,123,29,7,0,0,0,3,162
540280215,190,32,11,4,12,1,4,254
540280216,128,11,39,0,7,0,3,188
540280217,209,59,26,0,3,0,8,305
540280218,132,22,4,0,5,2,17,182
540280301,406,33,1,1,0,1,4,446
540280302,292,8,4,2,2,1,15,324
540280303,269,9,0,1,2,1,3,285
540280304,209,8,4,2,1,1,4,229
540280305,306,20,3,1,2,0,5,337
540280306,228,13,2,2,0,0,12,257
540280307,428,32,3,1,0,2,3,469
540280308,410,22,3,4,4,2,10,455
540280309,238,29,5,1,0,2,7,282
540280310,280,31,5,2,4,0,16,338
540280311,377,13,3,0,0,1,10,404
540280312,285,8,4,2,0,0,17,316
540280313,258,18,10,6,2,0,7,301
540280314,248,26,3,0,0,1,2,280
540280401,302,17,10,8,3,1,12,353
540280402,322,6,1,1,0,0,5,335
540280403,192,19,1,4,1,1,4,222
540280404,185,12,6,5,0,0,9,217
540280405,303,27,4,1,0,0,18,353
540280406,293,41,13,10,14,0,8,379
540280407,250,16,3,1,3,0,5,278
540280408,330,42,9,7,4,1,7,400
540280409,254,11,5,3,2,0,4,279
540280410,297,7,0,1,0,0,4,309
540280411,246,5,0,1,0,0,2,254
540280412,326,8,0,1,0,0,3,338
540280413,280,2,1,5,0,0,5,293
540280414,244,13,2,1,0,0,9,269
540280415,239,13,8,5,2,0,7,274
540280416,230,37,4,2,3,1,8,285
540280417,298,11,2,1,2,5,1,320
540280418,245,13,0,3,0,0,3,264
540280419,338,13,0,0,0,0,1,352
540280501,286,30,10,7,7,0,7,347
540280502,250,21,4,2,0,0,1,278
540280504,162,5,8,3,0,0,3,181
540280505,246,14,8,2,0,0,6,276
540280506,402,63,13,4,5,0,7,494
540280507,246,34,10,8,0,0,10,308
540280508,230,48,3,6,1,1,5,294
540280509,232,34,11,5,0,0,5,287
540280510,100,9,5,3,0,0,2,119
540280511,219,18,5,2,0,0,8,252
540280601,371,31,4,1,1,0,12,420
540280602,272,19,3,0,1,0,1,296
540280603,404,22,8,5,1,0,5,445
540280604,159,6,0,3,0,0,8,176
540280605,200,3,2,0,0,0,4,209
540280606,202,19,10,1,2,1,6,241
540280607,287,25,7,4,1,0,7,331
540280608,232,10,5,3,1,1,5,257
540280609,289,21,2,4,1,1,8,326
540280610,165,2,0,2,1,0,4,174
540280611,292,7,3,8,4,2,6,322
540280612,386,18,9,4,2,0,12,431
540280613,305,11,5,7,4,1,12,345
540280614,198,6,0,0,0,0,1,205
540280615,57,4,0,0,0,0,5,66
540280616,210,0,0,1,0,0,0,211
540280617,239,13,2,1,3,1,5,264
540280618,283,7,2,14,0,1,13,320
540280701,269,10,0,1,3,0,8,291
540280702,273,10,4,3,1,1,9,301
540280703,316,24,8,6,3,1,1,359
540280704,254,14,9,4,8,1,8,298
540280705,278,14,4,1,11,0,29,337
540280706,185,8,3,0,0,0,16,212
540280707,171,11,4,0,1,0,4,191
540280708,253,9,10,1,0,0,10,283
540280709,215,9,1,0,0,1,8,234
540280710,317,18,4,0,0,0,9,348
540280711,207,27,3,2,1,0,3,243
540280712,287,7,5,9,0,1,3,312
540280713,364,15,7,10,4,2,7,409
540280714,314,1,3,2,1,0,5,326
540280715,250,7,1,3,2,0,17,280
540280716,322,9,7,4,0,0,2,344
540280717,195,16,5,0,6,0,6,228
540280718,209,19,6,2,2,0,11,249
540280719,223,18,8,4,1,0,3,257
540280720,249,12,0,4,1,1,7,274
540280721,243,18,2,4,2,0,3,272
540280803,304,13,6,3,0,0,9,335
540280804,250,5,14,2,0,2,9,282
540280805,221,9,6,2,0,2,8,248
540280806,254,10,0,2,0,0,4,270
540280807,450,10,2,1,0,0,4,467
540280808,318,11,1,0,0,1,1,332
540280809,364,10,3,1,0,0,12,390
540280810,342,14,0,3,0,3,10,372
540280811,247,12,9,1,0,0,4,273
540280812,415,22,3,0,0,0,8,448
540280813,221,19,7,89,0,1,6,343
540280814,239,33,8,7,0,0,3,290
540280815,210,4,0,1,0,0,2,217
540280816,282,24,20,5,0,0,13,344
540280817,152,9,1,3,0,0,2,167
540280818,354,10,2,3,0,1,9,379
540280819,324,98,75,6,0,0,9,512
540280820,412,6,1,1,1,0,9,430
540280821,246,4,0,0,0,0,1,251
540280822,133,25,5,2,0,1,3,169
540280901,235,30,7,2,5,0,19,298
540280902,225,32,14,0,1,2,7,281
540280903,119,9,4,7,1,0,3,143
540280906,162,21,9,2,2,0,13,209
540280907,338,67,18,5,12,1,15,456
540280908,270,4,20,6,56,4,32,392
540280909,163,32,19,5,10,0,2,231
540280910,199,30,8,0,0,0,7,244
540280911,167,31,20,5,1,0,8,232
540281001,203,20,15,0,1,4,8,251
540281002,199,65,17,3,2,0,5,291
540281003,261,45,2,4,0,0,14,326
540281004,378,36,23,5,2,2,11,457
540281005,270,25,18,3,2,0,20,338
540281006,214,36,9,1,1,0,4,265
540281007,194,24,11,4,0,0,4,237
540281008,404,37,7,10,2,2,13,475
540281009,416,31,20,6,4,1,13,491
540281010,321,16,13,4,1,0,7,362
540281011,294,27,16,2,7,1,12,359
540281012,270,18,5,2,0,0,4,299
540281013,219,44,24,3,4,1,10,305
540281014,222,48,6,2,0,0,3,281
540281015,189,10,2,2,0,0,6,209
540281101,115,10,0,0,0,0,6,131
540281102,108,8,2,3,0,6,2,129
540281103,131,24,0,0,0,0,12,167
540281201,423,19,1,4,1,0,6,454
540281202,158,7,0,42,0,0,4,211
540281203,42,3,0,49,0,1,4,99
540281204,71,0,0,0,0,0,8,79
540281205,243,14,0,0,0,4,0,261
540281206,281,16,3,51,0,1,5,357
540281207,235,15,3,0,1,0,10,264
540281208,312,8,2,9,1,3,9,344
540281209,361,13,1,5,0,3,15,398
540281210,438,27,0,0,0,1,10,476
540281211,400,13,1,0,0,0,1,415
540281212,372,17,0,0,0,0,3,392
540281213,434,24,0,0,0,0,11,469
540281214,464,35,1,0,1,3,9,513
540281215,247,17,0,0,0,0,8,272
540281216,374,20,1,1,0,0,3,399
540281217,332,20,0,87,0,0,5,444
540281218,440,9,3,5,0,0,23,480
540281219,399,19,0,39,0,1,8,466
540281220,271,13,0,114,0,2,9,409
540281301,109,4,0,0,0,0,2,115
540281302,66,2,2,0,0,2,1,73
540281303,67,15,2,2,0,3,12,101
540281304,7,2,0,0,0,0,0,9
540281305,92,8,1,0,0,1,5,107
540281306,328,17,0,8,0,1,19,373
540281307,125,18,0,6,0,1,7,157
540281308,255,16,1,3,1,2,7,285
540281309,146,4,0,1,0,1,7,159
540281310,234,8,2,3,1,1,8,257
540281311,253,20,0,2,1,1,1,278
540281312,325,20,1,10,3,3,11,373
540281313,329,13,1,4,2,0,16,365
540281314,431,19,2,5,2,1,18,478
540281315,418,15,5,6,1,6,17,468
540281316,280,19,0,0,0,0,7,306
540281317,160,11,3,2,0,0,3,179
540281318,118,37,0,29,0,0,4,188
540281319,453,29,0,8,1,4,12,507
540281320,177,17,0,1,0,1,6,202
540281321,174,21,1,138,0,1,5,340
540281322,317,7,2,13,0,0,12,351
540281323,171,25,6,125,1,3,21,352
540281401,269,36,2,12,0,19,20,358
540281402,0,0,0,0,0,4,1,5
540281403,1,0,0,0,0,1,2,4
540281501,77,1,1,4,0,59,12,154
540281502,55,2,0,0,0,5,13,75
540281503,59,0,0,0,0,4,6,69
540281504,399,10,0,0,0,0,20,429
540281505,391,9,0,5,1,8,24,438
540281601,374,22,2,11,3,4,21,437
540281602,7,0,0,0,0,0,15,22
540281701,47,11,0,2,0,4,7,71
540281702,20,4,0,0,0,0,4,28
540281703,15,0,0,0,0,0,0,15
540281704,8,0,1,3,0,3,2,17
540281801,337,9,0,1,0,0,3,350
540281802,238,17,2,0,0,1,4,262
540281803,223,8,4,4,0,1,3,243
540281804,326,12,7,12,1,0,17,375
540281805,209,10,0,0,0,0,7,226
540281806,165,10,4,5,0,0,0,184
540281807,337,16,4,3,2,2,5,369
540281808,176,3,0,1,1,0,3,184
540281809,221,13,1,10,1,0,3,249
540281810,309,21,6,3,1,0,4,344
540281811,304,17,1,3,2,2,4,333
540281812,230,10,4,7,1,0,6,258
540281813,345,10,1,0,0,0,4,360
540281814,321,12,1,1,1,0,7,343
540281815,311,13,0,1,0,0,5,330
540281816,209,16,1,4,0,3,1,234
540281817,212,9,1,3,1,6,5,237
540281818,244,15,3,3,1,1,3,270
540281819,189,12,1,5,0,0,4,211
540281820,189,9,1,8,0,0,7,214
540281821,228,12,1,1,1,3,12,258
540281822,198,13,5,7,0,2,5,230
540281901,394,17,0,1,0,5,7,424
540281902,172,6,4,3,0,1,9,195
540281903,403,15,0,0,0,1,14,433
540281904,308,7,1,2,0,0,15,333
540281905,411,18,3,0,0,0,20,452
540281906,337,34,1,0,0,0,6,378
540281907,339,18,3,0,0,2,8,370
540281908,374,10,3,0,0,1,5,393
540281909,345,11,1,1,1,0,2,361
540281910,261,17,4,0,0,0,3,285
540281911,352,21,1,0,0,0,4,378
540281912,378,25,5,1,3,1,6,419
540281913,346,10,0,1,0,0,2,359
540281914,331,19,3,2,0,0,4,359
540281915,280,6,0,0,1,0,10,297
540281916,376,34,2,1,1,0,6,420
540281917,380,35,1,3,0,0,35,454
540281918,318,11,0,0,4,1,8,342
540281919,381,16,5,9,0,1,10,422
540281920,360,28,0,0,3,0,2,393
540281921,372,24,0,3,1,0,7,407
540281922,362,12,0,0,0,2,14,390
540281923,438,36,4,5,0,8,13,504
540281924,466,10,0,0,0,0,2,478
540281925,353,8,0,0,0,0,5,366
540281926,344,16,1,7,0,0,6,374
540281927,235,10,0,28,0,1,24,298
540281928,281,13,0,0,0,1,1,296
540282001,400,36,0,2,0,0,1,439
540282002,425,14,0,3,0,0,7,449
540282003,380,18,1,2,3,2,20,426
540282004,475,38,8,10,0,4,9,544
540282005,303,3,8,1,2,0,10,327
540282006,286,4,5,7,1,0,8,311
540282007,306,18,11,1,0,1,5,342
540282008,139,5,4,5,0,2,3,158
540282009,282,8,5,2,1,4,4,306
540282010,217,12,6,3,0,0,8,246
540282011,463,22,1,4,0,0,2,492
540282012,180,10,3,8,0,1,5,207
540282013,228,6,1,5,0,0,6,246
540282014,178,9,7,1,1,1,6,203
540282015,269,17,0,0,0,0,1,287
540282016,282,10,3,2,0,1,10,308
540282017,224,10,0,2,0,0,8,244
540282018,225,10,1,4,0,0,9,249
540282019,325,16,2,33,0,4,5,385
540282020,174,10,3,93,0,0,3,283
540282021,282,6,3,3,2,0,8,304
540282101,6,6,0,0,0,0,1,13
540282102,110,19,0,1,0,5,10,145
540282103,24,4,1,3,1,0,2,35
540282201,180,8,5,0,1,0,2,196
540282202,371,39,8,5,1,0,11,435
540282203,213,29,4,1,3,0,16,266
540282204,248,10,6,2,0,0,7,273
540282205,231,18,7,5,2,0,2,265
540282206,357,47,3,5,6,0,8,426
540282207,331,63,13,3,5,1,12,428
540282208,218,31,5,3,2,0,7,266
540282209,356,15,9,4,5,2,13,404
540282210,300,23,13,3,4,0,1,344
540282211,230,21,7,2,1,0,2,263
540282212,212,13,6,3,1,0,10,245
540282213,207,19,7,2,0,0,3,238
540282301,385,2,6,6,1,0,9,409
540282302,247,19,1,4,2,0,4,277
540282303,320,9,5,6,4,1,10,355
540282304,311,2,5,6,0,1,10,335
540282305,411,3,4,5,0,1,8,432
540282306,299,8,11,12,1,0,6,337
540282307,260,15,3,1,0,0,5,284
540282308,227,9,1,4,1,0,0,242
540282309,255,9,2,0,1,0,5,272
540282310,232,18,11,2,1,3,4,271
540282311,426,14,1,7,0,0,7,455
540282312,332,4,1,3,2,0,4,346
540282313,244,7,1,1,0,0,1,254
540282314,172,5,1,25,1,5,2,211
540282401,306,10,2,5,2,0,11,336
540282402,313,21,2,33,0,4,4,377
540282403,348,32,0,25,0,1,3,409
540282404,378,5,0,0,1,0,13,397
540282405,251,6,2,3,0,0,5,267
540282406,200,5,0,0,0,0,7,212
540282407,311,9,2,0,3,2,6,333
540282408,340,8,0,1,0,0,12,361
540282409,266,22,0,2,0,0,1,291
540282410,282,8,1,3,0,0,9,303
540282411,312,26,0,18,1,2,8,367
540282412,383,20,3,1,1,0,5,413
540282413,214,18,0,2,0,0,5,239
540282414,307,29,0,27,0,0,14,377
540282415,399,13,0,0,1,3,16,432
540282416,286,15,0,1,0,0,55,357
540282417,53,2,0,0,0,0,247,302
540350101,67,3,0,0,0,0,0,70
540350102,23,5,0,0,0,4,0,32
540350103,139,8,0,1,0,2,5,155
540350104,21,0,0,0,0,0,2,23
540350105,1,0,0,0,0,1,0,2
540350106,12,1,0,0,0,0,3,16
540350201,65,5,0,3,0,1,25,99
540350202,13,0,0,0,0,2,5,20
540350203,11,1,0,1,0,0,5,18
540350204,26,1,0,0,0,1,10,38
540350205,3,1,0,0,0,0,0,4
540350206,11,15,0,0,0,0,0,26
540350207,27,2,0,0,0,4,8,41
540350301,97,11,0,0,0,1,1,110
540350302,6,4,2,0,0,0,0,12
540350303,17,2,0,0,1,6,4,30
540350304,49,3,0,0,0,0,7,59
540350305,3,0,0,0,0,2,2,7
540350306,7,0,0,0,0,1,0,8
540350307,16,5,0,0,0,1,1,23
540350308,26,2,0,0,0,5,0,33
540350401,152,14,0,2,0,1,16,185
540350402,43,0,0,1,0,2,6,52
540350403,261,16,1,3,2,7,13,303
540350404,246,33,3,5,0,0,5,292
540350405,47,4,0,1,0,9,3,64
540350406,21,0,0,0,0,0,9,30
540350407,10,2,0,0,0,0,7,19
540350408,0,1,0,0,0,0,0,1
540350409,25,0,0,0,0,0,0,25
540350410,239,16,3,2,0,4,9,273
540350411,180,32,0,1,0,0,4,217
540350412,346,28,1,1,0,0,11,387
540350413,102,10,0,1,0,0,21,134
540350414,240,16,2,8,1,0,2,269
540420101,114,1,0,12,0,6,4,137
540420102,102,8,0,1,0,1,5,117
540420103,61,0,0,0,0,2,3,66
540420104,9,0,0,0,0,0,0,9
540420105,21,2,0,0,0,0,1,24
540420106,17,4,0,0,0,1,0,22
540420107,292,10,0,3,0,0,4,309
540420201,1,0,0,0,0,0,0,1
540420202,0,1,0,0,0,0,1,2
540420203,35,9,0,1,0,2,4,51
540420301,188,6,0,2,0,20,3,219
540420302,131,6,0,0,2,2,15,156
540420303,236,12,4,5,1,0,14,272
540420304,76,4,1,2,0,1,3,87
540420305,467,21,4,14,1,2,4,513
540420306,283,12,0,0,1,0,3,299
540420307,338,32,1,1,0,1,1,374
540420308,139,5,2,0,0,0,8,154
540420309,387,11,0,9,0,0,9,416
540420310,157,7,2,2,0,1,0,169
540420311,79,0,8,3,0,0,1,91
540420312,161,7,2,5,0,0,1,176
540420313,181,12,3,6,0,2,10,214
540420314,260,15,0,0,1,1,13,290
540420315,205,4,0,3,0,0,1,213
540420316,226,11,1,1,0,0,2,241
540420317,275,11,0,37,0,2,9,334
540420318,138,4,0,1,0,0,5,148
540420401,212,3,2,0,2,1,4,224
540420402,320,16,1,5,0,2,7,351
540420403,304,11,2,3,4,0,6,330
540420404,265,8,5,2,1,0,8,289
540420405,390,34,17,9,2,0,4,456
540420406,388,18,5,12,0,5,13,441
540420407,348,13,2,3,3,0,9,378
540420408,174,11,1,0,0,0,2,188
540420409,286,4,7,4,0,0,4,305
540420410,307,13,0,2,0,1,7,330
540420411,397,23,4,6,4,0,5,439
540420412,226,12,6,2,1,0,6,253
540420413,245,12,4,1,1,0,1,264
540420414,332,21,7,7,0,0,9,376
540420415,278,10,6,4,0,0,5,303
540420416,261,17,2,2,0,1,6,289
540420417,225,17,2,4,0,0,3,251
540420418,293,10,6,7,2,0,4,322
540420419,221,10,5,5,0,0,8,249
540420420,280,5,8,6,5,0,5,309
540420501,216,4,2,4,0,1,8,235
540420502,357,14,2,2,2,0,8,385
540420503,245,32,12,6,3,2,5,305
540420504,280,37,17,3,12,2,9,360
540420505,326,23,8,7,3,1,5,373
540420506,271,19,2,0,0,0,1,293
540420507,240,18,6,3,0,1,2,270
540420508,275,50,5,8,0,0,8,346
540420509,224,29,7,5,1,0,7,273
540420510,177,38,4,1,2,0,1,223
540420511,285,48,40,3,9,4,10,399
540420512,264,11,5,6,0,0,2,288
540420513,302,29,5,4,3,0,5,348
540420514,279,31,17,5,9,0,8,349
540420515,263,11,8,5,0,0,3,290
540420516,265,23,9,9,3,1,4,314
540420517,222,6,5,3,0,0,9,245
540420518,258,11,10,5,3,0,6,293
540420519,188,13,2,3,0,0,2,208
540420520,227,30,5,2,1,1,5,271
540420601,244,22,0,4,0,1,9,280
540420602,260,0,9,4,0,2,2,277
540420603,192,30,1,2,0,1,16,242
540420604,38,1,0,0,1,4,6,50
540420605,108,4,0,2,0,0,2,116
540420606,80,1,1,0,0,0,2,84
540420607,217,7,1,3,0,4,9,241
540420608,38,4,0,0,0,2,13,57
540420609,17,0,0,0,0,4,0,21
540420610,212,13,1,2,1,3,9,241
540420611,140,7,0,1,1,0,3,152
540420612,272,6,2,0,2,2,6,290
540420613,449,16,6,1,2,0,4,478
540420614,274,10,5,0,0,3,4,296
540420701,262,10,0,1,0,0,11,284
540420702,125,3,0,23,0,4,2,157
540420703,92,0,0,5,0,1,7,105
540420704,129,3,1,1,0,4,3,141
540420705,29,0,0,0,0,1,2,32
540420706,24,6,0,1,0,1,0,32
540420707,11,1,0,0,0,1,0,13
540420708,16,6,0,0,0,1,5,28
540420709,91,7,2,1,0,0,3,104
540420710,178,8,3,2,1,1,6,199
540420801,147,9,1,37,1,0,4,199
540420802,163,4,2,5,1,3,20,198
540420803,125,5,3,3,0,0,15,151
540420804,6,0,0,0,0,0,6,12
540420805,48,9,0,1,0,0,2,60
540420806,6,6,0,0,0,1,0,13
540420901,34,10,0,0,0,0,8,52
540420902,9,1,0,0,0,0,3,13
540420903,3,1,0,0,0,0,0,4
540420904,20,7,0,0,0,0,0,27
540421001,272,13,0,1,1,0,14,301
540421002,34,1,0,0,0,1,4,40
540421003,77,7,1,3,0,0,3,91
540421004,21,0,0,0,0,0,3,24
540421005,235,3,0,0,0,1,6,245
540421006,147,15,0,3,0,0,2,167
540421007,107,5,0,4,0,0,4,120
540421008,227,12,1,1,0,1,2,244
540421009,167,5,2,17,0,0,7,198
540490101,366,8,3,6,0,1,10,394
540490102,524,13,0,44,0,2,35,618
540490103,185,17,0,2,0,3,25,232
540490104,502,1,0,0,0,0,0,503
540490105,555,4,3,3,4,0,7,576
540490106,229,15,3,2,0,0,5,254
540490107,329,20,1,0,0,0,4,354
540490108,324,13,1,1,0,1,7,347
540490109,310,19,3,1,3,1,8,345
540490110,134,0,0,0,0,0,0,134
540490111,161,8,0,0,0,1,3,173
540490112,199,4,0,0,0,0,5,208
540490113,217,12,1,1,0,1,3,235
540490114,285,18,0,0,0,0,1,304
540490115,206,4,0,21,1,1,2,235
540490116,258,17,2,8,1,0,7,293
540490201,112,0,0,2,0,1,19,134
540490202,472,11,0,14,1,1,33,532
540490203,601,22,0,8,0,1,35,667
540490204,213,20,2,4,0,0,5,244
540490205,302,21,1,4,0,0,6,334
540490206,544,62,1,24,1,7,10,649
540490207,187,14,1,2,3,0,9,216
540490301,524,36,7,15,0,12,47,641
540490302,105,1,0,1,0,0,4,111
540490303,343,28,8,4,7,1,13,404
540490304,251,29,11,4,0,0,8,303
540490305,249,21,1,3,1,8,21,304
540490306,130,5,1,5,0,0,43,184
540490307,198,26,1,5,0,0,5,235
540490308,211,20,3,7,0,1,5,247
540490309,303,34,6,10,4,9,14,380
540490310,209,30,1,1,0,7,14,262
540490311,218,18,2,2,2,1,3,246
540490312,216,30,1,0,1,0,2,250
540490401,219,41,0,8,0,1,34,303
540490402,26,7,0,0,0,0,2,35
540490403,18,8,0,0,0,0,2,28
540560101,177,9,0,2,0,0,2,190
540560102,247,8,0,0,0,0,6,261
540560103,229,1,0,0,0,0,0,230
540560104,198,7,0,0,0,0,9,214
540560105,105,5,0,0,0,0,3,113
540560106,98,0,0,2,0,0,0,100
540560201,337,31,1,8,0,1,10,388
540560202,176,11,4,0,0,0,8,199
540560203,98,4,0,1,0,0,5,108
540560204,142,5,0,0,0,0,1,148
540560205,287,3,0,4,0,0,17,311
540560206,295,19,6,4,0,0,7,331
540560207,128,0,0,0,0,0,0,128
540560208,332,14,4,7,5,0,3,365
540560209,184,9,2,9,0,1,13,218
540560210,271,17,2,0,0,0,0,290
540560301,428,25,1,1,0,1,5,461
540560302,189,1,0,0,0,0,2,192
540560303,563,4,1,0,0,0,4,572
540560304,129,9,1,1,0,0,2,142
540560305,309,17,1,3,0,2,23,355
540560306,143,5,0,0,0,0,2,150
540560307,97,2,0,2,0,0,9,110
540560308,235,4,0,2,0,0,11,252
540560309,146,6,0,15,0,1,2,170
540560401,1,1,0,0,0,0,0,2
540560402,3,0,0,0,0,3,0,6
540560403,53,3,0,1,0,0,0,57
540560501,275,21,1,3,0,3,10,313
540560502,1,1,0,0,0,0,0,2
540560503,1,0,0,0,0,0,0,1
540560601,536,44,1,12,1,4,22,620
540560602,439,9,0,4,0,1,20,473
540560603,465,29,1,13,1,5,30,544
540560604,574,44,4,18,1,5,14,660
540560605,230,10,0,2,0,0,7,249
540560606,134,6,0,2,0,1,7,150
540560607,230,24,0,1,1,0,10,266
540560608,459,22,3,3,0,1,34,522
540560609,226,1,0,1,0,2,13,243
540560610,345,24,2,2,0,0,6,379
540560611,346,28,0,4,0,0,13,391
540560612,369,18,3,2,0,0,5,397
540560613,388,22,10,4,0,0,20,444
540560614,239,28,1,3,0,2,11,284
540560701,90,10,0,0,0,0,10,110
540560702,262,30,5,17,2,4,7,327
540560703,52,6,0,0,0,0,4,62
540560704,58,2,0,0,0,1,1,62
540560705,107,7,0,0,0,0,4,118
540560706,68,1,0,0,0,3,3,75
540560707,102,2,0,0,0,0,5,109
540560708,329,11,0,1,0,0,11,352
540560709,260,2,0,1,0,0,10,273
540560710,259,14,3,28,0,1,12,317
540560711,274,17,0,40,1,1,3,336
540560801,522,35,0,48,1,8,22,636
540560802,484,40,0,3,0,11,22,560
540560803,211,42,0,0,0,0,6,259
540560901,367,32,10,3,2,0,3,417
540560902,622,60,9,7,0,4,17,719
540560903,448,45,1,3,2,1,24,524
540560904,292,6,4,1,0,1,2,306
540560905,288,20,5,2,1,0,6,322
540560906,221,14,6,6,0,1,17,265
540560907,216,6,2,0,0,0,5,229
540560908,297,10,2,0,0,3,2,314
540560909,280,13,5,9,1,0,7,315
540560910,223,13,8,6,0,0,9,259
540560911,193,11,2,1,0,0,1,208
540630101,125,4,0,1,0,0,14,144
540630102,83,5,0,0,0,0,2,90
540630103,2,1,0,0,0,0,0,3
540630104,2,1,0,0,0,3,0,6
540630105,186,5,0,0,0,1,10,202
540630106,263,12,2,3,0,1,12,293
540630107,270,18,1,11,2,1,6,309
540630108,191,10,0,0,0,0,3,204
540630109,363,12,5,15,2,2,9,408
540630110,332,13,0,1,0,1,4,351
540630111,318,15,0,1,1,1,5,341
540630112,289,17,5,1,1,0,15,328
540630113,252,12,0,4,0,0,3,271
540630114,205,25,0,55,0,0,7,292
540630115,248,25,0,35,0,2,8,318
540630201,5,0,0,0,0,0,0,5
540630202,1,0,0,0,0,0,1,2
540630203,0,0,0,0,0,1,0,1
540630301,58,5,0,1,0,0,11,75
540630302,79,9,0,1,0,2,10,101
540630401,22,6,0,0,0,0,1,29
540630402,20,5,0,0,0,2,1,28
540630403,82,16,0,0,0,0,0,98
540630404,59,7,0,0,1,2,9,78
540630405,215,15,0,1,0,0,5,236
540630406,328,20,0,1,3,0,9,361
540630407,234,11,0,0,1,1,6,253
540630408,251,18,0,0,0,0,3,272
540630409,180,23,2,3,1,0,14,223
540630410,189,17,2,2,0,0,2,212
540630501,163,1,0,0,0,0,0,164
540630502,21,4,0,0,0,0,0,25
540630503,33,3,0,0,0,0,0,36
540630504,41,4,0,0,0,1,0,46
540630505,55,7,0,0,0,0,0,62
540630601,1,14,0,0,0,0,0,15
540630602,22,2,0,0,0,0,0,24
540630701,7,0,0,0,0,0,4,11
540630702,3,1,0,0,0,2,2,8
540630703,17,1,0,0,0,0,10,28
540630704,53,1,0,0,0,0,2,56
540630705,25,4,0,0,0,1,0,30
540630801,177,2,1,1,0,1,4,186
540630802,425,10,1,3,0,0,8,447
540630803,167,11,3,2,1,2,2,188
540630804,161,17,0,3,0,2,11,194
540630805,353,28,4,7,0,1,2,395
540630806,25,0,0,0,0,0,8,33
540630807,42,0,0,1,0,3,5,51
540630808,10,2,0,0,0,0,0,12
540630809,4,0,0,0,0,0,2,6
540630810,62,2,3,5,1,1,3,77
540630811,107,3,0,1,0,4,1,116
540630812,247,6,0,2,0,1,6,262
540630813,406,10,4,2,1,0,4,427
540630814,425,13,3,3,0,1,10,455
540630815,376,42,4,60,1,1,16,500
540630816,311,8,4,5,0,0,10,338
540630817,240,4,0,8,0,1,1,254
540630818,175,8,2,2,1,1,0,189
540630819,303,7,5,1,0,0,3,319
540630901,160,7,0,5,0,0,21,193
540630902,81,17,2,1,2,0,8,111
540630903,12,0,0,0,0,0,0,12
540630904,173,5,0,0,0,0,4,182
540630905,243,19,3,2,0,1,7,275
540630906,249,19,2,5,0,2,9,286
540630907,225,22,0,3,0,0,10,260
540630908,329,20,1,5,0,1,7,363
540630909,237,11,3,8,0,0,14,273
540630910,197,7,0,0,0,0,0,204
540630911,209,29,2,2,1,0,6,249
540630912,211,12,0,7,1,1,4,236
540630913,116,6,0,3,0,0,1,126
540630914,342,23,1,1,0,0,1,368
540630915,258,6,1,4,0,1,7,277
540630916,196,11,0,5,0,0,13,225
540630917,193,5,1,3,0,0,6,208
540630918,163,26,2,3,0,0,13,207
540631001,224,32,11,1,1,0,8,277
540631002,395,37,11,3,5,2,37,490
540631003,373,10,11,1,1,1,10,407
540631004,368,33,16,9,1,3,8,438
540631005,221,7,4,5,0,0,7,244
540631006,202,7,1,4,1,1,3,219
540631007,186,14,0,4,0,0,4,208
540631008,325,25,4,1,2,0,3,360
540631009,193,4,1,1,0,0,0,199
540631010,168,6,4,1,0,0,2,181
540631011,219,5,0,2,0,0,0,226
540631012,247,5,4,4,3,3,6,272
540631013,337,6,1,0,0,1,8,353
540631014,376,24,1,8,1,4,15,429
540631101,237,16,6,9,2,3,4,277
540631102,365,15,5,7,0,9,9,410
540631103,201,13,11,5,12,3,5,250
540631104,392,51,2,3,3,0,8,459
540631105,429,71,7,3,0,2,11,523
540631106,397,22,1,1,0,1,11,433
540631107,359,23,6,10,1,0,11,410
540631108,258,20,5,5,2,0,5,295
540631109,221,16,2,2,1,0,5,247
540631110,261,13,4,4,1,0,7,290
540631111,161,11,4,0,0,0,2,178
540631112,266,20,3,2,0,1,14,306
540631113,333,19,10,2,2,0,15,381
540700101,179,12,0,0,0,6,12,209
540700102,62,6,0,0,0,1,8,77
540700103,20,2,0,0,0,0,1,23
540700104,119,12,0,1,0,0,1,133
540700105,93,5,0,1,0,1,1,101
540700201,79,4,0,0,0,0,1,84
540700202,152,20,0,1,0,2,0,175
540700203,68,21,0,0,0,0,2,91
540700204,58,1,0,0,0,0,13,72
540700205,226,12,1,1,0,4,4,248
540700206,160,2,13,21,2,6,10,214
540700207,362,6,0,2,0,1,13,384
540700208,236,22,0,0,0,0,20,278
540700301,127,3,0,1,0,2,5,138
540700302,168,11,0,7,0,1,10,197
540700303,87,5,0,0,0,1,4,97
540700304,273,20,0,2,1,2,4,302
540700305,242,11,1,2,3,0,14,273
540700306,256,20,1,9,0,2,8,296
540700307,281,14,0,3,2,1,4,305
540700308,389,17,2,3,0,1,6,418
540700309,385,9,3,5,0,1,8,411
540700310,226,26,9,2,0,2,5,270
540700311,311,16,0,13,1,4,3,348
540700312,196,12,0,0,0,1,2,211
540700313,200,8,1,1,1,0,0,211
540700314,200,4,0,0,0,0,0,204
540700315,199,3,0,3,0,0,3,208
540700316,237,11,1,0,1,2,4,256
540700401,79,4,0,0,0,0,1,84
540700402,306,7,0,3,1,0,4,321
540700403,69,0,0,0,0,0,0,69
540700404,93,7,0,0,0,2,2,104
540700501,112,6,1,1,0,2,13,135
540700502,136,10,0,1,0,0,5,152
540700503,452,14,0,1,0,4,21,492
540700504,212,15,0,0,0,0,1,228
540700505,154,9,1,2,0,2,19,187
540700506,82,8,1,0,0,1,7,99
540700507,179,6,3,3,0,0,5,196
540700508,325,19,0,14,0,1,8,367
540700601,124,6,0,0,0,0,0,130
540700602,207,8,0,11,0,2,12,240
540700603,89,0,0,0,0,0,0,89
540700701,265,17,4,1,1,0,4,292
540700702,188,7,0,3,0,0,3,201
540700703,255,22,6,3,3,0,0,289
540700704,276,10,7,10,1,0,5,309
540700705,225,7,1,0,1,0,6,240
540700706,270,25,12,6,1,0,7,321
540700707,293,9,5,8,1,1,6,323
540700708,324,14,2,8,1,0,14,363
540700709,175,6,1,3,3,0,3,191
540700801,225,9,1,2,0,1,5,243
540700802,281,26,7,6,1,1,7,329
540700803,374,26,2,7,0,1,11,421
540700804,233,8,1,3,1,0,6,252
540700805,209,8,1,5,1,1,4,229
540700806,312,15,6,9,3,1,6,352
540700807,384,13,6,7,4,2,14,430
540700808,232,6,1,1,0,0,4,244
540770101,286,5,0,12,0,0,6,309
540770102,372,25,2,3,0,0,12,414
540770103,251,6,0,1,0,2,2,262
540770104,267,7,2,18,0,4,6,304
540770105,404,20,1,70,2,6,32,535
540770106,44,3,0,0,0,1,8,56
540770107,261,7,0,3,0,0,4,275
540770108,349,24,2,17,0,1,10,403
540770109,231,14,1,2,0,0,1,249
540770110,368,16,0,5,0,1,4,394
540770201,166,2,0,6,0,1,9,184
540770202,110,2,0,0,0,0,10,122
540770203,15,1,0,0,0,0,0,16
540770204,11,0,0,0,0,1,3,15
540770205,131,1,0,2,0,2,8,144
540770206,24,0,0,0,0,0,8,32
540770207,117,5,1,0,0,12,4,139
540770208,366,17,2,7,0,0,4,396
540770209,283,10,1,6,0,1,3,304
540770210,206,15,2,3,0,1,1,228
540770211,294,22,1,4,0,0,15,336
540770212,201,13,0,24,0,1,18,257
540770213,261,13,1,3,0,1,4,283
540770301,247,1,7,3,1,0,26,285
540770302,169,8,0,2,0,13,11,203
540770303,43,1,0,0,0,0,5,49
540770304,137,1,0,0,0,0,7,145
540770305,103,5,0,0,0,0,0,108
540770306,71,5,0,0,0,1,5,82
540770307,6,3,0,0,0,0,0,9
540770308,192,12,0,2,0,2,10,218
540770309,351,16,5,9,1,1,19,402
540770401,341,6,1,8,0,1,34,391
540770402,200,15,0,6,0,0,12,233
540770403,64,3,1,39,0,0,4,111
540770404,300,10,2,5,0,3,2,322
540770405,245,9,9,7,0,0,5,275
540770406,76,12,0,1,1,0,4,94
540770407,257,9,0,2,0,0,5,273
540770408,224,18,2,8,0,1,6,259
540770501,125,0,0,1,0,4,2,132
540770502,7,2,0,0,0,0,2,11
540770503,8,3,0,0,0,2,0,13
540770601,152,6,0,1,0,0,4,163
540770602,360,23,3,14,1,1,3,405
540770603,162,8,5,12,1,2,6,196
540770604,109,18,0,1,0,0,2,130
540770605,188,12,0,6,0,1,14,221
540770701,40,1,0,0,0,0,10,51
540770702,124,7,1,1,0,1,8,142
540770703,311,12,0,0,0,1,2,326
540770704,146,4,0,0,1,3,4,158
540770801,280,22,3,3,0,3,9,320
540770802,115,3,1,0,0,0,0,119
540770803,264,14,4,4,1,2,2,291
540770804,272,13,1,3,0,0,10,299
540770805,313,16,0,3,0,0,6,338
540770806,292,16,8,2,1,0,2,321
540770807,237,20,6,8,2,0,3,276
540770808,114,3,1,3,0,0,3,124
540770809,213,6,6,2,1,1,4,233
540770810,249,14,1,1,3,0,5,273
540770811,186,7,4,5,2,2,4,210
540770812,189,27,0,0,0,0,4,220
540840101,88,2,0,0,0,0,10,100
540840102,284,14,0,3,3,2,4,310
540840103,31,0,0,0,0,6,4,41
540840104,184,9,0,0,0,0,12,205
540840105,252,18,7,2,9,0,14,302
540840106,241,27,4,0,0,0,0,272
540840107,328,6,1,0,1,0,9,345
540840108,273,21,0,4,0,3,21,322
540840109,310,18,0,2,0,1,9,340
540840110,223,11,6,4,0,0,3,247
540840201,57,4,0,0,1,3,10,75
540840202,84,5,1,2,0,0,5,97
540840203,21,2,0,1,0,0,4,28
540840204,1,3,0,0,0,0,0,4
540840301,366,9,0,0,0,0,6,381
540840302,252,15,0,0,0,0,5,272
540840303,185,4,2,4,0,0,1,196
540840304,352,23,1,2,1,0,10,389
540840305,185,12,4,2,0,0,1,204
540840306,24,7,0,1,0,0,1,33
540840307,139,10,0,2,0,2,24,177
540840308,24,3,0,0,0,0,3,30
540840309,151,7,2,0,1,0,5,166
540840310,32,0,1,2,0,0,5,40
540840311,68,3,0,0,0,2,5,78
540840312,233,16,1,2,0,0,4,256
540840313,153,10,0,0,1,0,2,166
540840314,200,16,2,5,1,0,7,231
540840401,37,9,0,0,0,0,0,46
540840402,85,4,0,0,0,1,4,94
540840403,310,17,3,3,1,0,7,341
540840404,38,6,0,0,0,0,3,47
540840405,203,12,0,1,0,1,14,231
540840406,11,0,0,0,0,0,0,11
540840407,45,0,0,1,0,0,2,48
540840408,187,8,0,2,0,1,7,205
540840409,214,8,1,6,0,0,6,235
540840501,30,4,0,1,0,0,1,36
540840502,47,0,0,0,0,0,0,47
540840601,38,5,0,0,0,2,6,51
540840602,107,7,0,0,0,0,0,114
540840603,74,5,0,0,0,0,1,80
540840604,35,8,0,0,0,0,13,56
540840605,98,2,0,4,1,0,7,112
540840606,171,8,5,4,0,0,9,197
540840607,225,6,2,20,0,0,8,261
540840701,37,9,0,0,0,0,0,46
540840702,7,4,0,0,0,0,1,12
540840801,11,13,0,0,0,0,9,33
540840802,68,34,0,1,0,0,9,112
540840901,279,18,2,17,1,3,7,327
540840902,368,3,1,4,0,1,9,386
540840903,191,12,4,11,6,1,5,230
540840904,304,11,1,3,0,0,14,333
540840905,166,16,5,7,0,0,0,194
540840906,258,14,2,1,0,0,5,280
540840907,357,24,1,9,0,1,8,400
540840908,249,22,7,8,2,0,0,288
540840909,335,14,1,7,0,0,10,367
540840910,187,15,2,7,0,1,7,219
540910101,268,7,7,8,0,1,8,299
540910102,262,17,5,5,7,1,3,300
540910103,218,16,1,3,3,2,7,250
540910104,400,16,10,5,17,1,6,455
540910105,366,15,6,2,0,0,5,394
540910106,362,28,0,3,0,0,9,402
540910107,301,3,2,2,0,0,3,311
540910108,488,85,21,9,2,0,15,620
540910109,247,37,11,6,4,0,5,310
540910110,202,12,5,2,2,0,26,249
540910111,220,69,4,6,0,2,0,301
540910112,332,10,8,8,0,2,4,364
540910113,222,18,5,4,2,1,3,255
540910114,134,6,4,3,3,0,2,152
540910115,232,22,0,0,0,1,17,272
540910116,501,32,7,3,0,0,8,551
540910117,345,3,2,10,0,1,12,373
540910118,356,111,35,42,2,1,12,559
540910119,395,22,6,7,0,2,1,433
540910201,440,5,0,2,2,1,16,466
540910202,422,1,3,4,0,1,2,433
540910203,265,0,10,7,0,1,3,286
540910204,235,2,0,2,0,0,5,244
540910205,318,12,2,1,0,1,3,337
540910206,216,8,4,5,1,3,8,245
540910207,344,31,11,6,5,0,9,406
540910208,293,4,3,4,1,0,2,307
540910209,294,13,3,8,0,5,11,334
540910210,306,7,1,4,3,0,4,325
540910211,263,22,3,4,1,1,9,303
540910212,251,10,2,1,0,2,7,273
540910213,498,20,6,5,0,4,9,542
540910214,234,11,0,0,0,0,6,251
540910215,302,10,12,9,1,1,10,345
540910216,211,10,5,2,0,1,5,234
540910217,202,28,13,1,2,0,3,249
540910218,264,7,5,4,0,0,9,289
540910219,249,0,2,5,0,0,2,258
540910301,54,8,0,0,0,0,9,71
540910302,79,4,1,0,0,1,2,87
540910303,51,7,0,1,0,2,7,68
540910304,51,1,0,0,0,0,1,53
540910305,122,7,0,0,1,0,5,135
540910306,231,7,2,7,1,2,10,260
540910401,124,2,0,5,0,0,14,145
540910402,140,8,0,1,0,0,12,161
540910403,193,3,0,0,0,1,38,235
540910404,231,14,0,13,1,1,8,268
540910405,94,5,0,3,0,1,6,109
540910406,187,8,4,8,3,1,3,214
540910501,61,3,0,0,0,0,5,69
540910502,97,8,0,1,0,0,5,111
540910503,101,11,0,0,0,0,0,112
540910504,82,4,0,0,0,0,3,89
540910505,78,5,0,0,0,1,2,86
540910506,99,3,0,0,0,0,0,102
540910507,185,6,0,5,0,1,7,204
540910508,108,7,0,2,0,0,4,121
540910509,438,6,0,2,3,0,6,455
540910510,71,2,1,1,0,0,3,78
540910511,109,0,0,0,0,0,2,111
540910512,262,11,6,6,0,2,9,296
540910513,264,13,1,1,1,0,1,281
540910514,225,2,0,0,0,0,48,275
540910515,322,16,2,1,2,0,0,343
540910516,161,1,1,4,0,0,7,174
540910601,163,8,0,0,1,0,11,183
540910602,125,6,0,5,0,2,20,158
540910603,85,6,0,0,0,1,3,95
540910701,61,0,0,1,0,1,28,91
540910702,73,0,0,2,0,2,3,80
540910703,114,3,0,10,0,1,7,135
540910704,65,0,1,2,0,0,6,74
540910705,133,10,1,5,1,8,12,170
540910706,162,9,0,1,0,2,4,178
540910707,245,4,0,10,1,4,15,279
540910708,116,3,4,15,1,4,10,153
540910709,108,9,0,2,0,0,8,127
540910710,144,4,1,3,0,1,12,165
540910711,19,0,0,1,0,0,5,25
540910712,246,11,3,3,0,0,8,271
540910713,272,10,0,2,0,0,5,289
540910714,257,14,0,44,1,3,9,328
540910715,362,16,2,7,1,5,5,398
540910716,240,2,0,4,0,0,7,253
540910717,247,11,2,10,0,1,5,276
540910718,317,14,7,16,0,1,16,371
540910719,262,11,1,2,0,1,4,281
540910801,39,3,0,0,0,1,4,47
540910802,165,1,0,1,0,3,9,179
540910803,189,5,0,0,1,0,14,209
540910804,71,8,0,0,0,1,4,84
540910805,147,11,2,12,0,1,6,179
540910806,32,0,0,0,0,2,7,41
540910807,97,1,0,0,0,0,1,99
540910808,125,6,0,1,0,9,12,153
540910809,125,11,0,1,0,0,12,149
540910810,294,13,1,5,4,1,9,327
540910811,167,0,0,4,1,2,5,179
540910901,273,26,0,7,0,2,42,350
540910902,213,3,0,0,0,0,4,220
540910903,178,5,0,0,0,0,5,188
540910904,95,1,0,0,0,0,9,105
540910905,262,13,1,5,0,1,10,292
540911001,258,8,0,1,0,0,8,275
540911002,117,12,2,3,0,3,6,143
540911003,54,0,0,1,1,0,9,65
540911004,26,0,0,0,0,2,8,36
540911005,146,9,3,2,0,3,11,174
540911006,82,6,0,0,0,2,4,94
540911007,34,0,0,0,0,0,0,34
540911008,153,1,1,3,2,0,22,182
540911009,166,25,0,1,0,9,6,207
540911010,106,1,0,0,1,3,4,115
540911011,47,1,0,0,0,2,5,55
540911012,23,1,0,0,0,0,3,27
540911013,86,9,0,0,0,0,1,96
540911014,193,14,0,2,0,0,8,217
540911101,247,13,0,0,1,1,6,268
540911102,81,8,0,0,0,0,3,92
540911103,22,0,0,0,0,0,0,22
540911104,29,3,0,0,0,0,3,35
540911105,78,2,0,0,0,3,7,90
540911106,134,7,0,4,0,1,6,152
540911107,63,3,0,0,0,0,3,69
540911108,123,8,0,2,0,0,8,141
540911201,106,1,0,21,0,0,13,141
540911202,28,3,0,0,0,1,0,32
540911203,108,3,0,3,0,1,3,118
540911204,15,2,0,0,0,0,0,17
540911205,89,4,0,0,0,1,0,94
540911206,81,2,0,0,0,1,14,98
540911207,86,6,0,1,0,1,22,116
540911208,54,2,0,0,0,0,0,56
540911209,248,6,2,3,0,3,5,267
540911210,228,18,0,4,0,0,6,256
540911211,122,5,0,3,0,0,0,130
540911301,317,19,1,2,0,0,7,346
540911302,247,13,0,2,1,0,8,271
540911303,288,10,3,48,0,0,6,355
540911304,252,7,2,5,0,0,8,274
540911305,196,10,0,0,0,0,5,211
540911306,250,7,0,0,0,1,1,259
540911307,201,10,5,5,2,1,6,230
540911308,262,3,0,3,0,1,13,282
540911309,438,22,2,2,0,0,0,464
540911310,452,50,12,13,2,2,5,536
540911311,360,37,20,7,0,0,5,429
540911312,319,19,4,10,1,0,6,359
540911313,259,2,0,0,0,0,0,261
540980101,159,2,0,2,0,8,28,199
540980102,95,11,0,0,0,2,4,112
540980103,75,5,0,1,0,5,7,93
540980104,299,25,1,6,1,2,13,347
540980105,56,5,0,1,1,0,1,64
540980106,312,17,1,10,6,10,25,381
540980201,27,0,0,0,0,0,0,27
540980202,345,20,0,25,0,1,7,398
540980203,128,4,1,1,2,2,12,150
540980204,43,1,0,1,0,2,3,50
540980205,31,1,0,0,0,0,2,34
540980206,299,6,0,4,2,0,2,313
540980207,323,14,0,4,0,1,5,347
540980301,60,3,0,0,0,3,16,82
540980302,146,13,1,0,0,3,9,172
540980303,99,7,0,0,0,0,0,106
540980401,119,6,1,1,0,0,16,143
540980402,45,2,0,1,0,3,10,61
540980403,27,0,0,0,0,0,10,37
540980501,303,22,0,0,1,1,4,331
540980502,303,17,4,0,0,0,0,324
540980503,246,18,4,6,1,1,5,281
540980504,218,15,4,2,0,0,3,242
540980505,223,15,4,1,0,0,5,248
540980506,170,13,4,4,1,0,3,195
540980507,199,17,1,2,0,1,3,223
540980508,30,1,0,0,0,0,7,38
540980509,153,10,3,2,0,2,11,181
540980510,84,2,0,9,0,0,34,129
540980511,152,3,0,1,0,1,14,171
540980512,88,4,0,0,0,0,8,100
540980513,204,16,2,1,0,0,2,225
540980514,208,8,2,10,0,0,7,235
540980515,162,19,6,3,0,1,3,194
540980516,333,11,0,1,0,0,3,348
540980517,112,11,0,1,0,0,11,135
540980518,224,18,0,27,0,0,2,271
540980601,68,1,1,0,1,3,8,82
540980602,59,13,0,0,0,0,5,77
540980603,38,5,0,0,0,1,2,46
540980604,24,4,0,0,0,5,8,41
540980605,13,4,0,0,0,4,8,29
540980701,154,10,1,1,1,0,10,177
540980702,189,12,1,6,0,4,11,223
540980703,51,2,0,0,0,0,8,61
540980704,113,5,3,1,3,1,7,133
540980801,103,5,0,4,0,4,6,122
540980802,120,3,0,0,0,7,6,136
540980803,118,4,0,1,0,0,29,152
540980901,166,4,1,8,0,3,7,189
540980902,328,16,0,7,0,1,11,363
540980903,182,12,1,1,1,1,8,206
540980904,227,6,0,1,0,6,3,243
540980905,122,8,0,1,0,2,6,139
540980906,82,17,0,0,0,0,1,100
540980907,296,12,2,0,3,2,11,326
540980908,311,9,0,34,2,2,10,368
540981001,12,2,0,0,0,0,5,19
540981002,501,23,4,10,1,2,16,557
540981003,209,9,1,4,0,0,5,228
540981004,219,10,1,2,0,3,10,245
540981005,229,10,3,1,1,0,6,250
540981006,260,14,5,1,0,3,10,293
540981007,211,15,4,5,0,3,9,247
540981008,257,11,3,2,0,1,9,283
540981009,188,19,4,4,1,1,1,218
540981010,184,9,2,2,2,2,7,208
540981011,292,17,2,3,0,3,8,325
540981101,56,1,0,0,0,0,3,60
540981102,92,8,0,0,0,1,7,108
540981103,141,6,0,0,0,1,18,166
540981201,145,12,0,0,0,0,0,157
540981202,203,12,1,3,0,3,8,230
540981203,151,13,4,6,0,1,8,183
540981204,291,16,1,7,0,3,4,322
540981205,312,17,0,4,0,1,7,341
540981206,248,17,0,0,0,0,3,268
540981207,224,3,7,6,0,2,22,264
540981208,312,15,3,2,0,1,10,343
540981209,230,11,7,6,0,0,7,261
540981210,183,20,2,8,3,1,2,219
540981211,220,9,4,1,3,0,5,242
540981212,195,5,0,4,0,0,4,208
540981213,168,14,3,3,1,1,4,194
540981214,254,11,5,10,2,3,7,292
541050101,76,1,0,0,0,1,0,78
541050102,42,1,0,1,0,0,4,48
541050103,171,2,0,0,0,1,0,174
541050104,71,3,0,0,0,0,0,74
541050105,81,3,0,1,0,2,3,90
541050106,5,0,0,0,0,1,1,7
541050107,50,1,0,0,0,0,7,58
541050108,83,2,0,0,0,0,0,85
541050109,6,0,0,0,0,1,1,8
541050110,15,5,0,0,0,0,0,20
541050111,9,0,0,0,0,0,0,9
541050112,87,3,0,0,1,0,0,91
541050113,202,5,0,1,0,0,1,209
541050201,97,0,0,0,0,0,1,98
541050202,89,2,1,2,1,0,1,96
541050203,90,1,0,0,0,0,2,93
541050204,72,0,0,0,0,0,1,73
541050205,6,0,0,0,0,0,1,7
541050206,6,2,0,1,0,0,0,9
541050207,130,3,0,1,3,1,17,155
541050208,85,3,0,1,0,4,1,94
541050209,288,17,1,2,1,2,8,319
541050210,33,2,0,0,0,1,2,38
541050211,20,0,0,0,0,0,0,20
541050212,56,0,0,0,2,5,1,64
541050213,204,10,2,2,0,1,12,231
541050214,248,12,2,4,0,2,7,275
541050215,164,10,3,2,0,0,13,192
541050216,217,12,1,2,0,0,2,234
541050217,253,10,2,2,0,0,2,269
541050218,320,17,1,1,0,4,5,348
541050219,236,17,5,1,5,1,9,274
541050220,184,11,0,0,2,1,5,203
541050221,223,12,6,0,0,0,7,248
541050222,200,17,2,2,1,1,2,225
541050223,168,9,16,3,0,3,8,207
541050301,44,1,0,2,0,2,8,57
541050302,258,18,0,12,1,5,9,303
541050303,40,9,0,1,0,0,0,50
541050304,10,0,0,0,0,0,0,10
541050305,56,1,0,1,0,1,3,62
541050306,61,4,0,0,0,0,5,70
541050307,87,5,0,0,0,0,6,98
541050308,42,2,0,0,0,2,0,46
541050401,203,20,1,2,0,4,16,246
541050402,143,14,1,17,0,0,10,185
541050403,111,6,1,0,1,0,1,120
541050404,70,2,0,2,0,9,3,86
541120101,457,13,0,1,0,0,24,495
541120102,786,76,8,17,2,11,51,951
541120103,327,43,0,7,0,5,19,401
541120104,41,0,0,2,0,0,5,48
541120105,39,0,0,0,0,0,5,44
541120106,89,18,0,1,1,3,5,117
541120201,5,0,0,0,0,0,0,5
541120202,20,0,0,0,0,0,0,20
541120301,6,2,0,0,0,0,0,8
541120302,27,0,0,0,0,0,0,27
541120401,1,5,0,0,0,0,8,14
541120402,1,6,0,0,0,0,5,12
541120501,328,13,0,5,2,0,7,355
541120502,274,14,6,3,4,1,6,308
541120503,220,7,2,1,0,1,7,238
541120504,245,13,2,1,0,0,9,270
541120505,337,15,1,3,0,7,16,379
541120506,255,7,0,0,0,2,15,279
541120507,152,8,0,0,0,1,1,162
541120508,284,19,2,3,2,0,30,340
541120509,227,28,3,34,0,0,12,304
541120510,331,21,2,5,0,2,6,367
541120511,285,18,1,1,0,0,4,309
541120512,226,7,2,3,0,0,8,246
541120513,214,7,5,0,4,1,3,234
541120514,121,3,7,4,0,2,5,142
541120515,238,9,1,2,0,0,7,257
541120601,230,43,1,6,0,4,4,288
541120602,502,15,0,1,0,1,11,530
541120701,18,0,0,0,0,0,0,18
541120702,337,22,0,2,0,0,11,372
541120703,655,18,2,18,1,4,28,726
541120704,135,13,2,6,0,3,5,164
541190101,219,7,0,0,0,1,4,231
541190102,190,2,0,1,0,2,4,199
541190103,383,16,1,0,0,0,11,411
541190104,349,10,0,0,0,0,5,364
541190105,577,17,1,2,1,2,3,603
541190106,283,8,2,2,1,0,6,302
541190107,517,23,2,0,0,0,2,544
541190201,137,1,0,0,0,0,1,139
541190202,265,0,2,0,0,0,5,272
541190203,259,0,1,0,0,1,3,264
541190204,127,1,0,2,0,1,0,131
541190301,63,0,0,0,0,0,0,63
541190302,385,9,1,0,0,0,4,399
541190303,266,7,1,0,0,1,21,296
541190304,115,2,0,4,0,13,2,136
541190305,165,8,1,4,0,0,6,184
541190306,72,1,0,1,0,4,0,78
541190307,257,25,0,3,1,0,3,289
541190401,121,6,0,0,0,0,0,127
541190402,264,11,1,4,0,2,11,293
541190403,414,25,1,28,4,9,14,495
541190501,95,4,5,2,0,0,2,108
541190502,467,21,2,7,1,1,13,512
541190503,238,1,2,3,0,4,14,262
541190504,136,8,0,3,0,9,3,159
541190505,49,0,0,0,0,5,0,54
541190506,115,0,0,0,1,1,4,121
541190507,133,6,4,4,2,3,8,160
541190508,357,16,1,7,5,1,8,395
541190601,34,3,0,0,0,0,3,40
541190602,187,7,1,0,0,0,3,198
541190603,108,15,0,3,0,20,1,147
580070101,0,0,0,0,1,45,16,62
580070102,133,31,0,1,0,8,8,181
580070103,134,11,1,27,0,42,16,231
580070104,170,25,3,27,1,156,9,391
580070105,89,99,1,23,2,145,36,395
580070201,91,6,0,1,0,0,1,99
580070202,25,35,0,2,0,1,7,70
580070203,77,34,0,6,1,8,23,149
580070204,32,10,0,4,1,0,3,50
580070205,208,28,0,1,0,3,6,246
580070301,105,35,1,14,0,2,3,160
580070302,499,44,1,14,0,0,19,577
580070303,333,21,2,0,4,1,7,368
580070304,350,43,1,12,1,2,6,415
580070305,91,19,0,14,0,2,17,143
580140101,108,13,0,0,0,3,5,129
580140102,131,65,0,3,0,0,7,206
580140103,77,14,2,2,0,5,5,105
580140104,269,30,12,4,2,0,10,327
580140105,84,7,0,0,6,6,6,109
580140106,320,0,19,0,31,0,11,381
580140107,191,8,1,0,0,2,5,207
580140108,213,29,15,0,0,0,10,267
580140109,486,0,40,21,23,1,4,575
580140110,330,24,15,11,2,0,13,395
580140111,111,7,0,0,5,36,2,161
580140112,61,37,0,1,2,6,8,115
580140113,70,17,0,0,2,8,6,103
580140114,264,52,29,41,4,1,15,406
580140115,137,7,0,18,0,0,10,172
580140116,274,26,1,13,1,2,15,332
580210101,33,0,0,0,0,1,0,34
580210102,35,0,0,1,0,0,10,46
580210103,78,0,0,0,0,0,0,78
580210104,42,4,0,0,0,0,2,48
580210105,71,4,0,0,0,2,3,80
580210106,13,2,0,0,0,0,0,15
580210107,40,8,0,0,0,0,0,48
580210108,20,5,0,0,0,0,0,25
580210109,42,3,0,0,0,0,3,48
580210110,32,0,0,0,0,0,0,32
580210111,17,7,0,0,0,0,2,26
580210112,217,26,5,18,5,0,12,283
580280101,32,13,0,0,0,0,0,45
580280102,15,3,0,0,0,0,2,20
580280103,50,17,0,0,0,0,2,69
580280104,55,0,0,0,0,0,4,59
580280105,25,4,0,0,0,15,2,46
580280106,16,5,0,0,0,6,0,27
580280107,280,17,6,4,0,2,7,316
580280108,95,7,0,0,1,1,2,106
580280109,258,41,9,5,2,0,5,320
580280110,114,9,0,67,0,0,2,192
580280115,37,2,1,0,0,6,1,47
580280116,62,7,0,6,0,0,5,80
580280117,254,25,2,0,2,2,1,286
580350101,26,20,0,0,0,0,12,58
580350102,94,14,0,1,0,23,1,133
580350103,12,32,0,0,0,13,2,59
580350104,20,0,2,7,0,242,13,284
580350105,21,13,0,15,0,84,1,134
580350106,27,3,0,0,0,0,1,31
580350107,26,4,0,1,0,0,5,36
580350108,20,10,0,1,1,0,0,32
580350109,13,3,5,6,2,238,4,271
580350201,79,30,0,17,0,0,29,155
580350202,146,9,0,7,3,0,2,167
580350203,7,5,0,1,0,0,1,14
580350204,240,43,1,5,0,2,15,306
580350205,116,6,0,4,0,1,3,130
580350206,41,18,0,5,0,0,16,80
580350207,147,27,0,2,0,0,7,183
580350208,102,13,0,30,1,1,11,158
580350209,218,14,0,0,0,0,1,233
580350210,240,23,0,7,0,1,11,282
580350211,138,36,0,11,0,0,22,207
580350212,140,45,0,8,0,0,33,226
580350213,132,14,0,18,2,1,5,172
580350214,150,29,0,7,0,0,3,189
580350215,196,18,0,5,0,0,19,238
580350216,46,1,0,3,0,1,4,55
580350301,215,24,0,0,1,0,3,243
580350302,242,9,0,0,0,0,2,253
580350303,262,27,0,0,0,0,5,294
580350304,368,25,6,17,1,0,34,451
580350305,361,19,3,1,0,0,1,385
580350306,341,25,10,22,0,1,16,415
580350307,346,39,2,0,1,0,6,394
580350308,419,16,0,1,0,0,16,452
580350309,315,21,4,1,2,0,42,385
580350310,255,37,6,0,1,0,4,303
580350311,120,13,0,7,0,0,5,145
580350312,104,9,0,0,0,1,1,115
580350313,265,23,2,12,0,2,5,309
580350314,32,19,0,1,0,0,0,52
580350315,173,32,0,11,2,0,9,227
580350316,294,17,1,15,1,1,0,329
580350401,253,45,18,1,4,0,10,331
580350402,283,63,8,1,11,1,7,374
580350403,133,16,3,5,3,1,6,167
580350404,407,25,5,8,0,0,7,452
580350405,242,23,3,4,1,0,3,276
580350406,272,21,5,0,0,1,10,309
580350407,195,18,7,1,6,1,15,243
580350408,293,14,12,5,4,0,18,346
580350409,314,38,16,2,2,1,5,378
580350410,305,25,3,7,3,1,7,351
580350411,296,27,18,7,4,5,12,369
580350412,328,19,1,4,2,1,3,358
580350413,173,9,3,1,4,1,10,201
580350414,291,34,5,2,1,0,11,344
580350415,295,25,7,6,2,0,18,353
580350416,257,24,1,5,0,2,4,293
580350417,264,63,12,4,3,0,21,367
580350418,288,89,22,0,12,0,18,429
580350419,277,70,14,7,3,0,13,384
580350420,282,48,6,3,3,0,6,348
580350421,179,23,0,1,0,0,9,212
580350501,217,77,3,2,7,4,9,319
580350502,249,26,28,0,0,0,5,308
580350503,310,58,5,1,11,2,1,388
580350504,181,82,24,0,50,0,20,357
580350505,203,34,12,1,17,3,5,275
580350506,249,40,14,1,2,0,14,320
580350507,180,27,8,2,26,0,25,268
580350508,172,19,5,0,4,0,17,217
580350509,251,78,19,0,9,0,16,373
580350510,273,60,19,2,45,0,8,407
580350511,290,46,39,1,12,7,4,399
580350512,119,15,9,1,3,0,2,149
580350513,242,38,18,1,5,0,10,314
580350514,193,27,33,0,14,1,6,274
580350515,202,69,68,1,5,1,12,358
580350516,317,62,51,0,36,4,15,485
580350517,203,34,20,1,17,2,7,284
580350518,132,22,15,4,2,0,7,182
580350519,141,10,3,0,0,0,7,161
580350520,122,26,4,0,5,1,5,163
580350521,188,29,8,0,4,0,15,244
580350522,200,46,5,0,6,0,3,260
580350523,185,37,12,1,7,3,7,252
580350601,295,24,22,7,4,0,5,357
580350602,217,71,10,0,3,0,15,316
580350603,198,14,12,0,9,0,11,244
580350604,205,27,7,1,16,0,2,258
580350605,256,42,14,5,6,1,10,334
580350606,174,18,0,0,1,0,5,198
580350607,191,10,2,1,0,0,1,205
580350608,313,42,16,7,5,1,11,395
580350609,294,26,7,3,8,1,10,349
580350610,217,11,20,0,7,0,9,264
580350611,223,44,3,1,11,0,10,292
580350612,267,45,21,1,17,1,3,355
580350613,295,59,43,5,35,7,10,454
580350614,274,55,8,3,21,8,11,380
580350615,222,42,16,3,30,0,7,320
580350616,184,27,18,3,3,0,15,250
580350617,206,61,6,1,34,1,11,320
580350618,98,31,6,1,8,0,3,147
580350701,54,5,0,4,0,0,0,63
580350702,161,9,3,0,0,0,6,179
580350703,307,36,9,1,0,1,13,367
580350704,384,15,2,4,0,0,11,416
580350705,242,16,1,0,1,0,4,264
580350706,278,12,2,1,2,0,1,296
580350707,241,9,0,5,1,0,10,266
580350708,283,17,4,1,2,0,3,310
580350709,319,14,7,3,0,0,8,351
580350710,281,21,1,0,0,0,4,307
580350711,343,12,3,1,0,0,8,367
580350712,327,21,8,5,0,0,16,377
580350713,224,14,0,0,0,0,0,238
580350714,230,11,0,1,0,0,3,245
580350715,230,18,1,0,0,0,1,250
580350801,190,8,0,26,0,0,5,229
580350802,450,30,0,14,0,0,12,506
580350803,353,23,2,1,0,0,3,382
580350804,213,4,0,1,0,0,1,219
580350805,119,8,3,0,0,0,0,130
580350806,308,13,0,0,0,0,8,329
580350807,271,19,0,2,0,0,5,297
580350808,195,15,0,0,0,0,5,215
580350809,298,24,3,0,0,0,6,331
580350810,325,34,2,0,0,0,6,367
580350811,320,43,3,0,0,0,4,370
580350812,231,17,5,0,0,0,5,258
580350813,219,17,0,0,0,0,2,238
580350814,343,14,1,3,0,0,6,367
580350815,239,14,1,4,0,0,3,261
580350816,356,24,1,23,0,0,17,421
580350817,271,14,0,1,0,0,5,291
580350818,174,3,3,5,0,0,5,190
580350819,210,23,0,0,1,0,1,235
580350820,244,29,0,2,2,0,6,283
580350821,187,6,0,3,1,0,8,205
580350822,351,15,0,3,0,0,5,374
580350823,259,5,0,0,0,0,5,269
580350824,181,30,0,7,0,0,7,225
580350825,217,9,0,2,0,0,6,234
580350826,190,0,0,0,0,0,5,195
580350901,207,13,0,1,1,0,3,225
580350902,258,13,1,2,1,0,2,277
580350903,333,13,4,1,0,0,6,357
580350904,343,19,1,0,0,0,6,369
580350905,186,3,3,0,0,0,0,192
580350906,252,24,0,0,0,0,2,278
580350907,329,9,0,0,0,0,6,344
580350908,301,12,0,0,1,0,7,321
580350909,330,11,2,9,0,0,4,356
580350910,269,15,3,4,1,0,5,297
580350911,276,17,3,4,1,0,0,301
580350912,275,17,2,1,0,0,10,305
580350913,360,11,3,0,2,0,4,380
580350914,318,25,1,1,0,0,2,347
580350915,212,10,1,0,4,0,2,229
580350916,267,29,1,0,0,0,8,305
580350917,317,8,0,0,0,0,5,330
580350918,263,55,0,0,0,0,7,325
580351001,156,16,1,1,0,0,6,180
580351002,293,12,0,5,2,0,4,316
580351003,224,13,5,5,2,0,4,253
580351004,292,43,3,7,1,0,12,358
580351005,391,30,4,2,0,0,5,432
580351006,423,39,18,8,3,2,2,495
580351007,210,18,1,1,0,0,5,235
580351008,273,20,12,1,0,0,0,306
580351009,312,25,6,4,1,1,4,353
580351010,159,33,0,23,1,0,5,221
580351011,262,31,6,3,0,1,3,306
580351012,222,1,0,0,0,0,12,235
580351013,397,24,4,7,3,1,15,451
580351014,192,6,2,9,1,0,0,210
580351015,233,7,1,2,0,0,5,248
580351016,228,8,0,5,2,0,7,250
580351017,248,25,4,2,5,1,3,288
580351018,133,3,0,1,4,0,3,144
580351101,242,18,3,2,0,0,3,268
580351102,255,18,8,9,0,0,7,297
580351103,387,17,0,0,0,1,1,406
580351104,441,44,7,9,3,2,18,524
580351105,207,23,4,3,2,0,3,242
580351106,356,30,4,4,4,0,11,409
580351107,390,40,16,5,4,0,15,470
580351108,233,12,9,4,1,0,7,266
580351109,97,8,0,7,0,0,0,112
580351110,225,39,11,6,13,0,13,307
580351111,0,0,0,0,0,0,0,0
580351112,269,98,0,52,2,1,23,445
580351113,304,11,5,0,1,0,9,330
580351114,226,15,2,3,1,1,1,249
580351115,238,7,0,1,0,0,4,250
580351116,157,6,0,0,0,0,3,166
580351117,382,28,1,1,0,0,5,417
580351118,215,4,0,5,1,0,4,229
580351119,196,17,2,0,0,1,3,219
580351120,196,24,4,1,6,0,6,237
580351121,259,19,4,12,3,0,1,298
580351122,240,9,0,0,0,0,5,254
580351123,198,23,2,0,0,0,4,227
580351124,111,0,2,0,0,0,2,115
580351125,162,9,3,13,0,0,2,189
580351126,163,17,1,34,0,0,19,234
580351201,345,20,11,2,13,2,10,403
580351202,163,0,12,2,5,0,11,193
580351203,207,28,7,9,4,0,8,263
580351204,386,16,4,0,2,0,15,423
580351205,405,21,1,0,8,0,14,449
580351206,225,11,2,0,0,3,3,244
580351207,189,8,5,1,0,0,1,204
580351208,234,11,8,6,2,2,5,268
580351209,325,24,16,2,11,0,3,381
580351210,201,13,0,1,1,2,2,220
580351211,169,10,3,0,0,1,1,184
580351212,240,2,0,0,0,0,6,248
580351213,260,39,1,0,3,0,8,311
580351214,234,38,5,2,2,0,5,286
580351215,310,22,4,16,10,0,7,369
580351216,254,7,4,0,1,1,5,272
580351301,223,43,12,1,21,1,11,312
580351302,134,21,20,1,34,1,3,214
580351303,120,32,20,1,9,2,3,187
580351304,150,15,2,1,1,0,10,179
580351305,156,14,4,1,0,0,12,187
580351306,277,36,13,0,8,0,6,340
580351307,287,26,5,5,10,0,8,341
580351308,187,27,2,4,9,1,3,233
580351309,301,52,15,4,1,0,4,377
580351310,355,23,9,2,2,0,5,396
580351311,259,30,4,0,3,0,9,305
580351312,307,18,3,5,1,0,10,344
580351313,382,21,19,3,5,0,11,441
580351314,236,26,6,1,1,0,5,275
580351315,368,38,12,3,0,0,6,427
580351316,313,28,7,3,1,1,7,360
580351401,181,13,2,2,0,0,10,208
580351402,60,6,0,4,0,0,1,71
580351403,294,8,1,14,1,0,2,320
580351404,293,24,2,3,0,1,2,325
580351405,291,53,10,3,5,3,5,370
580351406,181,34,55,2,5,0,18,295
580351407,349,51,5,3,8,0,6,422
580351408,340,9,11,3,5,2,30,400
580351409,294,17,14,2,5,0,7,339
580351410,376,2,2,4,1,0,21,406
580351411,403,23,4,0,1,0,12,443
580351412,340,20,1,0,0,2,10,373
580351413,400,28,12,3,0,2,7,452
580351414,384,21,11,4,1,1,16,438
580351415,164,2,0,0,0,0,1,167
580351416,116,14,1,2,1,0,6,140
580351417,280,11,0,5,0,0,10,306
580351418,360,23,4,9,0,4,6,406
580351419,212,16,2,3,0,0,19,252
580351420,48,3,0,27,1,1,1,81
580351421,152,5,0,13,0,0,13,183
580351422,219,27,1,4,1,0,0,252
580351501,398,25,3,4,0,0,5,435
580351502,254,18,2,4,0,0,7,285
580351503,343,26,19,19,2,0,2,411
580351504,270,32,7,3,0,0,4,316
580351505,433,23,12,12,4,1,22,507
580351506,395,19,5,8,1,2,13,443
580351507,342,27,5,5,1,0,1,381
580351508,277,32,4,8,0,0,3,324
580351509,290,34,3,3,0,0,4,334
580351510,361,19,4,6,3,0,8,401
580351511,216,26,3,0,0,0,3,248
580351512,230,12,7,2,2,2,10,265
580351513,266,11,2,7,0,0,8,294
580351514,291,34,13,3,0,0,9,350
580351515,172,7,1,2,0,0,4,186
580351601,174,17,3,0,0,1,16,211
580351602,238,8,1,11,0,6,11,275
580351603,57,18,0,0,0,4,15,94
580351604,159,5,0,3,0,0,12,179
580351605,252,21,0,15,0,0,21,309
580351606,179,14,2,7,0,4,2,208
580351607,98,9,0,2,1,0,2,112
580351608,147,14,4,5,0,0,0,170
580351609,140,15,0,21,0,2,16,194
580351610,198,24,0,15,0,1,15,253
580351611,269,17,1,3,0,0,7,297
580351612,208,17,2,20,0,0,6,253
580351613,189,28,0,22,0,0,6,245
580351614,131,11,0,34,0,0,26,202
580351615,190,13,0,57,0,1,21,282
580351616,338,18,1,9,2,0,4,372
580351617,52,7,0,15,0,2,2,78
580351618,58,3,0,0,0,5,2,68
580351619,128,10,0,1,1,0,2,142
580351620,76,9,1,0,0,0,0,86
580351701,321,26,6,0,8,0,11,372
580351702,259,28,2,4,7,0,7,307
580351703,147,6,3,3,7,1,9,176
580351704,296,25,1,6,9,1,9,347
580351705,103,10,3,6,3,0,3,128
580351706,213,18,9,4,0,0,4,248
580351707,374,38,7,13,2,0,4,438
580351708,382,20,7,0,2,0,5,416
580351709,345,40,4,6,11,0,8,414
580351710,326,14,4,4,17,0,12,377
580351711,406,26,6,1,2,0,6,447
580351801,4,1,0,0,0,0,0,5
580351802,271,16,1,27,3,0,7,325
580351803,203,19,3,40,0,1,12,278
580351804,171,18,2,2,0,0,4,197
580351805,268,15,3,1,0,1,7,295
580351806,205,12,3,5,1,0,5,231
580351807,325,25,6,5,5,0,22,388
580351808,288,28,8,2,0,0,3,329
580351809,325,22,7,8,4,3,9,378
580351810,315,32,12,5,1,0,5,370
580351811,172,46,4,188,1,1,42,454
580351812,333,44,7,73,6,10,27,500
580351813,187,8,1,6,0,4,6,212
580351814,131,51,1,7,0,17,7,214
580351815,265,19,0,6,0,0,0,290
580351816,239,10,1,0,0,1,7,258
580351817,206,10,0,21,0,0,3,240
580351818,269,31,0,15,3,1,1,320
580351819,182,26,5,18,3,0,4,238
580351820,191,14,0,5,0,0,1,211
580351821,236,13,1,18,0,1,4,273
580351822,192,12,1,4,0,0,6,215
580351823,198,7,0,0,0,0,2,207
580351824,203,19,6,15,0,6,5,254
580351825,202,13,0,20,0,4,3,242
580351826,163,30,7,35,0,0,7,242
580351901,187,24,0,25,1,51,19,307
580351902,301,18,3,2,0,0,5,329
580351903,193,20,6,4,0,0,1,224
580351904,306,20,6,4,1,0,5,342
580351905,341,46,3,7,1,1,3,402
580351906,326,28,5,6,6,0,14,385
580351907,304,28,7,16,1,3,10,369
580351908,359,37,5,19,0,2,11,433
580351909,297,20,8,10,1,2,3,341
580351910,219,23,0,1,0,0,3,246
580351911,304,28,5,13,0,2,7,359
580351912,106,15,0,25,0,6,12,164
580351913,176,7,0,6,0,0,4,193
580351914,174,25,1,15,1,14,10,240
580352001,112,8,0,1,0,0,7,128
580352002,200,21,3,5,2,46,1,278
580352003,49,2,3,6,0,22,2,84
580352004,96,16,0,1,0,1,4,118
580352005,20,8,0,0,0,0,0,28
580352006,90,58,0,6,0,2,14,170
580352007,306,50,1,20,1,34,35,447
580352008,423,25,6,4,2,1,17,478
580352009,239,22,4,4,15,1,7,292
580352010,269,37,2,9,0,1,8,326
580352011,284,13,0,1,0,0,1,299
580352012,384,15,1,0,3,0,4,407
580352101,112,35,0,7,1,6,10,171
580352102,291,5,1,1,0,0,2,300
580352103,251,14,0,4,1,3,3,276
580352104,352,35,3,6,2,3,15,416
580352105,249,20,2,0,1,0,8,280
580352106,267,31,1,1,3,1,17,321
580352107,324,28,3,3,5,0,12,375
580352108,256,22,0,24,1,1,2,306
580352109,251,8,2,0,0,0,6,267
580352110,301,37,1,6,0,0,11,356
580352111,251,20,0,7,0,1,6,285
580352112,195,3,3,8,0,0,3,212
580352113,138,21,1,4,0,12,9,185
580352114,248,25,2,4,9,0,8,296
580352115,171,9,2,8,1,0,5,196
580352116,183,17,0,6,0,0,9,215
580352201,59,0,3,3,0,2,129,196
580352202,195,16,0,5,0,0,3,219
580352203,26,8,0,0,0,0,2,36
580352204,15,4,0,13,0,0,0,32
580352205,210,29,0,14,0,4,11,268
580352206,279,20,1,0,0,1,2,303
580352207,175,8,11,0,1,0,6,201
580352208,298,15,1,1,2,0,5,322
580352209,258,23,1,0,0,0,11,293
580352210,240,22,0,2,0,0,4,268
580352211,335,24,0,1,2,0,5,367
580352212,130,36,0,0,0,0,3,169
580352213,222,14,0,2,2,0,0,240
580352214,238,15,0,2,1,0,2,258
580352215,166,16,0,3,0,0,13,198
580352216,163,14,1,0,0,0,3,181
580352217,286,15,0,5,0,0,9,315
580352218,119,4,0,0,0,0,5,128
580352219,258,12,0,2,0,0,5,277
580352220,223,9,0,7,0,0,6,245
580352221,133,11,0,1,0,0,6,151
580352301,55,0,0,1,0,0,7,63
580352302,272,6,2,3,0,0,5,288
580352303,192,0,2,6,0,0,4,204
580352304,286,17,1,4,8,0,6,322
580352305,235,1,5,4,13,1,8,267
580352306,159,3,14,0,2,0,5,183
580352307,294,0,4,9,20,2,6,335
580352308,282,10,1,3,0,0,24,320
580352309,343,17,7,1,11,0,15,394
580352310,260,5,14,4,14,0,22,319
580352311,269,3,4,0,4,0,6,286
580352312,253,2,6,3,1,0,6,271
580352313,291,29,0,4,0,0,5,329
580352314,256,0,2,7,0,0,0,265
580352315,201,2,1,3,0,1,0,208
580352316,214,3,1,0,0,0,2,220
580352317,237,3,1,2,2,0,1,246
580352318,152,0,0,0,0,0,0,152
580352319,320,11,3,14,3,1,10,362
580352320,196,13,1,5,0,0,2,217
580352321,164,2,0,0,0,0,1,167
580352322,9,0,0,1,0,1,1,12
580352323,184,0,0,0,0,0,1,185
580352324,193,3,8,12,0,0,2,218
580352325,226,6,0,2,3,0,8,245
580352326,221,14,2,9,1,0,0,247
580352327,171,28,0,3,0,0,6,208
580352401,232,13,1,1,0,1,3,251
580352402,234,7,3,2,1,0,3,250
580352403,419,17,3,3,0,1,6,449
580352404,352,23,0,3,0,0,7,385
580352405,147,11,0,0,0,0,0,158
580352406,212,20,0,2,0,0,26,260
580352407,253,18,2,7,0,0,15,295
580352408,278,21,1,9,0,0,13,322
580352409,241,7,0,45,0,0,15,308
580352410,277,7,1,1,0,0,9,295
580352411,337,14,2,0,2,0,16,371
580352412,292,13,0,1,0,0,7,313
580352413,205,7,0,1,0,0,26,239
580352414,185,6,5,16,2,0,4,218
580352501,337,22,1,18,0,0,8,386
580352502,312,12,1,26,2,0,6,359
580352503,327,30,4,15,3,0,7,386
580352504,206,17,1,5,4,0,0,233
580352505,165,15,0,0,0,0,1,181
580352506,159,11,1,0,1,0,0,172
580352507,208,16,0,0,0,0,2,226
580352508,169,17,4,3,0,1,6,200
580352509,189,6,0,0,0,0,1,196
580352510,266,9,1,1,0,0,2,279
580352511,203,12,3,6,0,0,5,229
580352512,228,11,1,13,0,0,4,257
580352513,258,23,0,2,0,0,1,284
580352514,291,24,4,7,4,1,4,335
580352515,247,11,2,3,0,0,5,268
580352516,258,16,0,6,0,0,2,282
580352517,295,19,1,0,0,0,3,318
580420101,92,47,0,0,4,0,1,144
580420102,38,3,0,0,0,0,6,47
580420103,75,8,0,0,2,6,11,102
580420104,62,12,0,0,1,3,23,101
580420105,107,23,0,4,0,0,1,135
580420106,141,14,0,3,1,1,15,175
580420107,30,0,0,0,0,2,18,50
580420108,46,1,0,0,0,6,26,79
580420109,50,11,2,6,0,2,1,72
580420201,229,40,2,16,0,10,12,309
580420202,182,13,4,1,1,0,2,203
580420203,204,47,0,6,0,1,6,264
580420204,171,7,7,0,11,0,3,199
580420205,215,16,6,3,6,1,4,251
580420206,240,29,1,8,7,0,4,289
580420207,269,33,5,13,6,2,17,345
580420208,271,30,10,6,0,0,12,329
580420209,188,26,3,6,0,1,12,236
580420210,184,22,2,22,0,0,4,234
580420211,296,31,0,9,1,0,2,339
580420212,196,4,1,3,11,0,10,225
580420213,177,8,1,7,0,0,17,210
580420214,275,29,7,19,2,0,2,334
580420215,231,30,8,12,0,0,4,285
580420216,192,16,8,17,1,3,3,240
580420217,281,12,2,28,0,1,2,326
580490101,3,0,0,0,0,0,0,3
580490102,39,11,0,3,0,6,7,66
580490103,10,3,0,1,0,0,0,14
580490201,16,4,0,1,0,5,6,32
580490202,116,13,0,0,0,0,9,138
580490203,67,2,0,1,0,0,14,84
580490204,69,1,0,0,0,0,13,83
580490205,97,2,0,0,0,0,10,109
580490301,66,23,1,2,0,22,6,120
580490302,25,3,0,0,0,11,1,40
580490401,281,27,6,29,1,17,10,371
580490402,121,7,0,0,0,1,20,149
580490403,259,16,0,1,0,0,1,277
580490404,309,25,1,1,1,0,11,348
580490405,185,9,4,1,2,3,11,215
580490406,196,22,0,6,2,1,6,233
580490407,426,16,6,3,19,1,7,478
580490408,278,34,7,1,7,0,4,331
580490409,251,31,17,2,7,4,5,317
580490410,166,13,2,3,1,1,28,214
580490411,214,13,3,2,1,1,5,239
580490412,180,11,2,0,0,0,3,196
580490413,265,22,0,1,0,0,3,291
580490414,197,21,1,6,0,0,7,232
580490415,183,26,1,6,0,0,11,227
580560101,71,5,0,0,0,0,0,76
580560102,12,3,0,1,0,0,1,17
580560104,8,0,0,0,0,0,1,9
580560105,119,4,0,0,0,23,23,169
580560201,19,13,0,9,0,14,4,59
580560202,17,9,0,0,0,0,1,27
580560203,12,3,0,0,0,1,10,26
580560204,8,0,0,0,0,0,0,8
580560205,11,4,1,1,0,67,16,100
580560206,27,27,1,27,0,92,9,183
580560301,185,0,1,0,0,0,2,188
580560302,290,17,2,1,1,0,4,315
580560303,275,13,0,3,0,0,2,293
580560304,271,24,1,2,3,0,5,306
580560305,326,35,0,3,0,0,10,374
580560306,319,21,2,3,0,0,8,353
580560307,207,17,8,1,1,7,10,251
580560308,347,39,7,4,2,4,32,435
580560309,200,33,11,1,4,1,21,271
580560310,79,11,0,1,1,33,5,130
580560401,204,21,5,18,1,19,22,290
580560402,183,6,0,1,1,0,9,200
580560403,271,31,29,13,0,8,21,373
580560404,210,34,10,7,1,12,2,276
580560405,450,31,6,35,0,4,8,534
580560406,282,47,8,34,0,46,9,426
580560407,340,21,10,9,3,5,10,398
580560408,212,5,0,4,0,1,11,233
580560409,193,19,22,17,0,6,7,264
580560410,164,32,8,10,2,22,7,245
580560411,38,8,0,4,0,2,4,56
580560501,17,2,0,1,0,3,1,24
580560502,139,32,18,8,0,14,10,221
580560503,99,12,0,0,0,0,1,112
580560504,174,32,2,1,0,6,2,217
580560505,330,33,8,4,0,3,5,383
580560506,293,24,22,3,1,0,12,355
580560507,278,24,6,4,1,0,7,320
580560508,262,16,2,0,0,1,4,285
580560509,299,44,17,1,7,10,8,386
580560510,203,44,42,2,11,12,24,338
580560511,217,40,30,2,7,6,7,309
580560512,168,18,9,0,0,7,6,208
580560513,138,23,2,3,0,1,11,178
580560514,110,17,53,0,4,9,6,199
580560515,169,80,30,0,29,4,18,330
580560516,205,54,67,3,25,8,6,368
580560517,139,34,14,0,5,6,5,203
580630101,43,71,2,0,0,0,9,125
580630102,76,14,0,0,0,0,10,100
580630103,25,13,0,0,0,0,0,38
580630104,145,10,0,0,0,1,7,163
580630105,38,8,0,0,0,0,1,47
580630106,11,0,0,0,0,0,6,17
580630107,14,9,0,0,0,0,0,23
580630108,25,0,0,0,0,1,12,38
580630109,90,23,0,2,0,1,5,121
580630110,31,1,0,5,0,0,25,62
580630111,553,35,8,10,3,2,12,623
580630112,489,38,4,12,2,1,22,568
580630113,330,21,0,21,0,27,12,411
580700101,13,0,0,0,0,0,0,13
580700102,28,6,0,1,0,8,6,49
580700103,312,97,12,38,1,176,26,662
580700104,197,68,13,8,0,30,8,324
580700105,430,32,9,7,1,5,12,496
580700106,268,41,5,4,11,8,21,358
580700107,409,29,1,10,4,22,6,481
580700108,190,41,14,9,0,22,18,294
580700109,193,19,4,4,2,0,3,225
580700110,168,45,10,13,4,98,23,361
580700111,305,30,7,17,0,0,1,360
580700112,140,33,7,7,3,12,6,208
580700113,326,65,17,15,0,24,13,460
580700114,288,16,4,1,0,0,2,311
580700201,34,2,0,2,0,7,1,46
580700202,56,9,0,1,0,9,5,80
580700203,15,0,0,0,0,0,0,15
580700204,101,10,1,9,1,11,9,142
580770101,0,8,0,0,0,0,0,8
580770102,148,10,0,3,1,2,6,170
580770103,101,45,0,3,0,0,9,158
580770104,56,21,0,2,0,2,7,88
580770105,162,22,3,23,3,33,15,261
580770106,217,19,3,9,1,1,11,261
580770201,108,13,1,5,0,23,12,162
580770202,45,6,0,0,0,0,14,65
580770203,79,6,1,0,0,0,5,91
580770204,73,2,0,7,0,5,9,96
580770205,221,60,2,6,8,1,3,301
580770206,92,7,0,0,0,0,1,100
580770207,216,27,0,1,0,2,3,249
580770208,371,93,2,20,5,6,8,505
580770210,89,9,9,27,1,2,2,139
580840101,15,1,0,0,0,1,10,27
580840102,205,29,0,3,0,0,7,244
580840103,87,14,1,1,3,3,2,111
580840104,40,16,0,0,0,0,2,58
580840105,95,22,0,6,0,1,11,135
580840106,230,36,0,29,1,0,11,307
580840107,87,21,0,1,0,0,6,115
580840108,98,22,0,8,0,6,12,146
580840109,76,17,0,0,0,0,0,93
580840110,18,3,0,0,0,0,0,21
580840111,99,9,0,4,0,0,9,121
580840112,20,1,0,0,0,0,0,21
580840113,2,34,0,0,0,0,1,37
580840114,16,7,0,0,0,18,3,44
580840115,0,68,0,5,0,46,13,132
580840116,179,60,5,41,4,56,7,352
580910101,22,15,0,0,0,0,3,40
580910102,74,16,0,17,0,7,14,128
580910103,240,32,7,10,1,4,15,309
580910104,26,2,0,0,0,0,3,31
580910105,12,15,0,0,0,0,0,27
580910106,126,23,0,7,1,8,32,197
580910107,426,53,7,11,3,0,7,507
580910108,285,63,6,14,1,0,8,377
580910109,55,7,0,0,0,1,0,63
580910201,10,4,0,1,0,0,1,16
580910202,13,10,1,1,0,0,2,27
580910203,14,12,0,0,0,0,0,26
580910204,8,3,0,0,0,0,0,11
580910205,44,6,0,1,1,0,6,58
580910301,11,0,0,0,0,0,0,11
580910302,67,20,3,9,2,5,7,113
580910303,254,11,3,1,0,9,12,290
580910304,406,54,23,14,3,1,5,506
580910305,265,70,9,4,7,5,11,371
580910306,193,27,14,2,3,1,11,251
580910307,134,43,14,1,9,0,10,211
580910308,190,32,2,3,2,0,4,233
580910309,191,23,1,4,0,0,22,241
580910310,164,27,11,2,4,0,1,209
580910311,268,46,0,9,3,2,14,342
580910312,165,30,1,2,1,0,0,199
580910313,174,11,5,2,0,1,3,196
580910314,178,22,8,0,9,0,4,221
580910315,137,17,9,1,8,0,18,190
580910316,130,16,2,2,2,0,5,157
580910317,199,41,1,5,0,0,14,260
580910318,294,38,9,1,3,2,11,358
580910319,232,32,3,8,1,0,9,285
580910320,224,26,4,1,0,0,1,256
580910321,218,28,0,5,0,1,4,256
580910322,234,25,2,1,2,0,8,272
580910323,249,54,0,26,0,0,10,339
580910324,251,40,1,3,0,0,4,299
580910325,190,9,2,4,0,0,0,205
580910326,158,10,0,43,0,0,4,215
580910327,211,38,0,7,0,0,6,262
580980101,96,31,2,1,0,11,16,157
580980102,3,0,0,0,0,1,0,4
580980103,458,34,6,7,0,1,21,527
580980104,441,45,5,28,1,1,4,525
580980105,93,20,0,2,0,5,12,132
580980201,36,9,0,0,0,0,1,46
580980202,149,38,1,1,0,4,7,200
580980203,19,1,0,0,0,1,1,22
580980204,69,17,0,5,0,0,14,105
580980205,64,7,0,3,0,0,4,78
581050101,49,5,0,2,0,6,16,78
581050102,126,19,0,7,0,13,7,172
581050103,213,12,3,2,0,1,38,269
581050104,294,21,6,1,0,0,10,332
581050105,219,22,2,1,5,2,11,262
581050106,446,30,2,29,8,0,9,524
581050201,4,2,0,0,0,0,1,7
581050202,13,6,0,0,0,2,12,33
581050203,12,34,0,0,0,13,1,60
581050204,58,5,6,0,1,0,19,89
581050205,14,12,0,0,0,0,4,30
581050206,11,0,0,0,0,0,2,13
581050207,56,9,0,0,0,0,7,72
581050208,20,0,0,0,0,0,0,20
581050209,59,0,2,0,0,4,25,90
581050210,34,19,0,0,0,3,13,69
581050211,211,33,0,4,2,1,17,268
581050212,28,0,0,0,0,0,0,28
581050213,29,7,0,0,0,1,3,40
581050214,19,1,0,0,0,0,13,33
581120101,98,15,1,15,0,10,2,141
581120102,23,0,0,0,0,0,1,24
581120103,98,4,3,0,2,0,12,119
581120104,7,7,0,0,0,1,5,20
581120105,69,8,0,0,0,0,0,77
581120106,12,4,0,1,1,0,0,18
581120107,20,21,0,1,0,0,1,43
581120108,27,4,0,0,0,1,0,32
581120109,29,4,0,0,0,0,1,34
581120201,77,17,0,0,0,1,2,97
581120202,93,14,1,5,2,3,13,131
581120203,27,5,0,1,0,4,2,39
581120205,178,56,1,17,0,7,8,267
581120206,203,22,3,8,0,19,12,267
581120207,87,13,0,0,2,3,15,120
581120208,220,13,0,2,1,4,6,246
581120301,125,11,1,14,0,2,8,161
581120302,361,20,0,0,1,0,3,385
581120303,367,15,0,3,0,0,5,390
581120304,372,27,0,2,0,0,2,403
581120305,320,22,1,4,0,0,4,351
581120306,226,13,0,9,7,0,3,258
581120307,324,25,2,5,0,0,9,365
581120308,312,4,0,0,0,0,8,324
581120309,287,15,0,1,0,0,10,313
581120310,324,27,4,0,0,0,14,369
581120311,232,20,2,4,3,0,7,268
581120312,297,22,6,0,3,2,12,342
581120313,225,23,27,7,5,1,10,298
581120314,245,30,2,13,2,2,7,301
581120315,140,22,2,2,6,0,2,174
581120316,224,39,8,2,2,1,3,279
581120401,167,27,0,15,0,7,15,231
581120402,240,23,1,15,0,1,12,292
581120403,16,8,0,11,3,0,1,39
581120404,334,24,6,9,0,0,2,375
581120405,254,13,3,1,3,0,4,278
581120406,174,8,0,0,0,0,4,186
581120407,185,27,2,0,0,1,3,218
581120408,365,34,11,0,5,0,7,422
581120409,150,26,10,6,7,2,7,208
581120410,181,28,5,0,0,0,10,224
581120411,197,11,5,1,0,0,2,216
581120412,185,21,3,3,1,0,3,216
581120413,328,14,2,2,0,0,19,365
581120414,108,8,0,0,0,0,13,129
581120415,292,15,2,7,0,1,9,326
581120416,126,19,4,2,0,0,2,153
581120417,17,0,0,0,0,0,0,17
581120418,399,42,4,9,0,0,6,460
581120419,262,23,1,33,0,1,5,325
581120420,303,34,4,6,3,0,12,362
581120421,331,16,0,0,0,0,2,349
620070101,17,48,0,0,0,11,3,79
620070201,37,28,0,0,0,7,43,115
620070301,23,9,0,0,0,17,1,50
620070302,181,16,2,0,0,5,19,223
620070303,116,14,3,0,1,3,15,152
620070401,33,33,0,0,0,51,5,122
620070501,187,8,3,0,0,0,2,200
620070502,155,23,3,0,0,0,7,188
620070503,272,36,30,5,2,0,2,347
620070504,162,16,2,5,1,0,0,186
620070505,180,21,6,4,2,1,6,220
620070506,214,20,11,0,6,1,19,271
620070507,210,19,5,2,5,0,14,255
620070508,188,25,7,2,3,0,6,231
620070509,164,18,3,14,4,3,6,212
620070510,368,42,7,13,5,0,4,439
620070511,237,50,5,1,1,0,5,299
620070601,85,0,0,1,0,5,39,130
620070602,241,41,3,0,1,24,62,372
620070603,198,11,2,1,0,10,29,251
620070604,112,12,3,3,0,23,17,170
620070605,6,22,0,0,0,0,1,29
620070606,51,4,0,0,1,5,31,92
620070607,141,12,0,3,0,0,7,163
620070608,357,19,6,2,0,0,2,386
620070609,319,20,4,5,1,0,4,353
620070610,203,14,0,25,0,0,27,269
620070611,158,7,0,38,2,0,7,212
620070612,306,15,8,2,0,0,1,332
620070613,110,7,1,302,0,0,1,421
620070614,127,37,0,7,0,0,29,200
620070701,186,15,5,3,1,0,5,215
620070702,236,18,5,6,0,0,2,267
620070703,196,10,0,0,0,2,5,213
620070704,293,16,3,1,0,0,1,314
620070705,330,21,0,2,1,0,12,366
620070706,162,4,1,2,1,1,3,174
620070707,394,20,4,0,0,0,9,427
620070708,432,39,5,0,0,0,12,488
620070709,130,11,2,8,0,0,4,155
620070710,57,13,0,0,0,0,0,70
620070711,428,32,3,1,0,0,8,472
620070712,221,32,1,1,0,0,5,260
620070713,224,28,0,1,1,0,6,260
620070801,170,17,7,4,2,0,6,206
620070802,135,5,4,0,0,0,5,149
620070803,32,2,0,0,0,0,0,34
620070804,275,18,1,0,0,0,6,300
620070805,320,26,0,0,0,0,2,348
620070806,336,27,2,0,0,0,9,374
620070807,184,7,1,0,0,0,5,197
620070808,189,8,3,2,2,0,7,211
620070809,176,14,9,2,3,0,1,205
620070810,298,16,4,5,1,2,5,331
620070811,256,16,1,4,0,0,9,286
620070812,166,10,1,3,1,0,1,182
620070813,222,28,6,7,0,1,6,270
620070814,185,18,1,1,0,0,1,206
620070815,158,16,10,9,0,0,6,199
620070816,154,10,5,15,0,0,45,229
620070817,153,16,4,3,3,1,1,181
620070818,153,10,3,1,1,0,19,187
620070901,25,21,62,18,2,64,0,192
620070902,78,64,22,9,1,171,16,361
620070903,30,19,7,11,0,33,8,108
620070904,57,12,5,9,4,246,2,335
620070905,32,0,4,3,3,146,10,198
620070906,58,29,24,9,1,268,12,401
620071001,177,26,9,7,29,0,14,262
620071002,175,37,1,1,19,0,10,243
620071003,235,28,4,5,19,3,10,304
620071004,182,13,4,0,1,2,15,217
620071005,201,2,11,4,9,1,21,249
620071006,210,1,18,2,7,3,22,263
620071007,259,59,15,2,29,0,25,389
620071008,164,20,7,1,2,0,16,210
620071009,166,13,4,7,8,0,14,212
620071010,171,4,9,0,2,0,12,198
620071011,156,0,9,3,2,1,13,184
620071012,209,21,4,3,2,1,6,246
620071013,217,1,8,4,0,0,39,269
620071101,323,30,0,0,0,0,14,367
620071102,184,18,3,0,0,0,1,206
620071103,338,25,3,9,0,0,2,377
620071104,256,8,6,1,0,1,3,275
620071105,122,7,0,0,0,0,10,139
620071106,188,7,0,6,0,0,10,211
620071107,219,13,1,0,0,0,6,239
620071108,192,23,0,2,0,0,4,221
620071109,229,10,3,0,2,0,4,248
620071110,194,16,0,2,0,1,13,226
620071111,305,22,2,4,2,0,8,343
620071112,290,26,0,2,0,0,10,328
620140101,10,12,0,0,0,1,8,31
620140102,219,30,0,0,2,4,28,283
620140103,314,14,1,6,2,0,5,342
620140104,325,20,0,3,1,1,9,359
620140105,273,21,2,3,2,3,13,317
620140106,26,18,0,0,0,0,0,44
620140107,0,45,0,0,0,0,1,46
620140108,169,32,2,0,0,3,43,249
620140109,57,5,1,0,0,7,39,109
620140110,294,18,4,1,1,0,15,333
620140111,321,14,1,39,1,1,2,379
620140112,174,12,0,1,0,0,0,187
620140201,218,34,1,8,1,1,3,266
620140202,198,16,3,3,0,0,3,223
620140203,228,23,0,7,0,0,5,263
620140204,285,20,5,3,2,0,12,327
620140301,342,21,1,0,3,0,8,375
620140302,156,28,0,3,0,16,13,216
620140303,231,40,1,9,1,4,26,312
620140304,290,9,0,26,0,1,7,333
620140401,359,45,0,35,1,1,17,458
620140402,331,44,7,1,2,0,14,399
620140403,249,23,4,1,8,0,5,290
620140404,281,25,4,8,0,0,3,321
620140405,208,15,3,0,0,0,10,236
620140406,227,16,1,3,2,0,11,260
620140407,209,27,5,5,2,0,3,251
620140408,342,23,1,6,0,1,10,383
620140409,188,16,0,0,0,1,8,213
620140410,262,12,0,3,3,1,8,289
620140501,24,2,0,0,0,3,28,57
620140601,233,13,3,6,3,1,5,264
620140602,248,9,8,1,0,0,4,270
620140603,212,22,2,10,2,1,5,254
620140604,195,17,2,2,0,1,3,220
620140605,224,15,5,3,1,1,7,256
620140606,168,15,2,5,0,2,10,202
620140607,232,18,3,1,1,0,2,257
620140608,227,12,9,6,0,1,9,264
620140609,210,13,0,1,0,0,2,226
620140701,39,10,0,1,1,5,10,66
620140801,46,11,0,0,0,0,11,68
620140901,178,54,1,2,1,1,12,249
620140902,118,14,2,1,1,1,7,144
620140903,15,8,0,0,0,0,0,23
620141001,70,8,0,1,0,2,17,98
620141002,154,28,2,3,1,2,12,202
620141003,173,8,1,28,0,1,14,225
620141101,152,9,1,2,2,13,36,215
620141102,291,23,1,18,0,1,6,340
620141103,170,35,1,38,0,1,0,245
620210101,109,8,4,5,1,77,7,211
620210102,283,37,12,25,3,41,27,428
620210103,94,46,8,3,0,21,3,175
620210104,192,31,10,22,1,54,8,318
620210105,99,28,3,9,0,17,5,161
620210106,191,47,3,8,1,11,3,264
620210107,216,29,13,6,3,10,9,286
620210108,206,33,10,19,0,6,5,279
620210109,167,19,2,16,0,3,4,211
620210110,239,30,3,12,0,5,6,295
620210111,216,29,2,12,0,14,12,285
620210112,104,13,0,9,1,58,23,208
620210201,93,12,0,6,1,5,5,122
620210202,145,74,11,32,0,62,32,356
620210203,304,21,0,117,0,0,6,448
620210204,235,20,1,18,0,0,6,280
620210205,244,9,2,8,0,0,17,280
620210206,310,29,3,12,0,1,5,360
620210207,193,16,0,0,0,0,2,211
620210208,253,18,1,0,0,0,1,273
620210209,176,16,2,2,2,0,6,204
620210210,195,5,1,6,0,0,6,213
620210211,310,20,1,13,0,0,12,356
620210212,176,7,1,42,0,0,8,234
620210301,132,53,3,3,29,9,19,248
620210302,148,56,44,1,1,29,36,315
620210303,193,16,16,0,1,6,18,250
620210304,146,31,28,1,0,6,0,212
620210305,131,43,7,0,56,7,10,254
620210306,109,42,16,0,60,3,13,243
620210307,116,50,11,0,1,7,18,203
620210308,142,29,39,1,39,7,2,259
620210309,238,34,25,2,8,12,19,338
620210310,152,23,23,1,14,10,9,232
620210311,160,56,7,4,1,3,20,251
620210312,160,31,6,7,0,0,4,208
620210313,217,57,8,2,7,9,2,302
620210401,23,13,1,2,0,7,10,56
620210402,70,12,0,3,0,9,7,101
620210403,25,5,0,1,0,23,7,61
620210501,114,52,2,2,4,18,18,210
620210502,76,27,3,24,0,26,16,172
620210503,15,0,0,3,1,10,6,35
620210601,107,12,5,1,1,0,8,134
620210602,183,33,17,19,1,1,4,258
620210603,147,25,13,3,18,4,2,212
620210604,192,32,8,9,4,17,4,266
620210605,130,24,9,2,0,3,3,171
620210606,175,40,6,6,2,2,1,232
620210607,231,27,24,4,4,8,15,313
620210608,278,20,5,7,3,2,7,322
620210701,232,35,32,16,2,6,17,340
620210702,120,10,0,5,0,9,20,164
620210703,101,9,0,1,0,1,9,121
620210704,116,6,1,3,0,4,16,146
620210705,264,23,11,15,1,7,14,335
620210706,292,28,0,9,0,5,12,346
620210707,409,37,4,18,0,2,12,482
620210708,68,16,3,13,0,6,16,122
620210709,289,30,13,25,1,10,11,379
620210710,128,13,4,17,0,2,9,173
620210801,187,24,8,4,7,0,7,237
620210802,161,38,7,0,3,3,5,217
620210803,234,17,9,4,1,0,10,275
620210804,156,18,4,6,0,1,6,191
620210805,236,16,4,1,1,0,5,263
620210806,216,14,3,4,1,1,1,240
620210807,213,19,6,0,0,0,10,248
620210808,240,32,6,2,1,0,6,287
620210809,340,26,4,6,1,0,12,389
620210810,330,23,3,5,0,0,4,365
620210901,206,50,8,6,11,1,22,304
620210902,312,45,17,4,10,7,8,403
620210903,266,28,2,3,1,0,5,305
620210904,375,19,2,2,3,1,13,415
620210905,325,50,14,5,0,0,10,404
620210906,170,42,10,5,8,1,4,240
620210907,220,22,7,8,0,7,6,270
620210908,386,35,7,5,4,1,5,443
620210909,191,17,1,2,0,0,3,214
620211001,292,18,7,4,1,1,2,325
620211002,299,26,6,3,1,0,4,339
620211003,248,29,0,3,3,0,10,293
620211004,183,7,4,5,0,0,5,204
620211005,332,26,4,8,0,2,11,383
620211006,213,5,1,1,0,0,2,222
620211007,185,16,5,6,0,0,1,213
620211008,208,15,1,1,0,0,0,225
620211009,181,10,0,0,0,0,1,192
620211010,173,4,0,0,0,0,0,177
620211011,151,7,0,0,0,0,3,161
620211101,161,2,7,1,2,7,2,182
620211102,210,22,20,3,0,8,10,273
620211103,271,31,21,2,0,1,7,333
620211104,190,24,9,4,4,10,14,255
620211105,218,2,2,1,0,5,11,239
620211106,234,15,27,3,1,16,11,307
620211107,186,21,6,5,1,0,9,228
620211108,173,14,4,23,0,1,12,227
620211109,145,12,4,11,0,1,9,182
620211110,180,24,6,8,2,2,10,232
620211111,256,0,4,15,0,1,9,285
620211112,308,21,8,13,3,2,10,365
620211113,223,31,12,11,0,4,3,284
620211114,157,23,9,16,0,4,12,221
620211201,196,1,9,5,0,5,9,225
620211202,184,6,5,4,1,2,6,208
620211203,162,27,0,9,2,1,7,208
620211204,121,26,15,5,0,0,5,172
620211205,142,12,3,21,1,6,8,193
620211206,213,2,2,35,0,8,4,264
620211207,198,41,11,26,1,6,11,294
620211208,312,6,7,19,3,12,20,379
620211209,37,16,5,0,0,47,53,158
620211301,185,20,11,5,0,9,17,247
620211302,266,23,5,5,0,4,7,310
620211303,215,51,4,5,1,8,11,295
620211304,152,16,2,2,0,1,6,179
620211305,128,20,8,5,3,11,5,180
620211306,208,29,4,3,0,4,8,256
620211307,208,43,3,6,1,10,6,277
620211308,206,29,9,7,0,4,6,261
620211309,118,20,0,0,0,3,8,149
620211310,192,26,4,6,0,1,8,237
620211311,242,27,5,7,1,10,7,299
620211401,202,14,4,10,0,0,6,236
620211402,335,24,0,11,0,0,16,386
620211403,339,43,2,5,0,0,10,399
620211404,332,25,1,23,0,1,1,383
620211405,353,15,0,8,1,0,6,383
620211406,203,29,0,4,0,0,15,251
620211407,198,25,0,24,0,0,7,254
620211408,244,20,2,2,0,0,6,274
620211409,370,15,1,3,0,0,4,393
620211410,340,16,4,10,0,0,3,373
620211411,294,16,5,9,0,0,6,330
620211412,242,30,6,0,0,1,3,282
620211413,192,16,7,10,0,1,1,227
620211414,224,5,7,16,1,1,3,257
620211415,254,14,13,39,2,5,7,334
620211416,287,27,8,21,0,7,16,366
620211417,214,27,3,11,1,7,10,273
620211418,47,8,0,38,0,3,5,101
620211501,147,25,35,0,40,6,5,258
620211502,133,31,18,3,19,0,9,213
620211503,280,36,17,2,9,5,12,361
620211504,149,6,13,0,23,5,25,221
620211505,158,6,9,2,1,0,4,180
620211506,269,27,6,4,3,0,10,319
620211507,160,31,0,0,1,0,11,203
620211508,146,32,1,0,1,1,3,184
620211509,144,46,4,2,8,2,5,211
620211510,148,29,12,2,8,5,10,214
620211511,185,47,9,3,9,4,7,264
620211512,204,32,11,2,12,0,5,266
620211601,314,29,8,5,0,0,5,361
620211602,262,7,8,2,1,0,4,284
620211603,326,18,3,1,1,1,2,352
620211604,253,2,0,0,0,0,13,268
620211605,171,6,1,0,0,0,1,179
620211606,252,10,2,1,0,0,4,269
620211607,314,42,3,3,0,0,7,369
620211608,293,31,0,1,0,0,1,326
620211609,245,18,0,0,0,0,3,266
620211701,240,16,4,5,0,0,2,267
620211702,209,5,1,3,0,1,5,224
620211703,146,11,0,2,0,0,2,161
620211704,198,22,0,14,0,0,4,238
620211705,231,11,2,3,0,0,6,253
620211706,230,6,1,3,0,0,6,246
620211707,229,8,0,0,1,0,4,242
620211708,310,20,0,3,0,1,5,339
620211709,206,11,0,3,0,0,3,223
620211710,245,20,0,3,0,0,5,273
620211801,238,26,6,5,8,6,6,295
620211802,246,25,3,1,1,0,13,289
620211803,215,18,2,2,0,0,0,237
620211804,179,18,2,2,0,0,4,205
620211805,179,34,4,3,8,4,9,241
620211806,203,11,0,1,1,0,3,219
620211807,188,20,1,4,0,0,12,225
620211808,74,13,0,0,0,0,0,87
620211809,247,16,0,3,0,0,1,267
620211901,174,11,0,0,0,0,4,189
620211902,228,30,4,11,1,3,12,289
620211903,260,47,8,7,6,7,22,357
620211904,242,21,6,5,1,1,5,281
620211905,192,26,16,6,2,21,15,278
620211906,149,10,1,5,0,13,6,184
620211907,116,29,3,2,0,20,4,174
620211908,290,31,0,9,0,0,13,343
620211909,171,10,5,9,0,2,7,204
620211910,184,9,0,8,0,0,5,206
620211911,258,24,11,3,0,1,12,309
620211912,218,32,1,11,0,2,4,268
620280101,9,23,0,1,0,0,0,33
620280102,31,40,0,1,0,10,6,88
620280103,61,31,0,0,0,1,6,99
620280104,213,27,0,5,1,16,24,286
620280105,124,39,0,3,1,2,8,177
620280201,25,2,0,0,0,7,16,50
620280301,23,35,0,0,0,0,0,58
620280401,326,31,4,6,0,0,10,377
620280402,317,40,9,1,1,1,8,377
620280403,195,26,3,1,0,0,2,227
620280404,245,14,1,1,0,0,4,265
620280405,176,14,0,3,0,0,5,198
620280406,294,26,2,4,1,4,9,340
620280407,140,20,0,20,0,0,3,183
620350101,148,11,2,2,4,1,2,170
620350102,177,64,7,6,3,8,26,291
620350103,81,48,2,0,1,2,3,137
620350104,83,7,0,0,0,2,16,108
620350105,48,18,2,1,0,7,18,94
620350106,87,11,0,1,0,31,12,142
620350107,69,58,0,0,0,0,0,127
620350108,26,16,0,0,0,0,2,44
620350109,38,13,1,0,0,2,2,56
620350110,182,9,1,11,1,0,7,211
620350111,216,49,3,1,0,5,23,297
620350112,165,48,6,35,3,30,22,309
620350113,225,83,0,25,2,6,33,374
620350114,204,28,0,38,5,19,32,326
620420101,24,10,0,0,0,1,11,46
620420102,55,11,1,4,0,2,5,78
620420103,124,18,0,4,0,1,15,162
620420104,31,9,0,0,0,0,3,43
620420201,65,13,4,2,0,346,31,461
620420202,167,14,0,5,0,13,4,203
620420301,19,3,0,0,0,0,10,32
620420401,340,13,2,13,0,0,4,372
620420402,254,25,9,7,0,2,5,302
620420403,167,7,2,4,0,0,4,184
620420404,220,18,5,18,0,0,1,262
620420405,292,32,2,11,0,1,5,343
620420406,207,5,0,0,0,2,5,219
620420407,79,14,0,3,1,5,19,121
620420408,165,39,1,4,0,0,5,214
620420409,121,13,3,2,0,4,17,160
620420410,247,15,9,7,1,1,4,284
620420411,171,30,0,3,0,0,11,215
620420412,227,16,0,3,0,0,6,252
620420501,136,12,3,8,0,2,14,175
620420502,139,12,0,5,3,10,17,186
620420503,45,8,1,0,0,2,9,65
620420504,173,5,0,0,0,0,6,184
620420505,180,11,3,17,0,0,2,213
620420506,214,16,0,7,0,0,4,241
620420601,249,18,2,4,0,1,3,277
620420602,316,23,6,9,0,3,15,372
620420603,159,12,0,3,0,0,1,175
620420604,198,16,1,3,1,1,3,223
620420605,202,7,0,2,1,1,3,216
620420606,176,14,0,4,1,0,6,201
620420607,278,11,10,3,0,0,4,306
620420608,182,17,4,1,3,0,6,213
620420609,244,39,2,0,3,1,8,297
620420610,210,22,0,11,0,1,4,248
620420611,209,19,2,2,0,0,15,247
620420612,163,29,6,2,16,0,6,222
620420613,171,15,4,1,0,0,5,196
620420614,171,13,3,3,0,0,3,193
620420615,260,10,1,2,0,0,2,275
620420701,385,57,0,19,0,0,9,470
620420702,436,8,0,6,1,0,17,468
620420703,156,2,4,4,0,10,11,187
620420704,201,4,1,6,0,2,18,232
620420705,377,15,1,42,3,4,12,454
620420706,115,10,1,5,1,0,7,139
620420707,212,35,2,35,1,14,15,314
620420708,175,27,0,5,1,6,6,220
620420709,190,23,0,4,2,15,23,257
620420710,201,13,0,1,0,0,11,226
620420711,186,18,8,37,0,1,2,252
620420712,132,26,1,30,0,1,3,193
620420713,351,57,0,18,0,0,6,432
620420714,349,19,1,13,0,0,7,389
620420715,193,24,2,0,0,0,2,221
620420716,204,11,0,1,0,1,4,221
620420717,140,23,0,1,0,0,10,174
620420801,285,25,11,14,0,0,82,417
620420802,276,23,13,7,3,0,8,330
620420803,191,5,3,2,1,1,1,204
620420804,184,9,0,2,3,2,2,202
620420805,160,26,4,3,1,0,5,199
620420806,209,30,13,4,1,0,4,261
620420807,257,41,16,7,1,0,10,332
620420808,255,45,21,2,11,0,4,338
620420809,192,33,8,0,0,0,3,236
620420810,242,53,22,2,13,4,10,346
620420901,194,3,2,1,0,0,3,203
620420902,344,43,5,29,3,10,12,446
620420903,253,15,0,0,0,3,19,290
620420904,197,14,7,15,0,0,3,236
620420905,239,17,2,2,0,0,3,263
620420906,321,13,2,8,1,0,8,353
620420907,275,12,0,9,0,0,4,300
620420908,209,16,2,17,0,3,3,250
620420909,204,10,1,3,0,0,1,219
620420910,230,14,2,2,8,0,12,268
620421001,303,12,0,20,0,0,10,345
620421002,235,9,1,1,0,0,8,254
620421003,195,5,1,1,0,0,8,210
620421004,158,13,0,1,0,0,3,175
620421005,203,6,4,1,0,0,7,221
620421006,236,7,7,4,0,0,5,259
620421007,197,8,0,7,0,0,5,217
620421008,225,15,3,5,0,0,6,254
620421009,286,20,1,0,1,0,10,318
620421010,247,16,2,5,3,0,6,279
620421011,228,24,3,6,2,0,11,274
620421012,191,20,6,2,7,2,3,231
620421013,186,20,12,5,4,1,7,235
620421101,201,19,4,0,0,1,49,274
620421102,222,19,2,2,2,3,10,260
620421103,162,10,0,0,0,12,25,209
620421104,208,54,0,1,0,4,10,277
620421105,224,11,0,0,1,0,13,249
620421106,224,16,0,3,2,0,8,253
620421107,225,6,0,8,0,0,16,255
620421108,150,8,0,3,3,7,18,189
620421109,221,15,1,1,0,0,5,243
620421110,295,18,0,7,0,0,8,328
620421111,129,10,0,23,0,0,4,166
620421112,123,16,0,1,0,0,2,142
620421201,278,10,0,3,1,1,6,299
620421202,291,7,3,1,0,0,0,302
620421203,307,20,5,9,3,0,13,357
620421204,229,13,3,6,0,1,10,262
620421205,149,12,7,2,1,0,20,191
620421206,161,14,6,2,1,1,5,190
620421207,327,46,16,4,1,0,5,399
620421208,250,29,4,6,2,0,8,299
620421209,229,30,4,2,2,0,2,269
620421210,201,29,14,2,4,0,10,260
620421211,165,42,2,3,4,0,4,220
620421212,183,11,3,0,3,0,5,205
620421213,200,37,5,1,5,0,7,255
620421214,128,25,6,1,10,0,0,170
620421301,225,7,2,2,0,0,5,241
620421302,324,19,2,7,0,0,19,371
620421303,277,12,2,3,1,0,4,299
620421304,311,16,1,14,0,0,3,345
620421305,303,27,1,20,0,7,17,375
620421306,357,19,2,9,1,5,20,413
620421401,156,2,0,4,0,0,2,164
620421402,18,1,0,0,0,60,2,81
620421403,275,1,0,13,1,10,15,315
620421404,157,5,1,8,0,2,6,179
620421405,279,14,2,12,1,10,115,433
620421406,109,7,0,5,3,5,8,137
620421407,266,3,1,17,0,16,26,329
620421408,228,29,2,4,0,19,14,296
620421409,173,6,2,2,0,16,15,214
620421410,106,13,2,17,0,8,7,153
620421411,207,5,1,4,0,1,5,223
620421412,93,7,0,12,0,1,11,124
620421501,369,18,0,5,1,0,3,396
620421502,217,28,1,3,0,0,11,260
620421503,233,18,0,2,1,0,14,268
620421504,209,28,2,1,0,1,18,259
620421505,184,9,0,0,1,0,6,200
620421506,182,14,0,2,0,0,5,203
620421507,231,19,1,0,0,0,1,252
620421508,116,7,0,3,0,0,1,127
620421601,241,24,0,20,0,0,4,289
620421602,130,7,0,0,0,13,6,156
620421603,199,14,0,3,0,0,1,217
620421604,196,14,1,0,0,1,3,215
620421701,258,14,1,6,0,4,95,378
620421702,191,13,0,0,1,4,17,226
620421801,236,19,2,0,1,0,2,260
620421802,136,9,2,1,1,0,5,154
620421803,313,19,0,0,2,0,7,341
620421804,240,13,0,0,0,0,1,254
620421805,230,6,1,8,0,0,10,255
620421806,201,18,0,6,1,0,5,231
620421807,294,18,1,44,2,0,1,360
620421901,272,13,0,0,0,0,3,288
620421902,176,28,1,22,1,2,15,245
620421903,249,12,0,1,1,0,6,269
620421904,252,8,0,3,0,0,2,265
620421905,85,16,1,0,0,3,14,119
620422001,65,4,0,4,0,0,3,76
620422002,219,28,1,0,1,1,5,255
620422003,146,24,3,0,8,2,7,190
620422004,187,20,18,5,3,0,0,233
620422005,148,23,6,2,4,1,7,191
620422006,226,7,0,2,0,0,3,238
620422007,241,22,3,24,1,0,2,293
620422008,154,13,9,0,0,0,5,181
620422009,150,22,10,4,0,1,2,189
620422010,121,8,2,0,0,0,6,137
620422011,218,30,2,4,7,0,8,269
620422012,223,22,1,3,0,0,6,255
620422013,232,17,0,0,0,0,1,250
620422101,258,17,0,0,0,0,4,279
620422102,146,16,1,3,0,6,1,173
620422103,289,47,0,5,0,0,3,344
620422104,139,31,1,5,0,0,1,177
620422105,211,8,2,4,1,8,153,387
620422106,172,36,3,2,2,0,2,217
620422107,244,17,1,5,1,23,29,320
620422108,115,16,0,1,1,1,15,149
620422109,108,10,0,0,0,0,13,131
620422201,379,27,5,15,4,0,7,437
620422202,66,1,0,3,0,0,1,71
620422203,235,16,0,3,0,6,11,271
620422204,79,13,0,1,0,10,6,109
620422205,318,25,2,12,0,0,7,364
620422206,229,29,0,8,3,6,14,289
620422301,226,19,1,10,0,0,5,261
620422302,202,14,0,5,0,0,8,229
620422303,175,17,1,9,1,0,5,208
620422304,202,14,3,3,2,1,3,228
620422305,377,38,2,0,0,0,9,426
620422306,197,17,1,0,0,0,1,216
620422307,192,19,8,3,0,2,3,227
620422308,162,8,3,0,0,0,10,183
620422309,193,6,5,1,0,2,3,210
620422310,165,17,0,2,0,0,11,195
620422311,298,23,4,6,0,1,3,335
620422401,209,8,0,0,0,0,5,222
620422402,208,20,8,1,0,1,2,240
620422403,206,17,6,0,0,0,2,231
620422404,316,40,0,1,0,0,3,360
620422405,306,15,0,0,0,0,2,323
620422406,172,15,1,4,1,0,4,197
620422407,181,14,0,1,1,1,2,200
620422408,341,34,11,3,10,1,14,414
620422501,312,36,4,0,0,1,2,355
620422502,287,13,3,9,0,0,11,323
620422503,361,18,3,1,0,1,5,389
620422504,160,6,0,2,0,0,8,176
620422505,365,27,4,2,2,0,7,407
620422506,244,15,2,1,1,0,7,270
620422507,289,26,4,2,0,1,6,328
620422508,392,24,2,2,1,1,8,430
620422509,278,10,1,1,0,0,0,290
620422510,324,6,2,3,0,0,4,339
620422601,264,15,3,5,0,0,3,290
620422602,223,8,3,1,0,0,2,237
620422603,289,6,0,1,0,0,6,302
620422604,171,7,0,3,0,0,4,185
620422605,166,3,0,4,1,0,9,183
620422606,206,17,4,3,1,0,8,239
620422607,172,7,0,3,0,0,3,185
620422608,148,6,7,3,4,0,4,172
620422609,270,8,2,6,0,0,1,287
620422610,178,5,1,0,0,0,6,190
620422611,155,25,7,17,2,1,3,210
620422612,228,17,6,4,0,0,4,259
620422613,231,10,1,0,0,0,8,250
620422614,194,17,4,1,2,0,2,220
620422615,144,15,4,4,0,0,16,183
620422701,209,22,3,4,0,0,6,244
620422702,247,20,1,1,0,0,4,273
620422703,185,10,10,1,0,0,4,210
620422704,182,13,8,1,3,0,3,210
620422705,207,22,4,0,1,0,4,238
620422706,187,2,22,0,1,1,7,220
620422707,161,27,7,4,2,0,1,202
620422708,308,23,10,13,1,1,7,363
620422709,211,10,1,0,0,0,7,229
620422710,227,13,0,0,1,0,3,244
620422711,145,5,1,0,0,0,1,152
620422712,190,8,1,1,0,0,2,202
620422713,304,37,6,9,4,1,12,373
620422714,202,11,9,3,0,0,3,228
620422715,154,4,7,1,2,0,4,172
620422801,309,9,4,9,0,0,2,333
620422802,181,9,11,6,0,2,2,211
620422803,363,28,4,2,0,0,5,402
620422804,313,16,5,0,0,0,7,341
620422805,318,13,4,8,1,0,7,351
620422806,339,12,3,42,0,0,4,400
620422807,190,5,0,0,0,0,2,197
620422808,189,10,2,0,0,0,3,204
620422901,231,31,4,9,2,0,7,284
620422902,166,12,6,19,1,0,2,206
620422903,301,27,3,0,1,0,2,334
620422904,296,35,4,6,6,1,7,355
620422905,230,19,1,2,1,0,3,256
620422906,265,32,5,12,0,0,9,323
620422907,269,39,11,2,6,0,3,330
620422908,295,26,2,3,0,0,6,332
620422909,286,26,1,9,0,2,9,333
620422910,274,14,7,3,1,0,7,306
620423001,277,20,3,4,1,0,12,317
620423002,381,32,3,2,0,1,2,421
620423003,227,28,9,1,6,1,9,281
620423004,240,9,2,4,0,0,7,262
620423005,194,11,0,2,2,1,4,214
620423006,35,2,1,0,0,0,0,38
620423007,347,11,2,8,2,0,5,375
620423008,340,7,2,18,0,0,9,376
620423009,312,20,1,1,0,0,8,342
620423010,216,11,2,8,0,0,3,240
620423011,286,13,2,3,0,0,4,308
620423012,105,4,1,1,0,0,4,115
620423101,319,13,0,1,0,0,3,336
620423102,339,10,2,1,1,1,1,355
620423103,240,10,0,0,0,0,2,252
620423104,292,12,0,1,0,0,2,307
620423105,338,11,0,0,1,0,13,363
620423106,262,13,0,0,1,0,1,277
620423107,249,13,0,3,0,0,4,269
620423108,240,9,2,2,0,0,5,258
620423109,243,5,2,1,0,0,9,260
620423201,262,27,8,0,0,0,4,301
620423202,220,10,3,0,3,0,2,238
620423203,194,8,1,0,0,0,0,203
620423204,380,32,5,0,0,0,15,432
620423205,171,2,0,0,0,1,9,183
620423206,204,9,4,0,1,0,4,222
620423207,197,13,1,4,0,1,1,217
620423208,196,14,3,13,1,1,6,234
620423209,229,19,2,2,1,0,3,256
620423210,219,16,3,2,1,0,3,244
620423211,233,19,8,1,3,0,4,268
620423212,179,11,3,4,0,0,3,200
620423301,180,8,5,2,0,0,1,196
620423302,198,12,0,1,0,0,2,213
620423303,357,16,3,11,0,0,11,398
620423304,276,26,5,1,2,0,2,312
620423305,227,16,7,1,1,0,3,255
620423306,188,35,2,1,1,0,9,236
620423307,145,27,5,1,1,0,5,184
620423308,158,20,2,4,1,0,4,189
620423309,216,23,8,5,2,0,10,264
620423310,226,30,3,5,1,0,5,270
620423311,315,60,18,7,2,0,5,407
620423401,227,19,0,8,0,0,1,255
620423402,373,17,0,7,0,0,8,405
620423403,213,7,0,0,0,0,5,225
620423404,174,14,0,21,0,0,6,215
620423405,290,23,5,9,2,0,5,334
620423406,165,11,2,13,0,0,6,197
620423407,155,10,3,18,2,0,8,196
620423408,160,13,12,40,0,0,2,227
620423409,184,11,3,35,0,1,1,235
620423410,332,22,5,0,0,0,11,370
620423501,218,36,10,6,2,1,5,278
620423502,244,29,5,0,9,0,10,297
620423503,274,44,19,3,9,1,12,362
620423504,212,42,3,2,8,0,3,270
620423505,241,50,7,3,12,0,17,330
620423506,253,55,53,1,30,0,5,397
620423507,277,25,2,3,5,2,7,321
620423508,198,25,2,6,3,2,5,241
620423509,288,22,11,2,1,3,8,335
620423601,256,14,1,1,1,0,12,285
620423602,234,22,9,2,2,1,4,274
620423603,269,37,14,2,1,1,6,330
620423604,230,13,1,7,0,0,12,263
620423605,193,31,7,4,1,0,5,241
620423606,188,16,1,4,9,0,5,223
620423607,265,19,5,2,9,0,12,312
620423608,230,18,6,3,1,0,3,261
620423609,231,26,0,0,0,0,2,259
620423610,154,9,1,0,0,0,2,166
620423611,226,16,2,3,0,0,5,252
620423612,223,13,2,6,0,0,8,252
620423701,213,30,5,2,0,0,3,253
620423702,193,11,2,3,1,0,5,215
620423703,258,27,1,8,0,0,14,308
620423704,229,10,1,3,1,0,8,252
620423705,273,12,0,2,0,0,4,291
620423706,328,11,2,11,0,0,5,357
620423707,304,15,2,6,0,1,15,343
620423708,108,30,0,11,0,0,3,152
620423709,306,24,0,0,0,0,4,334
620423710,322,16,1,0,0,1,6,346
620423711,192,21,0,205,0,0,11,429
620423801,273,11,1,2,0,0,5,292
620423802,308,14,10,2,0,0,7,341
620423803,189,3,0,0,0,0,4,196
620423804,173,11,2,3,3,2,6,200
620423805,242,18,11,1,0,0,8,280
620423806,208,33,22,1,0,0,10,274
620423807,144,5,0,1,0,0,2,152
620423808,216,34,10,0,3,0,2,265
620423809,202,18,2,0,0,0,1,223
620423810,205,10,2,0,0,0,10,227
620423811,302,15,3,2,0,0,5,327
620423812,164,13,3,0,0,0,4,184
620423813,149,3,1,0,0,0,13,166
620423814,264,13,0,0,0,0,6,283
620423901,266,34,28,9,30,2,8,377
620423902,157,21,3,0,2,0,13,196
620423903,168,36,7,2,12,0,3,228
620423904,205,40,3,2,4,3,12,269
620423905,267,15,1,3,0,0,2,288
620423906,276,3,27,18,1,0,38,363
620423907,307,43,17,5,1,1,6,380
620423908,206,29,4,2,3,1,7,252
620423909,183,34,8,2,5,0,0,232
620423910,194,44,11,0,8,0,10,267
620423911,237,44,4,0,16,0,32,333
620423912,217,39,10,2,15,2,20,305
620424001,222,37,4,4,0,2,15,284
620424002,222,47,2,27,1,5,6,310
620424003,347,13,5,0,0,0,2,367
620424004,298,25,1,7,0,0,3,334
620424005,178,19,1,11,0,1,5,215
620424006,178,6,0,17,1,0,9,211
620424007,212,14,2,0,0,0,1,229
620424008,165,11,1,10,1,0,1,189
620424009,302,21,5,9,0,1,8,346
620424010,142,8,5,4,0,1,6,166
620424011,245,23,1,1,0,0,1,271
620424012,195,14,2,12,0,0,6,229
620424013,128,15,1,34,0,2,0,180
620424014,325,22,3,8,4,2,3,367
620424101,232,22,19,0,3,0,8,284
620424102,209,26,19,1,7,7,2,271
620424103,199,21,9,2,10,1,7,249
620424104,123,17,3,6,0,3,6,158
620424105,220,25,6,0,2,2,6,261
620424106,205,15,3,0,0,1,9,233
620424107,150,29,3,2,10,1,10,205
620424108,264,26,10,0,3,1,13,317
620424109,178,33,1,0,3,0,9,224
620424110,154,20,2,0,1,0,5,182
620424111,220,30,4,7,3,0,0,264
620424112,244,9,6,10,1,1,4,275
620424113,189,9,10,1,4,0,4,217
620424114,177,34,0,1,2,0,8,222
620424201,279,6,4,10,0,1,4,304
620424202,302,11,7,1,2,1,4,328
620424203,244,35,10,6,2,0,3,300
620424204,266,22,8,5,1,0,16,318
620424205,140,20,1,3,0,0,1,165
620424206,308,23,1,3,1,0,2,338
620424207,354,38,7,1,4,0,3,407
620424208,310,34,0,0,2,0,3,349
620424209,272,8,4,8,2,0,1,295
620424210,242,18,4,3,3,0,5,275
620424301,215,26,2,4,0,1,4,252
620424302,123,11,2,9,0,1,2,148
620424303,188,21,1,7,1,0,8,226
620424304,192,10,1,6,1,0,4,214
620424305,246,17,1,0,1,0,2,267
620424306,346,24,1,2,0,0,5,378
620424307,279,10,3,8,0,0,2,302
620424308,244,7,0,0,0,0,1,252
620424309,304,17,1,4,0,0,8,334
620424310,224,11,0,13,0,0,4,252
620424311,309,11,0,1,0,0,6,327
620424312,282,8,1,0,0,0,4,295
620490101,227,22,2,13,2,6,24,296
620490102,213,44,4,2,2,2,19,286
620490103,34,0,0,2,4,3,40,83
620490104,112,75,0,1,6,9,10,213
620490105,102,9,0,0,0,1,11,123
620490106,212,37,0,20,0,1,12,282
620490107,79,45,0,2,1,0,7,134
620560101,146,9,0,6,8,1,21,191
620560102,96,32,0,0,0,0,1,129
620560103,109,126,0,1,0,3,12,251
620560104,104,56,1,1,1,8,5,176
620630101,202,18,1,10,0,0,8,239
620630102,183,24,4,2,3,0,2,218
620630103,220,22,7,4,10,2,4,269
620630104,238,31,6,5,11,1,17,309
620630105,213,13,5,3,0,0,6,240
620630106,321,33,5,9,1,3,12,384
620630107,79,6,0,0,0,0,1,86
620630108,213,4,0,1,0,0,2,220
620630109,287,41,13,6,4,0,3,354
620630110,170,15,4,2,4,1,10,206
620630111,184,36,0,2,0,0,1,223
620630112,223,22,0,3,0,1,0,249
620630113,314,16,3,0,0,0,6,339
620630114,135,4,0,0,0,0,1,140
620630115,188,26,1,3,0,0,1,219
620630116,147,32,1,1,3,2,13,199
620630117,203,26,1,1,1,0,3,235
620630118,144,13,0,2,0,0,2,161
620630201,302,13,3,4,0,4,9,335
620630202,108,7,1,3,0,14,36,169
620630203,68,9,0,0,0,10,12,99
620630204,127,20,1,4,1,4,60,217
620630205,189,11,1,62,0,24,21,308
620630301,18,28,0,0,0,0,1,47
620630302,66,89,0,0,0,0,9,164
620630401,45,67,0,0,0,22,11,145
620700101,231,25,1,7,1,6,8,279
620700102,219,36,2,25,0,3,12,297
620700103,172,27,2,10,0,1,7,219
620700104,206,51,0,0,3,16,31,307
620700105,42,11,0,1,0,0,7,61
620700106,145,42,0,0,0,0,7,194
620700107,126,34,0,0,0,7,27,194
620700201,231,34,2,13,2,19,7,308
620700202,189,12,1,27,0,16,8,253
620700203,295,33,5,17,0,4,9,363
620700204,176,22,5,16,1,4,4,228
620700205,210,24,7,16,0,4,7,268
620770101,206,19,3,9,0,2,9,248
620770102,154,13,3,4,9,0,3,186
620770103,153,7,1,0,1,1,5,168
620770104,218,31,11,2,9,2,12,285
620770105,118,20,5,1,16,2,7,169
620770106,195,20,6,3,2,0,9,235
620770107,247,26,8,3,1,4,9,298
620770108,173,12,3,3,1,0,9,201
620770109,258,15,1,11,1,1,13,300
620770110,225,34,1,2,1,0,16,279
620770111,295,17,3,7,1,0,5,328
620770112,271,26,4,5,0,1,11,318
620770113,167,12,2,7,0,0,8,196
620770114,148,18,4,4,2,2,14,192
620770115,138,17,4,2,3,0,11,175
620770116,178,17,3,4,1,3,11,217
620770117,173,9,1,3,0,0,3,189
620770201,321,46,2,3,9,1,3,385
620770202,163,27,0,2,0,1,5,198
620770203,182,20,5,1,0,1,13,222
620770204,112,21,2,0,0,0,6,141
620770205,226,23,4,3,1,1,14,272
620770206,163,19,1,1,0,1,9,194
620770207,122,30,0,0,3,1,102,258
620770208,213,22,0,1,1,0,5,242
620770209,193,26,1,4,0,0,13,237
620770210,267,12,3,3,2,4,17,308
620770211,250,30,0,0,0,1,12,293
620770301,68,55,72,3,0,90,13,301
620770302,59,34,42,2,0,75,25,237
620770303,60,86,85,1,2,35,32,301
620770304,71,46,25,9,3,153,13,320
620770305,137,36,116,14,5,36,13,357
620770306,58,25,21,3,7,137,31,282
620770307,146,29,16,0,1,71,39,302
620770401,117,17,7,5,2,36,14,198
620770402,113,41,0,10,1,25,69,259
620770403,326,38,11,14,2,3,5,399
620770404,305,14,0,12,4,1,16,352
620770405,279,19,1,11,1,0,9,320
620770406,313,21,0,23,2,0,3,362
620770407,38,7,68,7,0,290,14,424
620770408,12,2,0,0,0,0,0,14
620770409,164,23,14,12,0,21,22,256
620770410,84,25,33,4,0,138,21,305
620770411,115,27,73,19,0,92,42,368
620770412,107,47,35,8,0,39,21,257
620770413,139,13,0,0,0,0,2,154
620770501,31,5,0,0,0,15,0,51
620770502,14,166,22,20,0,0,8,230
620770503,33,15,42,53,0,121,3,267
620770504,33,54,21,32,2,110,39,291
620770601,59,36,75,2,1,112,16,301
620770602,29,1,11,1,1,238,2,283
620770603,63,75,61,4,0,23,23,249
620770604,88,43,14,5,2,47,51,250
620770605,111,22,59,35,2,35,53,317
620770606,52,6,50,31,0,169,17,325
620770607,84,29,32,33,0,100,2,280
620840101,156,19,0,1,3,0,6,185
620840102,152,26,2,2,2,1,10,195
620840103,121,16,1,9,2,2,3,154
620840104,241,27,3,2,1,0,23,297
620840105,163,23,1,3,1,5,7,203
620840106,130,26,0,4,1,0,18,179
620840107,174,34,0,3,1,1,7,220
620840201,9,11,0,0,0,0,1,21
620840202,43,2,0,0,0,1,0,46
620840203,22,5,0,0,0,0,6,33
620840204,53,6,0,0,3,10,15,87
620840205,14,26,0,0,1,0,0,41
620840206,34,17,0,0,0,0,0,51
620840207,39,35,0,0,0,0,1,75
620840208,142,56,0,0,0,0,15,213
620840209,62,2,0,0,0,0,67,131
620849999,418,0,0,0,0,0,0,418
620910101,390,18,0,2,3,3,8,424
620910102,239,2,0,0,1,0,2,244
620910103,381,13,0,0,0,1,2,397
620910104,173,2,0,0,0,0,0,175
620910201,202,49,1,9,0,0,7,268
620910202,296,54,9,20,5,1,31,416
620910203,185,20,0,7,5,4,10,231
620910301,215,31,2,1,0,5,8,262
620910302,150,23,4,4,1,3,13,198
620910303,266,57,5,1,2,2,14,347
620910304,252,34,4,22,1,7,7,327
620910305,347,43,3,12,0,0,19,424
620910306,198,24,2,0,1,0,5,230
620910307,214,20,2,1,0,0,16,253
620910308,279,31,0,7,1,6,7,331
620910401,22,6,3,1,0,2,12,46
620910402,51,36,0,0,0,0,8,95
620910403,30,0,0,1,2,6,15,54
620910404,273,2,0,0,0,0,0,275
620910405,151,81,1,0,0,12,14,259
620910406,114,19,0,1,1,0,13,148
620910407,83,13,0,0,0,2,6,104
660070101,139,57,0,0,0,1,8,205
660070102,19,0,0,0,0,0,5,24
660070103,76,6,0,0,0,2,2,86
660070104,39,7,0,0,0,0,0,46
660070105,85,2,0,0,0,3,3,93
660070106,186,16,0,4,0,0,21,227
660070107,198,22,0,12,1,0,14,247
660070108,227,27,1,4,0,0,4,263
660070201,88,18,0,2,0,3,13,124
660070202,48,7,0,1,2,2,8,68
660070203,11,1,0,0,0,0,0,12
660070204,84,18,0,0,0,2,7,111
660070205,187,10,0,0,0,0,9,206
660070206,15,0,0,0,0,1,7,23
660070207,237,28,1,0,1,2,6,275
660070208,208,16,2,5,0,4,5,240
660070209,172,6,0,10,1,2,11,202
660070210,169,23,0,1,0,0,1,194
660070211,245,18,0,2,0,0,3,268
660070212,245,12,1,4,8,3,9,282
660070213,179,20,2,2,0,0,5,208
660070214,164,18,0,5,2,0,7,196
660070301,5,1,0,0,0,0,0,6
660070302,22,8,0,1,0,2,0,33
660070303,156,17,2,2,4,1,4,186
660070304,37,4,0,1,0,0,10,52
660070305,28,0,0,2,1,18,20,69
660070306,11,4,0,0,0,0,0,15
660070307,13,4,0,0,0,1,1,19
660070308,20,1,0,0,0,1,4,26
660070309,13,8,0,0,0,0,0,21
660070310,3,2,0,0,0,0,0,5
660070311,20,5,0,0,0,0,1,26
660070312,6,3,0,0,0,0,2,11
660070313,24,5,0,0,0,0,0,29
660070314,14,0,0,0,0,0,0,14
660070315,182,22,0,6,0,2,3,215
660070316,258,16,0,1,2,0,3,280
660070317,246,14,3,1,1,0,4,269
660070318,322,21,4,2,3,1,6,359
660070319,240,15,2,5,8,1,13,284
660070320,219,16,2,2,0,0,0,239
660070321,303,15,1,4,1,1,12,337
660070322,191,8,0,1,3,0,7,210
660070401,26,1,0,0,0,0,3,30
660070402,25,8,0,0,0,5,0,38
660070403,22,12,0,0,0,0,0,34
660070404,15,0,0,0,0,0,4,19
660070405,84,18,1,1,0,2,1,107
660070406,22,5,0,1,1,7,3,39
660070407,65,14,2,1,0,1,5,88
660070408,262,25,1,4,0,0,16,308
660070409,46,10,0,0,1,4,2,63
660070410,46,3,0,0,0,0,2,51
660070411,17,0,0,0,0,0,5,22
660070412,33,7,2,1,0,0,0,43
660070413,39,7,0,1,0,1,2,50
660070414,95,6,2,0,0,1,3,107
660070415,159,28,0,0,2,2,2,193
660070416,378,30,9,9,5,1,7,439
660070417,288,19,1,3,0,0,11,322
660070418,291,24,8,7,1,0,8,339
660070419,234,17,2,1,0,0,5,259
660070420,275,23,0,22,0,0,4,324
660070421,175,17,0,59,1,0,3,255
660070422,222,19,5,5,8,0,7,266
660070423,241,33,5,3,6,0,11,299
660070424,372,24,3,4,1,0,4,408
660070425,216,24,1,2,2,0,3,248
660070426,182,19,0,1,0,0,3,205
660070427,252,37,0,6,0,0,34,329
660070501,52,1,0,0,0,0,0,53
660070502,5,1,0,0,0,0,2,8
660070503,35,0,0,0,0,0,1,36
660070504,29,6,0,0,0,1,0,36
660070505,53,4,0,0,0,0,0,57
660070506,43,0,0,0,0,0,0,43
660070507,10,6,0,0,0,2,1,19
660070508,64,0,0,0,0,0,0,64
660070509,21,0,0,0,0,0,4,25
660070510,179,32,0,0,1,0,13,225
660070601,369,59,1,2,1,2,17,451
660070602,12,5,0,0,0,0,0,17
660070603,20,3,0,0,0,0,0,23
660070604,20,4,0,0,0,0,0,24
660070605,19,8,0,0,0,1,2,30
660070606,46,7,0,0,0,0,1,54
660070607,59,18,0,0,0,0,0,77
660070608,37,7,0,0,0,2,0,46
660070609,49,12,0,0,0,0,3,64
660070610,30,0,0,0,0,0,3,33
660070611,85,3,0,1,0,0,8,97
660070612,49,2,0,0,0,0,3,54
660070613,9,9,0,0,0,0,0,18
660070614,303,41,0,1,6,0,5,356
660070615,178,15,1,7,2,0,2,205
660070616,170,17,0,1,0,2,3,193
660070617,239,26,0,0,0,1,13,279
660070618,184,22,4,3,1,1,6,221
660070619,217,70,6,7,1,2,5,308
660070620,194,28,1,0,0,0,3,226
660070621,273,16,5,1,1,2,17,315
660140101,122,34,2,11,0,5,12,186
660140102,37,1,0,0,0,0,12,50
660140103,102,17,0,0,0,11,11,141
660140104,117,35,1,1,1,7,6,168
660140201,3,2,0,0,0,0,2,7
660140202,598,84,1,52,3,22,74,834
660140203,204,34,0,2,0,5,40,285
660140204,77,7,0,0,0,30,30,144
660140205,10,0,0,1,1,1,2,15
660140206,276,40,6,16,3,18,18,377
660140207,158,29,1,1,10,4,12,215
660210101,73,11,0,4,0,2,9,99
660210102,28,0,0,5,3,5,18,59
660210103,184,8,3,16,2,8,12,233
660210104,253,23,1,9,0,4,9,299
660210105,17,1,0,0,0,5,5,28
660210106,47,17,0,1,0,5,8,78
660210107,211,25,0,32,0,2,9,279
660210108,214,11,0,2,1,5,5,238
660210109,231,5,0,1,1,1,3,242
660210110,227,19,0,7,0,3,0,256
660210111,201,18,4,5,9,5,5,247
660210112,217,26,2,3,2,8,1,259
660210113,214,33,4,8,3,12,1,275
660210114,274,21,3,11,28,16,17,370
660210115,225,14,3,1,3,10,11,267
660210116,255,21,1,5,0,3,6,291
660210201,5,2,0,0,0,0,1,8
660210202,16,8,0,0,0,0,1,25
660280101,79,2,18,3,0,15,11,128
660280102,62,0,1,1,0,1,3,68
660280103,33,0,0,0,0,2,3,38
660280104,295,0,0,15,1,4,9,324
660280105,347,2,0,33,0,0,32,414
660280106,263,2,0,170,0,0,33,468
660280107,193,7,1,8,0,9,12,230
660280108,146,14,2,5,4,24,5,200
660280109,214,12,0,6,0,2,14,248
660280110,242,29,0,8,1,13,10,303
660280111,198,24,1,9,1,12,3,248
660280112,288,66,6,13,4,44,20,441
660280113,188,15,6,10,0,22,9,250
660280114,244,21,7,21,0,8,19,320
660280115,184,10,2,36,0,6,1,239
660280116,114,3,0,0,0,0,3,120
660280117,348,26,0,8,0,0,8,390
660280118,331,25,0,32,1,1,8,398
660280119,327,28,0,17,0,0,2,374
660280120,156,6,0,10,0,17,11,200
660280121,116,6,0,0,0,1,1,124
660280201,195,13,2,25,2,7,4,248
660280202,189,0,0,2,0,1,12,204
660280203,22,16,0,1,0,4,11,54
660280204,12,4,0,1,0,3,4,24
660280205,183,33,5,27,0,0,5,253
660280206,264,24,5,36,0,5,6,340
660280207,377,29,1,3,0,3,2,415
660280208,182,22,0,12,0,1,11,228
660280301,7,0,0,0,0,2,0,9
660280302,29,11,0,0,0,2,3,45
660280303,15,7,0,0,0,0,2,24
660280304,25,4,0,1,1,4,3,38
660280401,233,15,1,3,1,1,3,257
660280402,323,12,0,3,5,0,2,345
660280403,276,10,0,6,0,0,1,293
660280404,401,4,1,1,0,0,6,413
660280405,369,8,0,6,1,1,11,396
660280406,377,5,0,3,2,0,8,395
660280407,300,9,0,1,0,0,1,311
660280408,338,10,1,0,1,0,2,352
660280409,262,11,1,0,2,0,6,282
660280410,236,14,0,3,0,0,0,253
660280411,199,16,9,0,1,6,2,233
660280412,294,9,1,1,2,1,8,316
660280413,349,28,1,3,1,1,3,386
660280414,223,16,10,1,0,0,13,263
660280415,208,5,0,0,1,0,6,220
660280416,171,8,15,11,0,0,2,207
660280417,420,6,0,0,2,0,3,431
660280418,235,4,0,0,0,0,0,239
660280419,244,4,0,1,1,1,1,252
660280420,189,2,2,0,0,0,3,196
660280421,219,7,1,3,1,1,2,234
660280422,327,5,3,1,0,2,11,349
660280423,329,15,3,0,0,0,4,351
660280501,356,9,5,0,0,1,13,384
660280502,197,6,6,0,0,1,9,219
660280503,206,7,0,0,0,0,3,216
660280504,205,6,4,13,2,0,3,233
660280505,243,6,1,8,2,0,5,265
660280506,279,12,2,2,0,1,8,304
660280507,314,11,1,1,0,0,4,331
660280508,278,17,2,1,0,1,3,302
660280509,233,2,1,0,0,0,2,238
660280510,342,20,9,0,0,0,5,376
660280511,233,11,2,0,0,0,3,249
660280512,222,9,2,1,0,0,4,238
660280513,237,11,1,4,2,0,2,257
660280514,215,7,3,3,4,0,2,234
660280515,234,0,2,0,3,1,1,241
660280516,360,30,7,1,0,0,3,401
660280517,342,41,11,0,0,1,3,398
660280518,209,23,12,2,0,5,2,253
660280519,174,20,4,1,0,4,4,207
660280520,199,11,1,3,3,0,1,218
660280601,298,21,3,14,2,0,17,355
660280602,278,7,7,4,2,0,6,304
660280603,319,37,12,16,1,1,7,393
660280604,278,8,3,3,2,2,15,311
660280605,308,16,11,14,1,1,6,357
660280606,220,14,1,2,0,1,8,246
660280607,235,17,2,1,4,1,7,267
660280608,257,30,2,2,0,0,3,294
660280609,186,6,2,3,1,5,7,210
660280610,277,20,26,1,4,2,4,334
660280611,366,11,7,5,5,1,11,406
660280612,230,14,0,4,4,4,4,260
660280613,217,6,6,2,0,2,3,236
660280614,216,19,5,5,3,0,9,257
660280615,217,27,8,4,1,3,12,272
660280616,340,13,4,3,5,0,6,371
660280617,218,8,1,4,7,1,6,245
660280618,181,13,2,1,6,0,3,206
660280619,271,7,3,3,2,1,10,297
660280620,215,17,1,2,3,2,2,242
660280621,326,38,8,4,4,0,14,394
660280622,362,19,21,4,16,2,15,439
660280701,288,4,3,3,0,0,2,300
660280702,292,3,6,3,3,2,8,317
660280703,207,6,1,1,0,0,4,219
660280704,212,2,1,2,0,0,1,218
660280705,188,3,1,5,2,0,10,209
660280706,200,2,3,5,4,1,4,219
660280707,282,11,1,3,1,2,9,309
660280708,271,9,4,1,1,0,7,293
660280709,311,14,6,4,3,2,17,357
660280710,271,13,4,2,4,0,5,299
660280711,362,13,4,5,1,0,5,390
660280712,155,7,1,1,1,1,2,168
660280713,254,16,4,4,1,1,9,289
660280714,218,3,1,5,4,4,8,243
660280715,227,5,1,5,1,0,4,243
660280716,234,14,4,2,4,1,10,269
660280717,253,4,5,2,3,1,5,273
660280801,0,0,0,0,0,0,0,0
660280802,182,5,1,3,1,2,2,196
660280803,153,7,1,2,1,0,2,166
660280804,217,12,7,3,8,0,6,253
660280805,221,16,1,5,6,0,18,267
660280806,230,15,11,0,0,1,2,259
660280807,201,28,8,2,6,0,3,248
660280808,203,5,2,2,2,0,1,215
660280809,374,4,0,3,0,0,9,390
660280810,241,10,3,2,7,0,11,274
660280811,194,7,2,2,0,1,3,209
660280812,176,10,2,0,4,0,8,200
660280813,223,15,0,0,2,0,11,251
660280814,182,45,6,0,10,7,6,256
660280815,181,16,0,1,5,3,9,215
660280901,374,34,10,26,2,2,14,462
660280902,395,33,15,19,4,0,15,481
660280903,223,19,16,24,2,1,3,288
660280904,206,6,0,2,1,2,1,218
660280905,368,15,3,3,3,4,5,401
660280906,320,11,2,2,1,2,0,338
660280907,256,20,5,21,4,0,3,309
660280908,272,20,3,10,0,0,2,307
660280909,340,17,16,6,2,1,6,388
660280910,170,14,2,3,3,0,2,194
660280911,180,13,8,2,7,1,3,214
660280912,198,14,8,0,0,0,2,222
660280913,254,13,4,0,2,1,7,281
660280914,278,14,2,2,6,0,4,306
660280915,188,12,2,3,1,3,10,219
660280916,207,5,4,1,6,1,7,231
660281001,223,13,1,1,0,0,3,241
660281002,292,33,9,4,19,0,14,371
660281003,253,10,1,1,2,1,4,272
660281004,235,16,4,3,3,1,12,274
660281005,286,36,10,2,27,10,16,387
660281006,345,24,45,3,11,0,11,439
660281007,232,26,40,4,22,0,11,335
660281008,150,24,5,3,18,5,8,213
660281009,280,49,6,14,42,0,7,398
660281010,280,60,21,3,69,1,26,460
660281011,160,19,3,1,38,0,30,251
660281012,208,2,3,3,3,0,13,232
660281013,195,18,3,4,17,0,12,249
660281101,230,34,22,0,15,0,17,318
660281102,164,11,10,1,26,2,16,230
660281103,317,47,19,3,42,2,44,474
660281104,177,41,26,4,48,4,20,320
660281105,268,55,40,6,75,2,29,475
660281106,221,53,8,4,47,0,9,342
660281107,205,13,7,1,8,1,37,272
660281108,179,27,31,0,94,3,8,342
660281109,184,40,13,2,111,2,61,413
660281110,203,69,17,0,40,6,27,362
660281111,186,55,6,1,43,12,25,328
660281112,195,27,18,6,84,6,40,376
660281113,189,38,38,3,149,0,26,443
660281114,219,37,16,1,51,2,12,338
660281115,127,59,24,3,31,0,10,254
660281116,96,40,21,1,48,1,13,220
660281201,268,23,7,8,3,1,11,321
660281202,203,15,2,1,29,2,8,260
660281203,198,14,6,3,26,1,4,252
660281204,214,43,13,2,3,0,9,284
660281205,154,33,2,2,31,0,6,228
660281206,146,12,4,2,5,0,4,173
660281207,175,33,8,0,0,11,9,236
660281208,151,10,8,2,1,6,5,183
660281209,98,24,9,1,1,0,1,134
660281210,249,2,7,1,1,0,4,264
660281211,299,19,2,2,1,0,6,329
660281212,400,11,5,12,4,4,7,443
660281213,410,29,1,10,6,0,4,460
660281214,239,13,2,7,0,2,7,270
660281215,221,5,0,3,0,1,3,233
660281301,224,51,8,2,19,2,19,325
660281302,123,53,26,1,14,2,6,225
660281303,253,52,10,2,28,4,12,361
660281304,158,23,7,1,13,2,22,226
660281305,327,25,4,2,19,2,20,399
660281306,280,39,9,4,60,0,16,408
660281307,354,43,12,7,29,3,10,458
660281308,181,28,15,0,74,0,8,306
660281309,143,21,13,12,15,1,10,215
660281310,188,21,2,2,6,2,15,236
660281311,138,29,11,2,21,0,12,213
660281401,277,22,9,4,33,1,6,352
660281402,326,40,12,3,24,6,9,420
660281403,289,13,16,3,14,3,9,347
660281404,248,40,11,4,22,2,9,336
660281405,237,35,4,2,33,1,7,319
660281406,296,25,4,8,14,0,11,358
660281407,344,18,6,4,1,1,8,382
660281408,288,27,3,3,3,0,11,335
660281409,277,14,1,1,7,0,7,307
660281410,267,17,1,3,3,1,7,299
660281411,377,21,3,1,1,0,10,413
660281412,314,10,5,2,4,5,5,345
660281413,345,17,2,4,2,6,3,379
660281414,199,9,1,0,6,1,5,221
660281501,219,14,4,8,1,0,6,252
660281502,368,8,1,5,0,0,9,391
660281503,377,6,0,0,0,0,6,389
660281504,313,16,2,3,0,0,1,335
660281505,327,7,0,0,0,1,6,341
660281506,309,4,0,0,0,1,5,319
660281507,280,6,3,6,0,1,5,301
660281508,219,11,0,0,4,0,4,238
660281509,197,5,4,0,6,2,4,218
660281510,215,8,3,5,1,1,8,241
660281511,336,13,0,4,1,1,10,365
660281512,321,11,2,8,1,2,1,346
660281513,246,2,0,0,0,0,9,257
660281514,260,20,8,1,2,7,2,300
660281515,328,12,6,7,1,1,11,366
660281516,279,10,1,0,1,1,15,307
660281517,213,11,1,0,0,0,2,227
660281518,264,8,1,2,0,1,5,281
660281519,183,5,1,1,0,0,3,193
660281520,201,10,1,1,1,0,8,222
660281521,194,2,5,1,1,0,5,208
660281522,274,10,2,3,3,0,5,297
660281523,156,11,3,2,1,5,3,181
660281524,344,18,3,3,3,1,7,379
660281525,271,8,1,5,1,1,8,295
660281601,332,8,0,7,2,0,1,350
660281602,450,18,1,5,2,0,14,490
660281603,187,8,2,1,6,1,1,206
660281604,249,8,3,1,1,3,5,270
660281605,318,17,8,3,4,1,11,362
660281606,280,15,7,5,0,2,8,317
660281607,273,11,6,4,0,4,14,312
660281608,226,11,1,0,0,0,1,239
660281609,277,11,0,1,0,1,3,293
660281610,263,14,1,2,0,1,4,285
660281611,284,14,1,3,0,1,8,311
660281612,239,4,2,4,0,0,1,250
660281613,200,5,3,6,1,0,3,218
660281614,303,7,3,1,3,1,0,318
660281615,222,11,1,2,0,0,6,242
660281616,267,11,0,0,0,0,3,281
660281617,395,7,0,7,0,1,11,421
660281618,397,26,4,0,0,0,9,436
660281619,384,19,0,3,0,0,6,412
660281701,241,40,5,2,4,1,8,301
660281702,193,32,5,2,34,1,12,279
660281703,203,5,10,3,0,2,1,224
660281704,180,10,4,3,4,2,8,211
660281705,230,9,8,1,3,1,6,258
660281706,174,6,1,3,2,0,11,197
660281707,299,22,3,3,6,0,4,337
660281708,304,14,2,4,0,4,15,343
660281709,268,13,7,5,3,0,17,313
660281710,160,9,3,1,1,0,0,174
660281711,160,3,1,0,3,1,0,168
660281712,259,5,0,0,2,0,4,270
660281713,263,7,0,4,1,2,6,283
660281714,319,7,3,0,3,0,10,342
660281715,222,4,2,0,3,1,2,234
660281716,266,15,0,1,0,0,3,285
660281801,292,17,3,1,4,1,34,352
660281802,349,14,6,1,5,3,10,388
660281803,208,12,3,1,3,1,7,235
660281804,181,8,5,2,2,0,3,201
660281805,212,6,1,2,1,2,11,235
660281806,237,10,3,2,4,3,6,265
660281807,180,18,5,3,2,0,6,214
660281808,194,17,4,4,4,0,3,226
660281809,217,8,7,2,10,2,3,249
660281810,220,15,1,0,3,0,10,249
660281811,313,10,2,0,4,1,7,337
660281812,259,13,3,2,1,0,8,286
660281813,230,8,1,0,5,0,5,249
660281814,259,11,2,0,0,0,3,275
660281815,200,6,0,1,3,0,7,217
660281816,244,12,3,2,1,0,9,271
660281817,224,18,0,6,4,0,4,256
660281818,240,8,1,0,0,0,0,249
660281901,339,16,4,20,0,2,12,393
660281902,269,9,0,9,0,1,6,294
660281903,207,5,2,2,0,1,4,221
660281904,209,8,3,3,2,0,3,228
660281905,354,7,1,4,0,1,2,369
660281906,276,6,1,1,0,1,9,294
660281907,289,8,3,2,2,0,6,310
660281908,258,5,0,2,0,0,0,265
660281909,223,9,3,0,0,2,5,242
660281910,384,16,0,5,0,0,7,412
660281911,282,6,0,3,1,0,3,295
660281912,203,6,2,0,0,0,4,215
660281913,284,15,4,4,0,1,3,311
660281914,272,8,0,0,0,0,12,292
660281915,264,10,0,6,0,0,5,285
660282001,214,9,2,10,0,0,4,239
660282002,314,19,4,0,0,4,10,351
660282003,242,27,2,0,0,0,10,281
660282004,253,13,5,0,1,2,4,278
660282005,214,33,11,0,0,0,4,262
660282006,204,23,5,0,0,5,47,284
660282007,317,27,0,4,2,0,10,360
660282008,267,4,3,2,3,0,1,280
660282009,276,9,1,1,0,0,4,291
660282010,178,5,2,0,2,0,2,189
660282011,330,7,1,1,2,0,4,345
660282012,283,5,2,7,0,1,7,305
660282013,219,1,0,0,0,0,1,221
660282014,291,5,1,1,1,0,0,299
660282015,290,9,0,3,1,0,4,307
660282016,292,4,1,0,1,1,7,306
660282017,269,3,2,1,0,1,1,277
660282018,370,3,0,1,0,0,5,379
660282019,244,9,0,8,0,0,4,265
660282101,252,30,5,0,0,1,6,294
660282102,224,37,5,0,2,1,27,296
660282103,122,10,5,0,1,0,1,139
660282104,317,16,6,4,2,0,6,351
660282105,396,12,8,6,1,3,8,434
660282106,394,20,4,2,2,0,2,424
660282107,277,20,2,1,1,0,10,311
660282108,210,19,6,1,0,2,1,239
660282109,227,29,34,1,0,1,4,296
660282110,156,20,3,0,0,3,46,228
660282111,222,19,0,4,2,0,3,250
660282112,224,9,1,1,2,3,3,243
660282113,216,4,0,2,0,3,1,226
660282114,222,6,5,0,2,0,0,235
660282115,350,16,4,0,0,0,0,370
660282116,395,5,3,0,0,1,16,420
660282117,365,11,3,1,3,0,14,397
660282118,309,16,1,0,15,0,3,344
660282119,316,11,10,0,1,1,4,343
660282120,270,29,2,7,6,2,7,323
660282121,346,17,5,6,0,1,7,382
660282122,322,23,1,1,2,3,4,356
660282123,213,12,0,1,3,1,4,234
660282124,230,9,0,0,0,0,4,243
660282201,326,20,3,0,1,0,13,363
660282202,212,19,4,0,0,1,2,238
660282203,292,14,2,0,4,2,7,321
660282204,363,19,1,0,0,4,6,393
660282205,225,9,0,3,3,1,5,246
660282206,237,6,2,0,4,0,3,252
660282207,225,8,1,3,0,0,1,238
660282208,292,27,1,1,0,1,6,328
660282209,305,11,3,0,3,8,13,343
660282210,328,10,5,0,0,3,5,351
660282211,268,15,5,0,2,8,9,307
660282212,379,13,1,5,0,0,0,398
660282213,312,12,5,0,1,1,1,332
660282214,381,17,4,0,2,4,2,410
660282301,309,3,1,0,0,1,3,317
660282302,242,5,2,0,0,0,1,250
660282303,357,9,1,0,4,0,9,380
660282304,316,5,1,3,3,0,0,328
660282305,329,0,0,1,0,0,8,338
660282306,328,1,0,1,1,2,4,337
660282307,313,9,0,0,0,0,2,324
660282308,327,15,1,1,0,0,5,349
660282309,359,3,1,1,1,1,2,368
660282310,309,3,1,0,0,0,2,315
660282311,364,11,1,0,1,0,3,380
660282312,276,8,2,0,1,1,0,288
660282313,320,3,2,3,0,1,5,334
660282314,331,5,2,5,1,0,3,347
660282315,284,4,1,2,1,0,2,294
660282316,292,6,0,0,0,0,0,298
660282317,307,3,0,2,0,0,2,314
660282318,313,15,0,3,1,0,2,334
660282401,86,3,0,0,0,3,4,96
660282402,199,10,3,14,3,0,3,232
660282403,274,5,0,3,0,0,6,288
660282404,338,4,0,2,0,0,3,347
660282405,316,6,0,1,0,0,2,325
660282406,280,8,0,3,0,0,10,301
660282407,196,6,0,1,0,0,5,208
660282408,359,13,2,0,1,1,9,385
660282409,326,3,0,2,0,0,0,331
660282410,410,18,0,7,0,0,9,444
660282411,358,8,1,3,0,0,17,387
660282412,376,8,0,2,0,1,14,401
660282501,391,22,6,10,6,4,28,467
660282502,228,24,8,6,0,5,13,284
660282503,207,11,6,17,0,1,13,255
660282504,274,36,0,23,0,10,3,346
660282505,133,10,3,12,1,84,11,254
660282506,218,16,1,19,2,74,12,342
660282507,235,37,3,27,1,70,22,395
660282508,334,49,3,25,1,28,23,463
660282509,244,20,7,11,1,1,10,294
660282510,369,16,0,1,0,0,5,391
660282511,374,28,0,3,0,1,8,414
660282512,272,20,7,0,0,3,4,306
660282513,219,28,6,0,0,1,3,257
660282514,310,19,1,0,0,1,4,335
660282515,361,24,3,0,0,1,11,400
660282601,270,16,0,26,1,3,2,318
660282602,281,10,1,11,2,2,4,311
660282603,326,21,0,0,0,0,3,350
660282604,226,21,0,24,0,2,7,280
660282605,233,16,0,16,2,0,4,271
660282606,294,33,4,27,2,4,11,375
660282607,453,15,0,10,0,0,4,482
660282608,435,15,0,3,0,0,6,459
660282609,434,14,0,0,0,0,6,454
660282610,449,8,0,1,0,0,4,462
660282611,350,3,0,10,0,0,3,366
660282612,477,4,0,0,0,0,9,490
660282613,408,23,0,4,0,0,12,447
660282614,447,9,0,1,0,0,8,465
660282615,327,4,0,2,1,0,2,336
660282616,301,1,0,1,0,0,1,304
660282617,429,18,2,1,0,3,2,455
660282618,334,10,0,2,0,1,4,351
660282619,356,5,0,2,0,1,0,364
660282620,305,0,0,0,0,0,4,309
660282701,197,4,1,2,1,0,3,208
660282702,239,10,1,3,0,0,1,254
660282703,299,6,0,2,0,0,3,310
660282704,242,15,3,8,0,3,2,273
660282705,227,12,4,2,0,0,0,245
660282706,211,6,0,0,0,0,5,222
660282707,221,11,1,3,1,0,3,240
660282708,209,4,0,0,0,0,2,215
660282709,261,13,0,1,0,0,3,278
660282710,211,2,0,1,1,0,4,219
660282711,258,12,1,4,3,0,4,282
660282712,259,7,1,2,2,1,3,275
660282713,327,13,4,1,2,0,2,349
660282714,252,6,1,2,0,0,4,265
660282715,307,9,2,3,0,0,17,338
660282801,193,19,1,1,5,1,9,229
660282802,188,5,0,1,0,0,5,199
660282803,228,7,0,1,0,0,2,238
660282804,219,27,16,1,1,0,8,272
660282805,329,25,9,2,2,0,11,378
660282806,398,23,2,0,0,2,6,431
660282807,291,15,2,9,2,7,6,332
660282808,284,11,3,1,1,1,1,302
660282809,429,20,2,6,2,2,13,474
660282810,374,7,0,5,1,0,12,399
660282811,321,12,9,4,2,2,5,355
660282812,277,2,3,0,0,0,3,285
660282813,398,1,1,2,0,0,7,409
660282814,216,3,0,3,0,0,9,231
660282815,208,7,0,0,0,1,6,222
660350101,59,4,0,0,0,0,4,67
660350102,126,11,1,31,1,16,22,208
660350103,203,18,0,5,1,16,43,286
660350104,16,9,0,0,0,0,0,25
660350105,140,40,0,1,1,36,57,275
660350106,342,36,0,1,1,30,48,458
660350107,33,0,0,0,0,10,10,53
660350108,163,20,0,6,0,19,16,224
660350109,349,22,1,6,2,3,7,390
660350110,249,11,0,12,2,2,4,280
660350111,264,16,0,7,2,10,8,307
660350112,272,19,4,3,3,4,8,313
660350113,252,15,0,3,2,6,4,282
660350114,250,17,0,4,0,2,6,279
660350115,190,25,3,2,17,2,10,249
660350116,270,16,1,10,0,1,7,305
660350117,380,0,4,23,2,32,13,454
660350118,214,19,0,12,0,5,3,253
660350119,171,13,0,8,0,0,4,196
660350120,186,21,0,8,0,3,9,227
660350121,144,2,0,5,0,2,1,154
660350122,319,23,1,10,0,0,2,355
660350123,340,21,0,1,0,2,6,370
660350124,341,20,1,1,0,4,9,376
660350201,324,20,0,6,0,13,47,410
660350202,168,28,0,10,0,3,32,241
660350203,190,138,1,8,0,17,17,371
660350204,15,1,0,0,0,0,0,16
660350205,44,36,0,0,0,0,3,83
660350206,235,16,0,2,1,0,7,261
660350207,85,0,0,0,0,3,27,115
660350208,102,11,0,19,1,1,2,136
660350209,229,4,1,3,1,0,4,242
660350210,321,14,2,14,3,2,5,361
660350211,251,14,1,8,2,5,3,284
660350212,312,15,1,2,0,1,5,336
660420101,96,57,0,0,0,0,13,166
660420102,51,8,0,0,0,2,6,67
660420103,246,33,0,2,0,3,39,323
660420104,388,27,10,31,1,8,47,512
660420105,134,17,0,2,0,11,15,179
660420106,168,32,1,0,0,2,23,226
660420107,58,9,0,3,0,19,16,105
660420108,186,10,0,1,4,0,5,206
660420109,232,13,0,3,6,1,7,262
660420110,148,6,0,12,13,6,10,195
660420111,227,11,0,5,1,4,1,249
660420201,97,13,0,2,0,3,28,143
660420202,162,15,0,13,0,16,21,227
660420203,328,19,0,6,0,12,23,388
660420204,4,3,0,0,0,0,5,12
660420205,360,21,1,23,4,2,5,416
660420206,238,14,3,10,0,3,8,276
660420207,254,22,2,6,4,2,5,295
660420208,315,10,1,8,0,1,1,336
660420209,182,5,3,3,6,2,5,206
660420210,181,13,0,2,5,0,3,204
660490101,23,14,0,0,0,0,22,59
660490102,57,2,0,0,0,5,38,102
660490103,142,83,0,2,2,45,63,337
660490104,339,14,0,8,4,0,9,374
660490105,343,21,2,3,1,0,14,384
660490106,251,9,1,8,2,0,9,280
660490107,315,14,2,1,3,3,20,358
660490201,94,2,0,0,0,0,111,207
660490202,25,2,0,0,0,2,6,35
660490203,10,4,0,0,0,0,2,16
660490204,38,13,0,0,0,5,6,62
660490205,84,17,0,1,1,2,8,113
660490206,36,0,0,0,1,0,45,82
660490207,18,2,0,0,0,0,0,20
660490208,33,8,0,0,0,2,0,43
660490209,26,2,0,1,0,0,6,35
660490210,13,10,0,0,0,0,3,26
660490211,220,0,2,7,0,4,1,234
660490212,187,5,0,0,1,0,0,193
660490213,320,6,1,1,0,0,2,330
660490214,206,6,0,0,0,0,2,214
660490215,188,7,0,0,0,1,1,197
660490216,179,13,0,2,0,1,6,201
660490217,312,14,0,5,0,1,9,341
660490301,166,50,1,0,0,2,3,222
660490302,223,41,0,6,4,6,31,311
660490303,27,0,0,0,0,0,7,34
660490304,202,20,1,11,1,6,10,251
660490305,319,8,0,2,0,1,6,336
660490306,187,2,0,12,0,0,6,207
660490307,205,4,0,1,0,0,5,215
660490308,217,12,2,2,0,0,6,239
660490309,197,10,1,16,0,6,5,235
660490401,310,20,7,1,1,1,4,344
660490402,228,9,1,6,1,0,3,248
660490403,306,10,0,1,0,0,10,327
660490404,278,17,2,5,0,0,2,304
660490405,304,14,2,8,1,0,18,347
660490406,196,11,4,3,4,0,7,225
660490407,194,4,0,0,0,0,5,203
660490408,247,22,3,2,0,1,16,291
660490409,250,9,1,2,0,0,10,272
660490410,416,11,0,5,2,1,4,439
660490411,220,9,1,2,0,0,0,232
660490412,235,14,2,0,0,0,9,260
660490413,276,45,8,7,11,0,10,357
660490414,184,12,1,1,0,0,11,209
660490415,203,4,0,0,0,1,5,213
660490416,257,13,8,1,2,0,12,293
660490417,230,14,4,0,1,1,10,260
660490418,247,16,2,0,1,0,5,271
660490419,201,10,1,2,1,0,6,221
660490420,173,5,3,1,0,1,11,194
660490421,200,10,0,5,2,0,1,218
660490422,183,11,0,4,1,1,1,201
660560101,31,0,0,1,0,0,0,32
660560102,227,28,3,10,0,8,23,299
660560103,208,26,0,3,0,0,6,243
660560104,22,6,0,0,0,0,1,29
660560105,275,11,1,3,0,0,42,332
660560106,368,36,7,3,1,0,3,418
660560107,235,12,1,3,0,0,22,273
660560108,195,12,1,5,1,0,20,234
660560109,219,16,3,5,0,0,4,247
660560110,204,24,3,4,1,0,2,238
660560111,193,13,1,0,0,0,4,211
660560112,440,43,4,17,9,1,10,524
660560113,120,20,0,1,0,1,8,150
660560114,256,11,2,0,0,2,2,273
660560115,170,15,1,0,3,1,9,199
660560116,114,7,3,15,0,0,9,148
660560117,237,10,4,3,2,0,9,265
660560118,262,39,4,24,0,0,5,334
660560119,327,17,2,19,0,0,4,369
660560120,138,7,0,17,0,0,9,171
660560201,56,8,0,0,0,0,4,68
660560202,118,12,0,6,0,0,14,150
660560203,246,34,0,8,0,6,15,309
660560204,287,6,0,2,0,2,8,305
660560205,116,1,0,3,0,1,2,123
660560206,49,3,0,0,0,0,0,52
660560207,37,6,0,0,0,2,2,47
660560208,104,4,0,0,0,0,1,109
660560209,100,9,0,1,0,0,1,111
660560210,310,24,2,3,2,0,7,348
660560211,213,9,0,1,1,0,9,233
660560212,222,21,2,2,1,0,2,250
660560213,364,17,2,21,2,0,9,415
660560214,178,9,0,0,0,0,0,187
660560215,182,19,1,0,7,1,2,212
660560216,208,21,0,9,1,0,5,244
660560217,185,13,1,6,2,0,4,211
660560218,303,22,1,3,0,1,0,330
660560301,222,27,0,3,0,5,6,263
660560302,122,25,0,3,0,4,7,161
660560303,73,12,0,0,0,0,3,88
660560304,161,8,0,0,0,0,0,169
660560305,167,0,0,0,0,0,1,168
660560306,272,7,0,2,0,0,1,282
660560307,218,3,0,0,0,0,2,223
660560401,79,5,0,0,0,1,11,96
660560402,146,30,3,2,0,2,12,195
660560403,156,9,0,1,1,1,2,170
660560404,5,1,0,0,0,0,0,6
660560405,288,27,1,18,2,1,3,340
660560406,62,3,1,0,0,0,1,67
660560407,72,5,1,0,1,0,3,82
660560408,225,36,1,0,0,1,10,273
660560409,158,16,0,4,1,2,5,186
660560410,259,16,0,5,3,0,9,292
660560411,162,24,0,6,0,0,9,201
660560501,18,0,0,0,0,0,0,18
660560502,28,0,0,0,0,0,0,28
660560503,86,4,0,0,0,0,1,91
660560504,233,33,0,0,0,2,2,270
660560505,210,20,0,0,0,0,6,236
660560601,26,4,0,0,0,0,3,33
660560602,78,4,0,4,1,0,6,93
660560603,154,8,2,0,0,0,8,172
660560604,55,6,0,0,4,1,0,66
660560605,67,10,0,0,0,1,5,83
660560606,50,0,0,0,0,0,2,52
660560607,39,6,0,0,0,6,0,51
660560608,240,7,0,1,0,0,8,256
660560609,36,3,0,0,0,0,1,40
660560610,34,10,0,0,0,5,5,54
660560611,170,35,0,0,1,0,2,208
660560612,242,48,0,7,0,0,7,304
660560613,290,13,0,0,0,0,12,315
660560614,297,9,4,1,1,1,10,323
660560615,301,26,0,8,1,0,12,348
660560616,369,14,2,2,0,0,11,398
660560617,257,9,1,2,0,0,0,269
660560618,382,13,3,1,0,1,11,411
660560619,206,21,1,2,3,0,10,243
660560620,220,11,9,3,4,2,11,260
660560621,222,22,2,5,1,1,8,261
660560622,299,23,5,4,32,1,20,384
660560623,181,13,3,2,27,2,8,236
660560624,459,10,0,7,1,0,33,510
660560625,129,15,0,3,1,0,4,152
660560626,266,8,0,0,0,0,7,281
660560627,207,15,0,8,1,1,9,241
660560628,216,7,1,1,0,0,2,227
660560629,167,33,0,9,1,0,15,225
660560630,124,9,0,0,0,0,0,133
660560701,495,22,1,3,1,1,11,534
660560702,272,8,1,4,0,0,7,292
660560703,282,19,1,4,0,0,13,319
660560704,230,7,0,5,0,0,13,255
660560705,254,14,1,1,0,0,2,272
660560706,336,5,0,1,1,0,11,354
660560707,44,1,0,1,0,0,413,459
660560708,388,28,2,2,1,2,11,434
660560709,227,7,2,4,1,0,6,247
660560710,359,16,3,17,0,0,24,419
660560711,262,31,0,1,2,1,4,301
660560712,170,19,7,3,2,0,7,208
660560713,266,17,2,4,8,1,11,309
660560714,221,20,3,1,0,0,3,248
660560715,364,8,0,7,1,0,12,392
660560801,278,11,0,2,0,1,13,305
660560802,289,14,0,4,0,1,3,311
660560803,242,8,0,4,2,0,7,263
660560804,254,19,0,0,3,0,13,289
660560805,197,9,17,2,9,0,45,279
660560806,171,8,15,8,109,2,16,329
660560807,117,16,0,2,5,0,7,147
660560808,165,26,10,1,1,1,13,217
660560809,180,15,4,3,1,0,4,207
660560810,209,10,5,1,4,1,4,234
660560811,137,13,1,0,0,0,0,151
660560812,265,12,2,6,15,0,3,303
660560813,189,6,2,6,3,3,8,217
660560814,293,5,0,1,0,0,11,310
660560815,315,8,0,3,0,0,7,333
660560901,54,2,0,0,0,0,8,64
660560902,224,20,4,9,5,0,34,296
660560903,210,17,9,4,1,0,6,247
660560904,231,7,1,10,10,2,9,270
660560905,270,12,0,5,4,0,4,295
660560906,254,10,0,8,0,0,1,273
660560907,303,7,0,3,1,0,11,325
660560908,325,14,1,6,1,0,16,363
660560909,450,22,6,5,1,5,23,512
660560910,214,11,0,5,0,0,7,237
660560911,399,19,3,11,0,0,11,443
660560912,245,16,3,1,1,1,6,273
660560913,300,23,1,3,0,0,6,333
660560914,225,12,1,1,5,0,13,257
660560915,382,15,4,2,4,1,18,426
660560916,296,11,4,2,1,0,12,326
660560917,425,10,0,2,0,0,7,444
660560918,245,12,0,1,0,0,6,264
660560919,261,17,0,13,0,1,17,309
660560920,266,7,0,6,0,0,15,294
660560921,210,17,0,1,0,0,23,251
660560922,249,8,5,7,0,2,7,278
660560923,284,16,0,0,0,0,6,306
660560924,280,11,1,4,0,1,10,307
660560925,294,24,4,0,1,1,8,332
660561001,234,18,1,0,1,0,6,260
660561002,351,11,1,4,2,0,20,389
660561003,289,7,3,0,0,0,7,306
660561004,251,26,2,1,0,0,7,287
660561005,256,14,6,2,1,0,6,285
660561006,227,12,1,4,2,1,3,250
660561007,230,14,2,1,1,0,1,249
660561008,227,19,0,6,0,0,4,256
660561009,175,12,3,3,1,0,6,200
660561010,308,32,1,3,1,1,17,363
660561011,264,19,0,0,0,0,0,283
660561012,186,9,0,0,0,0,2,197
660561013,267,10,0,23,0,0,20,320
660561014,158,15,2,1,1,0,7,184
660561015,197,5,0,2,0,0,5,209
660630101,22,5,0,0,0,3,1,31
660630102,6,1,0,0,0,0,5,12
660630103,8,6,0,0,0,0,2,16
660630104,27,0,0,0,0,6,6,39
660630105,20,0,0,0,0,0,6,26
660630106,7,9,0,0,0,0,0,16
660630107,89,12,0,0,0,10,29,140
660630108,68,23,0,0,0,0,6,97
660630109,23,3,0,0,0,3,9,38
660630110,205,25,1,21,0,5,11,268
660630111,206,28,0,16,1,1,18,270
660630201,32,1,0,1,0,7,3,44
660630202,112,20,0,0,0,6,18,156
660630203,24,11,0,0,0,0,3,38
660700101,17,3,0,0,0,9,12,41
660700102,98,46,0,2,0,4,48,198
660700103,18,2,0,0,0,2,8,30
660700104,12,0,0,0,0,1,5,18
660700105,45,17,0,0,0,6,35,103
660700106,21,1,0,0,0,13,0,35
660700107,60,6,0,3,0,4,54,127
660700201,61,9,0,0,0,7,55,132
660700202,24,33,0,0,0,0,2,59
660700203,111,66,1,7,0,5,36,226
660700204,104,33,0,1,0,9,33,180
660700205,232,69,7,14,11,9,11,353
660700301,32,1,0,0,0,0,6,39
660700302,10,21,0,0,0,0,2,33
660700303,17,10,0,0,0,14,0,41
660700401,24,2,0,0,0,0,0,26
660700402,13,1,0,0,0,23,3,40
660700403,15,10,0,0,0,0,0,25
660700404,17,0,0,0,0,5,7,29
660700405,7,5,0,0,0,6,5,23
660700406,6,54,0,0,0,0,0,60
660700407,27,61,0,0,0,0,0,88
660700501,9,2,0,0,0,1,5,17
660700502,5,0,0,0,0,0,7,12
660700503,12,27,0,1,0,0,0,40
660700504,80,34,0,2,0,2,0,118
660700505,3,26,0,0,0,0,4,33
660700506,18,5,0,0,0,0,0,23
660700507,101,45,0,2,0,1,2,151
660700508,167,17,1,25,0,18,22,250
660770101,19,0,0,0,0,0,0,19
660770102,43,1,1,1,0,0,0,46
660770103,64,9,0,3,0,8,15,99
660770104,164,12,2,8,1,25,18,230
660770105,206,21,0,15,0,6,4,252
660770106,136,18,0,31,0,20,11,216
660770107,171,17,2,5,0,18,7,220
660770108,232,11,2,8,0,22,7,282
660770109,147,13,1,4,4,14,18,201
660770201,12,6,0,0,0,0,1,19
660770202,13,11,0,0,0,3,0,27
660770203,16,8,0,0,0,1,0,25
660770204,231,33,3,11,0,33,12,323
660770205,272,16,1,22,2,30,4,347
660770301,14,5,3,0,0,0,9,31
660770302,9,1,0,0,0,2,5,17
660770303,67,16,0,10,0,52,17,162
660770304,30,6,0,8,0,12,6,62
660840101,99,14,1,9,0,0,3,126
660840102,136,30,0,1,0,15,23,205
660840103,12,2,0,0,0,0,0,14
660840104,11,3,0,0,0,2,10,26
660840105,15,6,0,0,0,2,4,27
660840106,201,15,0,25,0,5,19,265
660840107,225,19,1,5,4,4,14,272
660840108,186,19,0,3,1,0,5,214
660840109,213,6,0,14,2,2,4,241
660840201,23,1,0,0,0,0,5,29
660840202,34,6,0,0,0,1,5,46
660840203,35,5,0,1,0,2,2,45
660840204,21,12,0,0,0,1,8,42
660840205,155,32,0,2,0,6,4,199
660910101,15,31,0,0,0,0,3,49
660910102,33,30,0,1,1,16,15,96
660910103,30,0,0,0,0,0,0,30
660910104,38,11,0,0,0,0,10,59
660910105,34,12,0,0,0,6,7,59
660910201,13,0,0,0,0,0,0,13
660910202,24,11,0,0,0,0,6,41
660910203,16,2,0,0,0,2,0,20
660910204,29,2,0,2,0,0,13,46
660910205,133,36,4,6,0,14,15,208
660980101,161,68,0,25,0,1,39,294
660980102,84,14,0,1,0,19,23,141
660980103,56,3,0,1,0,61,26,147
660980104,26,2,2,0,0,31,5,66
660980105,189,30,0,8,1,7,10,245
660980106,310,34,2,7,1,9,14,377
660980201,18,0,0,0,0,0,16,34
660980202,2,0,0,0,0,0,6,8
660980203,71,16,0,20,1,1,32,141
660980204,22,12,0,0,0,1,6,41
660980205,112,2,0,5,0,16,30,165
660980206,4,0,0,0,0,0,3,7
660980207,27,5,0,0,0,0,3,35
660980208,186,23,0,15,0,5,4,233
660980209,197,12,0,2,1,3,6,221
661050101,0,14,0,0,0,0,0,14
661050102,0,2,0,0,0,0,0,2
661050103,3,0,0,0,0,0,0,3
661050104,49,6,2,5,0,0,7,69
661050201,36,14,0,0,1,0,42,93
661050202,100,21,0,0,0,0,57,178
661050203,45,26,0,0,0,2,35,108
661050204,15,19,0,0,0,0,1,35
661050205,9,13,0,0,0,0,4,26
661050206,2,0,0,0,0,0,22,24
661050207,3,1,0,0,0,0,2,6
661050208,7,0,0,0,0,0,5,12
661050209,218,72,1,9,1,3,10,314
661050210,153,42,1,7,6,2,22,233
661050211,148,21,0,6,4,2,33,214
661050212,131,42,0,2,1,3,23,202
661050213,191,51,0,9,0,0,12,263
661120101,65,21,2,6,0,0,10,104
661120102,9,1,0,0,0,3,8,21
661120103,22,0,0,0,0,0,16,38
661120104,51,9,0,0,0,4,5,69
661120105,240,27,4,7,0,5,61,344
661120106,101,4,3,2,8,20,21,159
661120107,61,25,0,0,0,7,7,100
661120108,75,4,0,1,0,0,8,88
661120109,291,17,3,7,2,1,34,355
661120110,92,5,0,4,1,4,6,112
661120201,103,29,0,0,0,0,14,146
661120202,31,16,0,0,0,0,2,49
661120203,9,1,0,0,0,3,6,19
661120204,37,7,0,0,0,0,1,45
661120205,84,16,0,0,0,3,14,117
661120206,68,17,0,0,0,0,1,86
661120207,30,2,0,0,0,0,3,35
661120208,158,11,0,0,0,6,7,182
661120209,201,13,0,0,0,1,8,223
661120210,137,20,0,3,0,2,11,173
661120211,49,8,0,1,0,2,1,61
661120212,254,15,2,1,5,4,5,286
661120213,293,15,1,1,3,2,20,335
661120214,373,31,3,1,1,1,4,414
661120215,267,20,1,4,1,2,8,303
661120301,241,5,3,2,1,2,3,257
661120302,244,13,6,3,0,1,4,271
661120303,189,20,4,7,0,1,9,230
661120304,180,13,3,1,1,1,9,208
661120305,257,11,0,5,0,1,18,292
661120306,257,19,2,1,0,0,7,286
661120307,164,9,0,5,2,0,5,185
661120308,172,22,7,2,4,0,6,213
661120309,212,16,0,4,0,0,5,237
661120310,331,26,1,6,0,2,9,375
661120311,198,5,0,6,0,1,6,216
661120312,328,29,2,11,0,2,9,381
661120313,233,20,0,3,2,1,4,263
661120401,327,13,0,11,0,1,17,369
661120402,163,12,1,2,3,2,11,194
661120403,153,14,0,1,0,1,6,175
661120404,236,10,6,3,35,1,21,312
661120405,281,24,4,5,1,2,13,330
661120406,230,29,3,6,5,0,7,280
661120407,175,15,1,4,1,0,16,212
661120408,187,7,1,0,0,1,2,198
661120409,377,10,0,6,0,2,2,397
661120410,174,28,0,0,0,1,14,217
661120411,291,19,1,2,3,0,19,335
661120412,313,29,0,8,1,4,11,366
661120413,298,8,2,5,0,0,7,320
661190101,53,1,0,0,0,5,6,65
661190102,293,35,0,5,2,3,50,388
661190103,155,53,0,4,2,19,59,292
661190104,62,5,1,0,3,2,15,88
661190105,74,16,0,0,0,0,7,97
661190201,18,0,0,0,0,0,0,18
661190202,43,15,0,0,0,3,2,63
661190203,122,7,0,0,0,4,7,140
661190204,65,3,0,0,1,0,23,92
661190205,220,33,5,7,8,15,20,308
661260101,35,18,0,0,0,7,0,60
661260102,394,35,0,0,0,0,16,445
661260103,142,23,0,0,0,11,5,181
661260104,165,11,0,5,0,0,2,183
661260105,222,10,7,4,5,0,4,252
661260201,72,14,0,1,1,81,33,202
661260202,75,22,0,2,0,1,21,121
661260203,178,222,0,8,0,4,49,461
661260204,35,28,0,0,0,0,21,84
661260205,234,38,0,0,0,3,4,279
661260206,388,24,1,2,0,0,5,420
661260207,227,14,1,0,0,0,3,245
661260208,287,16,1,0,1,0,1,306
661260209,422,23,1,23,0,2,9,480
661260210,279,5,1,8,0,0,3,296
661260211,289,34,0,2,0,2,4,331
661260212,221,15,0,0,0,0,9,245
661260213,336,14,1,1,0,1,8,361
661260214,281,18,1,1,0,0,4,305
661260215,323,37,0,3,0,0,6,369
661260216,281,25,1,27,0,1,10,345
661260217,423,11,2,2,1,0,7,446
661260218,205,12,0,3,0,0,8,228
661260301,56,5,0,0,0,0,14,75
661260302,153,20,2,0,0,0,2,177
661260303,273,10,0,2,1,1,20,307
661260304,187,21,0,12,0,0,3,223
661260401,215,46,0,3,1,0,101,366
661260402,155,2,0,0,1,2,4,164
661260403,23,0,0,3,0,0,6,32
661260404,51,2,0,0,0,0,9,62
661260405,19,0,0,0,0,0,4,23
661260406,76,24,0,2,0,1,34,137
661260407,36,0,0,0,1,5,9,51
661260408,181,18,0,3,0,0,13,215
661260409,172,8,0,2,0,1,1,184
661260410,411,12,2,1,3,1,7,437
661260411,301,7,2,3,2,0,20,335
661260412,363,27,1,7,5,1,2,406
661260413,286,7,0,3,1,0,0,297
661260414,241,11,1,1,4,0,9,267
661260415,248,19,2,3,2,0,5,279
661260416,307,20,4,2,4,0,13,350
661260417,146,13,0,0,0,0,5,164
661260418,205,9,0,0,0,0,7,221
661260501,14,0,0,0,1,0,36,51
661260502,263,26,0,11,0,0,54,354
661260503,5,0,0,0,0,0,0,5
661260504,257,62,0,0,7,2,4,332
661260505,243,5,0,3,0,0,4,255
661260506,221,5,0,1,0,0,6,233
661260507,331,13,2,0,1,0,7,354
661260508,281,22,0,0,0,0,7,310
661260509,297,16,3,1,0,0,16,333
661260510,200,10,2,3,1,0,2,218
661260511,232,7,0,0,0,0,1,240
661260601,228,67,0,11,2,2,43,353
661260602,62,24,0,0,0,12,4,102
661260603,210,31,0,1,0,19,12,273
661260604,42,27,0,0,0,0,2,71
661260605,66,29,0,0,1,2,11,109
661260606,27,12,0,1,0,2,0,42
661260607,24,9,0,0,0,0,0,33
661260608,8,0,0,0,0,0,0,8
661260609,280,11,0,0,0,0,6,297
661260610,334,23,0,0,0,0,4,361
661260611,355,18,0,5,0,1,3,382
661260612,217,4,0,0,1,0,3,225
661260613,267,21,3,0,1,0,2,294
661260614,306,5,1,1,0,1,10,324
661260615,272,11,1,7,11,0,7,309
661260616,261,8,0,1,0,2,10,282
661260617,225,18,1,4,2,0,11,261
661260618,224,18,0,0,0,0,0,242
661260619,344,24,1,3,0,1,11,384
661260620,338,30,1,5,2,1,7,384
661260621,196,14,0,2,1,0,10,223
661260622,192,19,2,1,1,0,7,222
661260623,136,75,0,27,0,0,2,240
661260624,255,21,1,1,0,0,7,285
661260625,159,19,1,6,0,1,9,195
661260701,348,6,1,0,0,0,3,358
661260702,267,3,0,0,0,0,4,274
661260703,232,2,0,1,0,0,3,238
661260704,249,13,2,5,1,2,4,276
661260705,184,8,2,2,3,0,1,200
661260706,254,16,5,4,0,0,5,284
661260707,296,13,1,0,0,0,5,315
661260708,297,10,0,3,1,0,22,333
661260709,389,3,0,4,0,1,13,410
661260710,198,16,1,4,2,0,6,227
661260711,186,20,7,6,21,0,5,245
661260712,182,16,11,1,0,0,13,223
661260713,287,4,0,0,0,0,2,293
661260714,258,5,1,1,5,0,4,274
661260715,193,25,8,3,14,1,9,253
661260716,184,30,1,4,3,0,1,223
661260717,256,19,17,6,5,0,10,313
661260718,255,11,5,15,11,3,15,315
661260719,159,13,4,2,0,0,1,179
661260720,261,5,1,3,2,0,4,276
661260721,295,18,2,0,0,0,9,324
661260722,211,8,9,2,0,0,6,236
661260723,257,24,0,2,0,0,7,290
661260801,347,8,0,0,0,0,5,360
661260802,239,11,0,3,1,0,5,259
661260803,151,24,7,0,1,0,16,199
661260804,179,10,1,0,12,0,4,206
661260805,177,14,3,2,1,0,6,203
661260806,182,9,1,1,0,0,0,193
661260807,162,15,1,0,1,0,2,181
661260808,171,9,0,3,0,0,5,188
661260809,373,13,1,2,2,0,15,406
661260810,194,6,0,1,0,0,3,204
661260811,218,7,1,2,0,0,4,232
661260812,356,8,1,7,0,2,7,381
661260813,320,12,0,2,0,0,8,342
661260814,346,11,2,0,2,0,4,365
661260815,273,11,0,5,7,1,2,299
661260816,310,20,6,1,0,1,9,347
661260817,286,8,1,3,2,0,6,306
661260818,442,8,0,9,0,0,8,467
661260819,299,20,2,0,1,0,7,329
661260820,125,24,1,4,1,0,5,160
661260821,321,18,2,4,1,1,4,351
661260822,315,15,4,4,0,0,3,341
661260823,260,14,1,1,0,0,3,279
661260824,365,25,1,8,1,0,5,405
661330101,602,20,0,0,0,0,5,627
661330102,427,13,0,1,0,3,4,448
661330103,118,2,0,0,0,0,2,122
661330104,110,6,1,0,0,0,6,123
661330105,64,6,0,0,0,0,3,73
661330106,211,4,0,0,0,0,5,220
661330107,377,19,0,1,0,0,7,404
661330108,401,75,6,16,1,6,8,513
661330201,33,2,0,0,0,0,3,38
661330202,27,0,0,0,0,0,0,27
661330203,96,3,0,0,0,0,1,100
661330204,33,5,0,0,0,0,0,38
661330205,28,0,0,0,0,0,3,31
661330206,38,2,0,0,0,0,1,41
661330207,26,5,0,0,0,0,0,31
661330208,167,32,0,1,0,0,4,204
661330209,56,35,0,1,0,0,2,94
661330210,95,3,0,0,0,0,12,110
661330211,67,8,0,0,0,0,0,75
661330212,61,3,0,0,0,1,0,65
661330213,39,1,0,0,0,0,0,40
661330214,162,12,0,0,0,1,6,181
661330215,28,0,0,0,0,1,5,34
661330216,233,48,1,18,0,3,20,323
661330217,34,4,0,0,0,0,0,38
661330218,53,6,0,0,0,0,1,60
661330219,124,16,0,1,0,5,16,162
661330220,247,59,0,0,0,0,18,324
661330221,224,22,0,4,0,4,9,263
661330222,126,21,2,0,6,1,5,161
661330223,194,24,3,6,7,1,4,239
661330224,222,52,0,0,0,0,16,290
661330301,186,15,0,1,0,0,9,211
661330302,111,11,0,0,0,2,8,132
661330303,34,0,0,0,0,0,0,34
661330304,214,19,0,0,0,0,2,235
661330305,157,4,0,0,0,0,1,162
661330306,231,16,0,0,0,2,11,260
661330307,47,3,0,0,0,0,0,50
661330308,83,23,0,2,1,0,2,111
661330309,172,39,0,7,4,1,15,238
661330310,199,46,0,33,0,4,34,316
661330311,235,44,1,2,1,8,26,317
661330312,267,38,0,4,2,7,18,336
661400101,21,3,0,0,0,0,6,30
661400102,34,17,0,0,0,0,2,53
661400103,43,17,0,0,0,0,7,67
661400104,9,6,0,0,0,0,0,15
661400105,34,1,1,0,0,3,7,46
661400106,25,27,0,1,0,0,0,53
661400107,42,2,0,4,0,2,7,57
661400108,100,7,0,0,0,1,3,111
661400109,5,2,0,0,0,2,3,12
661400110,71,5,0,1,0,0,19,96
661400111,36,7,0,0,0,1,10,54
661400112,36,4,0,2,0,4,4,50
661400113,68,2,1,3,1,11,21,107
661400114,53,5,0,0,0,2,5,65
661400115,46,9,0,0,1,12,8,76
661400116,264,26,0,10,0,2,14,316
661400117,329,45,0,8,2,2,15,401
661400118,226,10,1,1,0,0,4,242
661400119,264,11,0,1,0,0,4,280
661400120,271,13,0,0,0,1,4,289
661400121,464,29,0,4,2,2,2,503
661400201,14,8,2,1,0,2,2,29
661400202,19,0,0,0,0,0,13,32
661400203,41,10,0,0,0,2,6,59
661400204,45,16,2,0,0,2,7,72
661400205,55,3,0,0,1,0,4,63
661400301,30,16,0,0,0,2,26,74
661400302,20,0,0,0,0,1,5,26
661400303,11,3,0,0,0,0,0,14
661400304,94,11,0,2,1,1,1,110
661400305,12,0,0,0,0,0,11,23
661400306,10,7,0,0,0,0,0,17
661400307,27,7,0,0,0,0,6,40
661400308,15,1,0,0,0,1,2,19
661400309,17,0,0,0,0,4,3,24
661400310,132,3,0,12,1,4,19,171
661400311,132,28,1,7,1,14,11,194
661400312,144,21,0,5,1,1,19,191
661400401,281,10,2,2,1,0,18,314
661400402,259,18,2,4,0,3,6,292
661400403,250,30,1,3,6,1,3,294
661400404,187,21,0,2,2,0,4,216
661400405,241,9,3,6,0,2,9,270
661400406,183,18,5,2,0,0,6,214
661400407,183,24,1,3,1,1,6,219
661400408,226,19,5,7,8,0,15,280
661400409,265,26,1,2,6,1,8,309
661400410,307,14,2,10,0,0,14,347
661400411,246,22,0,1,0,0,12,281
661400412,223,19,0,2,2,0,12,258
661400413,211,17,1,2,4,0,4,239
661400414,275,23,5,2,1,4,2,312
661400415,284,15,2,7,1,2,4,315
661400416,149,15,0,1,0,0,1,166
661470101,23,7,0,0,0,0,3,33
661470102,34,12,0,0,0,0,0,46
661470103,33,3,0,0,0,10,1,47
661470104,43,35,0,0,0,0,23,101
661470105,39,12,0,0,0,5,8,64
661470201,31,11,0,0,0,0,10,52
661470202,46,14,0,0,0,0,11,71
661470203,17,0,0,0,0,14,1,32
661470204,12,3,0,0,0,4,2,21
661470205,38,22,0,0,0,10,1,71
661470301,21,8,0,1,0,27,14,71
661470302,46,1,0,0,0,21,6,74
661470303,12,7,0,0,0,4,1,24
661470304,9,1,0,0,0,0,14,24
661470305,32,3,0,0,0,1,14,50
661470306,134,17,1,7,3,35,15,212
661470307,539,77,0,38,3,37,39,733
661470308,7,6,0,0,0,0,0,13
661470309,13,3,0,0,0,0,1,17
661470310,7,9,0,0,0,0,0,16
661470311,277,11,1,14,1,22,6,332
661470312,303,11,4,6,4,29,8,365
661470313,167,28,1,13,24,13,12,258
661470314,123,40,2,7,5,39,8,224
661470315,357,23,2,32,7,6,7,434
661470316,300,22,0,6,4,3,6,341
661470317,306,29,1,11,0,7,10,364
661470401,294,37,9,55,5,140,48,588
661470402,172,24,0,4,1,34,26,261
661470403,91,8,0,0,0,2,5,106
661470404,109,25,1,0,0,2,7,144
661470405,56,22,0,2,0,10,8,98
661470406,5,3,0,0,0,1,2,11
661470407,399,15,0,11,1,5,5,436
661470408,327,16,0,48,0,0,2,393
661470409,258,38,0,32,0,52,35,415
661470501,205,17,2,8,2,4,11,249
661470502,221,2,0,1,0,0,11,235
661470503,197,2,0,3,1,2,4,209
661470504,290,12,1,0,0,2,4,309
661470505,209,12,0,4,1,1,1,228
661470506,213,22,2,3,0,5,0,245
661470507,223,4,0,1,0,0,5,233
661470508,194,18,2,1,0,1,2,218
661470509,240,24,0,7,3,1,9,284
661470510,265,15,1,1,0,1,11,294
661470511,310,18,6,8,2,6,15,365
661470512,156,12,0,1,7,0,10,186
661470513,254,10,0,8,0,2,5,279
661470514,249,3,0,9,0,2,27,290
661470515,211,13,0,3,0,1,4,232
661540101,35,4,0,0,0,0,5,44
661540102,66,3,0,0,0,0,21,90
661540103,26,12,0,1,0,0,2,41
661540104,1,1,0,0,0,0,0,2
661540105,102,24,0,0,0,0,5,131
661540106,173,71,0,10,0,6,13,273
661540201,39,12,0,0,0,2,7,60
661540202,19,3,0,0,3,2,8,35
661540203,48,6,0,1,0,1,5,61
661540204,26,22,0,6,1,11,3,69
661540205,11,8,0,0,0,1,8,28
661540206,39,0,0,0,0,2,22,63
661540207,47,5,0,0,0,4,2,58
661540208,100,8,1,6,1,13,23,152
661540209,247,50,2,2,0,14,19,334
661540210,248,31,1,36,5,8,22,351
661540211,188,61,6,4,7,37,13,316
661610101,61,13,0,0,0,4,11,89
661610102,199,27,0,0,1,44,57,328
661610103,238,39,4,0,0,1,18,300
661610104,56,3,0,0,1,17,106,183
661610105,140,40,0,0,0,2,28,210
661610106,48,3,0,0,0,1,20,72
661610107,67,25,0,0,0,2,10,104
661610108,47,43,0,0,0,0,5,95
661610109,87,106,0,0,0,2,27,222
661610110,266,71,1,9,4,5,22,378
661610201,90,9,0,3,0,2,11,115
661610202,95,20,0,3,1,0,23,142
661610203,73,60,0,5,0,7,19,164
661610204,48,19,0,6,0,1,7,81
661610205,255,24,1,2,7,6,16,311
661610301,75,33,0,0,0,2,50,160
661610302,108,45,0,5,0,7,32,197
661610303,40,2,1,0,0,16,27,86
661610304,182,54,0,3,0,0,44,283
661610305,50,38,1,0,0,3,19,111
661610306,203,37,4,10,0,17,25,296
700070101,307,11,2,2,0,1,3,326
700070102,355,23,1,14,3,9,6,411
700070103,293,8,4,79,1,16,43,444
700070104,248,10,2,1,2,1,6,270
700070201,279,14,3,23,7,0,6,332
700070202,221,5,0,5,0,9,9,249
700070203,192,4,1,9,0,9,9,224
700070204,408,17,2,0,0,4,7,438
700070205,422,14,2,2,1,5,13,459
700070206,260,6,1,5,0,1,9,282
700070207,151,4,0,2,0,3,5,165
700070301,363,23,0,4,0,7,17,414
700070302,197,7,1,11,2,3,11,232
700070303,111,5,0,1,0,4,9,130
700070304,178,0,0,3,0,5,5,191
700070305,56,3,0,4,1,3,4,71
700070306,239,9,1,1,2,0,3,255
700070307,284,15,3,39,0,0,2,343
700070308,223,3,0,0,0,0,9,235
700070401,150,17,1,2,1,2,10,183
700070402,128,9,0,4,1,2,8,152
700070403,294,14,1,4,0,8,9,330
700070501,39,5,0,1,0,3,23,71
700140101,110,9,0,1,0,2,6,128
700140102,133,5,0,2,0,9,9,158
700140103,320,13,1,0,2,1,22,359
700140104,207,22,0,13,0,7,6,255
700140105,218,14,3,10,1,6,21,273
700140106,294,14,0,7,12,2,24,353
700140107,393,11,0,11,0,4,17,436
700140201,71,0,0,0,0,3,8,82
700140202,117,18,0,1,0,6,8,150
700140301,15,0,0,0,0,1,16,32
700210101,85,27,0,0,1,3,20,136
700210201,285,34,8,7,3,11,14,362
700210202,48,1,0,2,0,1,6,58
700210203,261,17,3,9,2,17,38,347
700210204,50,7,0,0,0,0,4,61
700210205,13,1,2,2,0,1,2,21
700210301,92,4,1,1,0,12,11,121
700210302,231,19,4,34,3,16,21,328
700210401,257,41,11,17,16,32,21,395
700210402,37,3,0,4,1,8,23,76
700210403,283,36,10,10,1,72,14,426
700210404,305,53,1,11,3,63,40,476
700210405,39,1,1,1,0,2,2,46
700210501,10,0,0,0,0,6,2,18
700210601,10,2,0,0,0,0,4,16
700210701,9,7,0,0,0,1,1,18
700210702,1,0,0,0,0,0,9,10
700280101,281,2,9,5,47,1,18,363
700280102,239,8,22,4,30,3,18,324
700280103,234,17,22,2,49,0,32,356
700280104,217,14,21,3,75,2,27,359
700280105,108,9,8,1,44,4,21,195
700280106,239,22,11,4,56,0,34,366
700280107,154,18,8,3,24,1,15,223
700280108,216,48,43,0,2,0,11,320
700280109,157,26,8,2,36,2,9,240
700280110,228,45,7,2,34,1,39,356
700280111,206,32,12,4,24,0,15,293
700280112,228,52,16,1,87,0,28,412
700280113,128,26,1,4,10,0,24,193
700280114,230,28,58,0,53,1,15,385
700280115,143,27,19,2,59,2,27,279
700280116,201,27,42,2,5,0,10,287
700280117,161,23,19,1,13,1,39,257
700280118,179,34,24,2,53,3,15,310
700280201,251,9,2,9,2,0,9,282
700280202,261,11,4,4,0,0,10,290
700280203,327,20,0,3,1,0,6,357
700280204,176,11,2,12,0,0,5,206
700280205,190,18,2,2,1,0,4,217
700280206,200,9,0,1,1,0,0,211
700280207,195,12,1,0,0,1,7,216
700280208,175,8,1,2,1,1,6,194
700280209,231,33,8,1,1,1,2,277
700280210,258,23,5,0,1,0,6,293
700280211,180,16,1,5,0,0,6,208
700280212,131,9,2,2,1,0,8,153
700280213,178,11,2,0,2,0,2,195
700280301,209,2,1,3,1,0,7,223
700280302,194,10,2,43,1,0,4,254
700280303,311,18,2,1,1,0,8,341
700280304,301,14,6,2,1,0,2,326
700280305,271,21,4,0,5,0,4,305
700280306,274,46,12,1,3,2,11,349
700280307,180,23,3,2,0,0,15,223
700280308,244,17,1,0,8,0,20,290
700280309,278,21,6,1,2,2,8,318
700280310,163,11,3,0,9,0,20,206
700280311,175,8,3,2,5,0,5,198
700280312,155,14,2,3,3,0,8,185
700280313,284,34,10,5,4,0,11,348
700280314,190,11,5,2,1,0,13,222
700280315,143,16,15,4,2,0,9,189
700280316,294,48,8,6,9,2,22,389
700280317,187,16,10,1,4,1,17,236
700280318,274,11,0,0,0,0,3,288
700280319,198,16,15,2,3,0,10,244
700280320,157,22,5,5,13,1,12,215
700280321,180,46,14,0,3,0,10,253
700280401,130,14,5,0,4,0,9,162
700280402,175,3,10,3,1,0,11,203
700280403,224,20,4,2,5,0,3,258
700280404,148,15,5,2,9,0,15,194
700280405,279,26,5,3,9,0,5,327
700280406,273,32,5,2,3,0,13,328
700280407,229,27,21,4,28,3,24,336
700280408,273,37,6,5,6,0,4,331
700280409,163,6,12,0,1,0,9,191
700280410,228,18,4,3,0,0,6,259
700280411,167,10,4,3,2,0,3,189
700280412,286,25,11,7,6,0,8,343
700280413,228,25,4,6,2,0,8,273
700280414,261,23,3,0,0,0,10,297
700280501,292,6,9,2,6,2,13,330
700280502,299,37,17,8,10,0,7,378
700280503,157,10,5,5,5,0,4,186
700280504,288,29,0,10,3,0,9,339
700280505,139,29,17,1,11,0,14,211
700280506,318,33,10,7,5,1,4,378
700280507,177,15,2,4,0,1,8,207
700280508,206,15,8,2,2,1,6,240
700280509,182,8,0,2,4,0,3,199
700280510,200,17,6,13,2,0,1,239
700280511,287,24,2,0,0,0,4,317
700280512,205,40,19,3,2,3,29,301
700280513,223,14,2,0,1,0,6,246
700280514,148,25,15,4,3,2,2,199
700280515,185,10,6,4,12,1,4,222
700280516,190,6,3,8,16,0,12,235
700280601,276,11,1,0,1,0,3,292
700280602,289,10,0,1,0,0,15,315
700280603,205,8,5,0,4,0,2,224
700280604,221,8,17,4,2,0,1,253
700280605,299,31,4,3,0,0,11,348
700280606,141,9,2,3,0,0,2,157
700280607,212,28,2,1,1,0,4,248
700280608,293,14,2,5,3,0,18,335
700280609,263,40,15,5,8,2,14,347
700280610,174,24,6,5,5,0,6,220
700280611,226,13,3,5,4,0,19,270
700280612,264,20,10,0,1,0,5,300
700280613,285,36,22,4,40,1,16,404
700280614,210,12,8,0,1,0,15,246
700280615,217,4,7,33,1,0,3,265
700280616,142,16,4,3,5,1,11,182
700280617,281,19,2,2,0,1,4,309
700280618,230,15,0,0,1,0,8,254
700280619,129,12,11,0,1,0,5,158
700280701,292,58,12,1,12,0,12,387
700280702,237,48,21,4,1,0,11,322
700280703,268,28,4,2,10,2,19,333
700280704,307,13,4,4,9,0,15,352
700280705,276,35,15,3,9,0,16,354
700280706,206,34,12,3,7,0,17,279
700280707,266,15,1,5,5,0,10,302
700280708,282,18,8,6,7,0,13,334
700280709,282,20,7,2,1,0,8,320
700280710,225,28,7,0,2,1,8,271
700280711,283,5,1,3,2,0,11,305
700280712,316,19,5,6,5,0,4,355
700280713,166,6,1,0,0,1,10,184
700280714,254,16,6,6,3,4,4,293
700280715,247,28,8,0,6,1,9,299
700280716,141,18,13,1,4,0,5,182
700280801,213,11,1,10,0,0,2,237
700280802,182,24,1,5,2,0,0,214
700280803,198,18,7,3,2,0,13,241
700280804,157,6,4,0,0,0,8,175
700280805,217,16,2,4,2,0,9,250
700280806,264,20,2,3,0,1,6,296
700280807,244,12,4,3,4,0,17,284
700280808,173,12,9,0,7,0,12,213
700280809,304,40,7,2,3,0,5,361
700280810,279,24,6,2,5,0,11,327
700280811,177,13,18,0,6,1,5,220
700280901,325,49,55,5,17,2,7,460
700280902,291,29,32,4,17,0,12,385
700280903,198,20,18,3,2,0,12,253
700280904,167,14,0,0,3,0,14,198
700280905,250,34,3,1,9,2,29,328
700280906,147,16,20,5,7,1,3,199
700280907,206,19,7,1,6,0,9,248
700280908,302,18,7,2,2,0,15,346
700280909,241,18,1,0,1,1,3,265
700280910,246,39,22,8,5,2,4,326
700280911,80,10,1,0,1,0,5,97
700280912,148,11,7,0,2,0,3,171
700280913,146,7,3,0,6,0,7,169
700280914,174,4,4,1,1,0,8,192
700280915,294,19,6,1,1,0,3,324
700280916,275,13,2,2,3,0,8,303
700350101,302,7,0,1,1,1,1,313
700350102,273,12,0,4,0,0,3,292
700350103,297,7,2,1,0,0,1,308
700350104,245,15,1,2,6,0,8,277
700350105,292,15,1,0,0,1,6,315
700350106,279,11,0,0,0,1,4,295
700350107,220,4,2,0,0,1,1,228
700350108,276,3,0,0,1,0,2,282
700350109,247,4,1,2,1,1,3,259
700350110,240,11,0,3,0,1,14,269
700350111,307,20,5,6,9,0,11,358
700350112,291,13,3,1,2,2,3,315
700350113,241,15,0,0,2,0,7,265
700350114,344,11,2,2,1,1,12,373
700350201,228,6,0,2,0,2,4,242
700350202,121,17,0,2,0,1,10,151
700350203,235,8,1,3,1,15,18,281
700350204,156,7,0,2,0,7,10,182
700350205,174,19,1,0,0,3,3,200
700350301,251,11,0,3,2,4,8,279
700350302,240,11,0,1,0,2,5,259
700350401,96,6,0,2,0,0,8,112
700350402,228,5,0,1,1,2,4,241
700350403,202,7,0,1,0,8,10,228
700350501,113,26,0,0,1,0,6,146
700350502,65,1,1,0,0,0,0,67
700350503,94,9,9,1,0,1,6,120
700350601,24,14,2,0,0,0,0,40
700350602,65,4,0,0,0,0,2,71
700350701,190,1,0,0,1,1,3,196
700350702,378,17,2,0,1,0,6,404
700350703,214,3,0,0,1,0,3,221
700350704,226,16,2,2,1,1,4,252
700350705,289,20,4,0,0,2,8,323
700350706,205,13,0,0,0,0,2,220
700350707,250,13,0,0,0,2,6,271
700350708,220,1,0,0,0,1,3,225
700350709,278,15,1,0,0,1,5,300
700350710,219,3,0,7,0,0,12,241
700350711,237,5,0,12,0,0,7,261
700420101,176,1,0,0,0,0,10,187
700420102,363,1,0,1,0,0,3,368
700420103,230,3,0,0,2,0,2,237
700420104,336,4,0,0,0,0,3,343
700420105,316,11,0,2,0,0,0,329
700420106,355,5,0,0,1,0,1,362
700420107,186,1,0,0,0,0,1,188
700420108,235,6,1,0,0,0,1,243
700420109,225,4,0,1,0,0,3,233
700420110,246,8,1,3,2,0,3,263
700420111,152,5,0,0,0,0,0,157
700420112,191,5,1,0,0,0,10,207
700420201,355,13,8,6,1,3,5,391
700420202,189,2,0,0,0,0,101,292
700420203,321,5,1,0,1,0,5,333
700420204,424,3,0,1,0,0,6,434
700420205,232,5,1,3,1,0,2,244
700420206,294,9,2,15,2,2,2,326
700420207,453,18,5,3,0,1,5,485
700420208,190,10,0,0,0,0,4,204
700420209,338,10,1,0,1,0,2,352
700420210,296,12,0,1,3,0,1,313
700420211,191,13,1,3,2,0,13,223
700420212,346,15,0,0,0,0,8,369
700420213,309,4,2,4,12,0,11,342
700420214,248,9,5,1,1,0,2,266
700420215,190,8,2,1,0,0,7,208
700420216,311,12,2,4,0,0,15,344
700420217,302,2,0,12,0,0,8,324
700420301,213,9,0,3,0,0,7,232
700420302,289,29,0,9,1,3,13,344
700420303,267,7,0,4,4,10,14,306
700420304,46,15,0,0,0,4,5,70
700420401,250,15,2,98,0,0,45,410
700420402,469,17,0,0,1,0,8,495
700420403,195,2,1,0,1,0,2,201
700420404,312,10,2,1,2,0,6,333
700420405,277,4,2,0,0,0,0,283
700420406,323,3,0,2,0,0,5,333
700420407,317,6,0,0,0,0,2,325
700420408,193,3,0,0,0,0,2,198
700420409,174,6,1,0,0,0,2,183
700420410,232,12,1,2,0,0,2,249
700420411,217,9,1,9,1,0,1,238
700420412,338,10,3,14,2,2,15,384
700420413,341,20,1,0,0,0,5,367
700420414,387,10,0,2,0,1,9,409
700420415,257,11,3,4,3,0,2,280
700420416,318,17,4,6,1,3,14,363
700420417,370,14,1,4,0,1,4,394
700420418,183,8,1,0,1,1,0,194
700420419,161,8,0,0,2,0,0,171
700420501,357,10,2,4,1,0,5,379
700420502,289,6,5,6,5,2,11,324
700420503,208,17,2,3,0,0,9,239
700420504,303,12,1,0,0,0,4,320
700420505,345,7,0,3,0,0,1,356
700420506,326,7,0,1,0,0,1,335
700420507,341,5,0,2,2,0,5,355
700420508,282,18,6,2,0,1,1,310
700420509,310,5,0,0,2,0,1,318
700420510,390,14,2,0,4,0,6,416
700420511,238,9,0,0,0,0,10,257
700420512,269,9,2,0,0,0,7,287
700420513,270,13,0,1,3,0,8,295
700420514,364,24,4,3,1,0,5,401
700420515,198,20,2,0,14,0,5,239
700490101,96,0,0,0,0,2,37,135
700490102,24,1,0,0,0,1,14,40
700490201,109,23,0,0,0,2,5,139
700490202,167,20,1,8,0,42,23,261
700490203,244,21,1,11,3,16,21,317
700490204,240,29,11,7,13,43,20,363
700490205,159,35,19,14,2,79,44,352
700490206,82,16,0,3,0,2,8,111
700490207,229,52,18,9,5,36,17,366
700490301,85,20,1,1,0,7,22,136
700490302,166,22,0,5,2,5,28,228
700490303,71,18,1,9,0,45,34,178
700490401,8,4,0,0,0,0,2,14
700560101,164,7,1,7,2,7,25,213
700560102,256,24,0,5,0,13,46,344
700560103,157,3,1,3,1,9,29,203
700560104,200,2,1,4,0,7,39,253
700560105,329,9,0,8,5,1,26,378
700560106,115,4,0,5,0,0,4,128
700560107,80,5,0,3,0,1,13,102
700560108,137,20,0,6,0,3,6,172
700560109,174,15,0,3,0,3,23,218
700560201,243,17,2,2,0,1,15,280
700560202,232,12,7,2,9,1,11,274
700560203,270,24,2,3,19,1,14,333
700560204,122,24,0,2,36,1,17,202
700560205,243,24,2,3,4,1,9,286
700560206,260,22,1,5,0,1,5,294
700560207,178,21,3,4,3,1,10,220
700560208,253,22,0,1,0,0,16,292
700560209,211,21,2,12,0,7,13,266
700560210,47,6,0,2,0,1,3,59
700560211,272,14,4,7,4,1,37,339
700560212,203,36,0,7,0,0,26,272
700560213,182,13,0,0,0,1,9,205
700560301,125,11,0,6,1,11,17,171
700560302,242,20,0,6,0,1,21,290
700560401,22,2,0,0,0,0,8,32
700560501,9,0,0,1,0,0,8,18
700560601,65,32,0,3,0,50,19,169
700560701,154,13,1,2,1,1,82,254
700560702,51,8,0,0,0,9,8,76
700630101,111,3,1,25,0,1,6,147
700630102,165,7,0,1,0,2,10,185
700630103,356,21,1,7,1,1,8,395
700630104,60,0,0,0,0,3,12,75
700630105,33,0,0,0,0,2,3,38
700630106,257,3,1,23,0,0,9,293
700630201,44,3,0,0,0,13,14,74
700630202,300,6,0,9,0,3,9,327
700630203,273,13,1,27,3,0,4,321
700630204,230,4,0,1,0,4,12,251
700630205,236,10,1,2,4,0,4,257
700700101,231,0,1,2,0,10,34,278
700700102,353,9,2,3,0,5,16,388
700700103,372,19,0,8,0,8,20,427
700700104,241,11,2,5,0,0,7,266
700700105,286,15,0,3,2,0,13,319
700700106,245,11,0,2,5,0,3,266
700700107,245,6,1,0,0,2,4,258
700700108,240,11,1,4,0,0,9,265
700700109,243,17,2,2,1,0,4,269
700700110,197,6,6,3,11,1,9,233
700700111,197,13,3,1,6,1,11,232
700700112,263,10,3,0,0,0,10,286
700700113,300,14,3,7,0,1,10,335
700700114,403,49,0,6,3,28,26,515
700700115,328,38,0,2,0,3,148,519
700700201,65,1,0,1,0,6,11,84
700700202,105,12,0,1,0,3,8,129
700700203,322,24,1,6,0,7,19,379
700700204,190,3,0,3,0,10,19,225
700700205,229,15,1,2,2,4,1,254
700700206,487,19,2,5,7,6,13,539
700700207,499,23,0,5,1,8,18,554
700700301,179,22,1,1,0,3,12,218
700700302,229,9,0,0,1,0,4,243
700700303,217,25,0,5,0,6,12,265
700700304,280,9,0,1,1,0,5,296
700700305,121,2,0,2,1,0,17,143
700700401,39,5,0,1,0,3,17,65
700700501,277,17,0,2,0,2,8,306
700700502,239,18,1,2,1,0,4,265
700700503,240,8,0,4,0,1,1,254
700700504,155,11,0,93,0,0,18,277
700700505,231,10,0,0,0,0,4,245
700700506,284,6,1,3,3,0,4,301
700700507,270,5,0,3,0,0,5,283
700700508,256,3,1,1,0,0,5,266
700700509,265,8,2,0,2,1,2,280
700700510,294,13,1,3,0,0,7,318
700700511,378,10,0,9,1,0,6,404
700700512,350,11,1,10,0,0,9,381
700700513,283,5,4,0,7,0,27,326
700700514,352,17,4,4,5,2,8,392
700700515,280,9,5,3,0,0,9,306
700700516,361,13,1,0,0,0,5,380
700700517,265,47,0,71,0,0,7,390
700700518,195,16,2,4,1,4,6,228
700770101,154,0,0,5,0,1,5,165
700770102,423,1,1,0,0,1,2,428
700770103,3,0,1,285,0,0,8,297
700770104,267,0,0,40,0,0,8,315
700770105,231,1,0,23,0,0,22,277
700770106,211,4,1,0,0,0,4,220
700770201,323,5,2,3,3,2,14,352
700770202,357,9,3,1,1,0,7,378
700770203,266,4,2,4,4,0,1,281
700770204,324,5,0,0,0,0,14,343
700770205,289,5,0,1,0,0,3,298
700770206,320,23,0,0,0,0,13,356
700770207,296,14,2,1,3,0,12,328
700770208,362,5,1,0,0,0,5,373
700770209,289,14,3,0,0,2,6,314
700770210,174,9,0,0,2,0,5,190
700770211,263,16,0,0,0,0,8,287
700770212,201,1,1,0,0,0,1,204
700770213,215,5,1,2,0,0,1,224
700770301,237,19,3,2,17,0,4,282
700770302,266,9,4,0,0,0,5,284
700770303,260,11,1,0,0,0,1,273
700770304,315,18,0,0,1,0,4,338
700770305,235,11,5,0,1,0,6,258
700770306,336,9,3,0,1,0,5,354
700770307,363,5,2,3,1,0,12,386
700770308,222,9,0,9,1,0,0,241
700770309,272,12,0,2,1,0,4,291
700770310,341,15,1,1,2,0,8,368
700770311,290,14,7,2,2,1,6,322
700770312,188,14,0,1,0,0,4,207
700770313,217,9,1,4,2,1,9,243
700770401,182,10,1,2,0,0,7,202
700770402,171,14,3,0,1,0,10,199
700770403,194,8,4,1,0,0,5,212
700770404,236,15,1,14,3,0,4,273
700770405,250,13,8,1,1,0,13,286
700770406,284,13,6,3,0,2,7,315
700770407,242,18,2,4,0,1,6,273
700770408,218,14,3,0,2,0,3,240
700770409,185,12,3,1,0,0,2,203
700770410,332,19,1,2,2,2,7,365
700770411,192,9,1,2,2,0,3,209
700770412,319,10,4,4,2,1,6,346
700770413,195,12,1,2,3,0,6,219
700770414,171,9,4,0,9,0,5,198
700770415,175,8,0,0,0,0,2,185
700770416,190,3,3,0,0,0,15,211
700770501,270,16,0,0,0,0,10,296
700770502,282,25,0,7,0,11,21,346
700770503,207,21,1,0,0,0,3,232
700770504,108,1,0,1,1,1,10,122
700770505,203,6,2,1,0,0,3,215
700770506,112,3,0,1,0,0,0,116
700770507,278,28,1,12,0,2,6,327
700770508,212,17,0,7,1,1,22,260
700770509,151,5,0,0,1,2,7,166
700770510,325,5,0,0,0,0,64,394
700770511,354,32,2,18,0,2,7,415
700770512,293,11,0,29,0,1,5,339
700770601,306,19,3,5,0,43,10,386
700770602,256,20,2,9,0,22,24,333
700770603,135,5,0,1,1,2,1,145
700770701,214,23,3,17,1,9,19,286
700770702,175,11,0,1,1,14,24,226
700770703,137,9,0,3,0,14,18,181
700770801,144,9,2,0,4,0,1,160
700770802,151,6,1,2,1,0,5,166
700770803,376,7,7,1,1,0,17,409
700770804,207,7,0,1,2,0,2,219
700770805,259,6,2,1,0,0,6,274
700770806,352,4,1,8,0,2,10,377
700770807,189,15,0,3,1,0,5,213
700770808,213,7,0,0,0,0,1,221
700770809,310,12,5,2,1,0,2,332
700770810,388,34,5,8,0,0,6,441
700770811,233,28,0,1,0,0,2,264
700770812,257,6,0,0,0,0,1,264
700770813,330,10,6,10,5,0,8,369
700770814,254,9,1,4,1,1,2,272
700770815,258,5,3,1,0,0,7,274
700770901,258,20,5,9,0,0,6,298
700770902,236,18,6,0,31,0,7,298
700770903,251,21,2,3,10,2,6,295
700770904,274,27,2,0,1,1,3,308
700770905,375,3,0,0,0,0,1,379
700770906,216,2,1,0,0,0,1,220
700770907,229,4,2,0,0,0,2,237
700770908,231,5,0,0,0,0,5,241
700770909,229,5,0,0,0,0,0,234
700770910,294,14,1,2,1,1,14,327
700770911,303,3,6,0,0,0,11,323
700770912,243,9,1,2,2,0,6,263
700771001,186,15,6,6,2,2,4,221
700771002,357,7,10,2,1,0,6,383
700771003,199,18,3,2,1,0,7,230
700771004,274,17,2,12,6,0,6,317
700771005,293,23,3,0,0,2,6,327
700771006,268,7,2,1,0,0,1,279
700771007,293,5,4,16,1,0,8,327
700771008,205,5,1,1,1,0,3,216
700771009,184,2,3,3,1,0,7,200
700771010,271,20,3,2,1,0,2,299
700771011,186,12,3,8,3,2,5,219
700771012,193,9,1,0,1,0,1,205
700771013,298,9,4,5,3,1,3,323
700840101,12,1,0,0,1,0,2,16
700840102,61,0,0,0,0,0,3,64
700840201,262,10,0,0,0,0,5,277
700840202,194,0,0,0,0,0,3,197
700840203,253,16,1,0,0,1,9,280
700840204,265,17,0,3,1,0,9,295
700840205,232,16,2,6,5,2,6,269
700840206,230,13,4,6,1,0,4,258
700840207,235,9,3,0,0,0,11,258
700840208,311,19,1,8,3,3,12,357
700840209,251,9,1,22,1,3,6,293
700840210,329,22,1,3,1,2,5,363
700840211,350,22,10,5,0,0,13,400
700840212,374,31,9,3,5,1,11,434
700840213,211,2,2,0,1,0,3,219
700840214,190,7,1,2,0,4,5,209
700840215,298,10,9,28,2,1,11,359
700840216,232,16,0,0,0,0,2,250
700840217,231,11,0,1,2,1,7,253
700840301,332,30,4,0,4,0,3,373
700840302,292,7,2,7,1,0,16,325
700840303,284,19,3,0,1,0,2,309
700840304,259,11,0,2,0,0,5,277
700840305,468,33,10,50,5,4,13,583
700840306,343,19,6,5,10,0,13,396
700840307,378,16,6,40,2,0,13,455
700840308,349,17,2,2,0,0,11,381
700840309,308,31,4,1,0,0,24,368
700840310,338,8,4,0,0,0,6,356
700840311,335,17,1,0,0,0,5,358
700840312,327,19,1,2,1,0,5,355
700840313,251,9,1,0,0,0,4,265
700840314,243,20,1,0,0,0,0,264
700840315,303,23,1,2,0,1,15,345
700840316,274,14,4,1,2,0,10,305
700840317,207,4,0,0,0,0,2,213
700840318,197,1,2,0,0,1,8,209
700840319,245,3,3,16,1,2,15,285
700840320,259,18,5,4,5,0,20,311
700840401,440,43,27,101,2,0,21,634
700840402,213,10,1,2,1,0,3,230
700840403,295,13,3,4,1,0,9,325
700840404,220,15,3,1,1,0,8,248
700840405,327,32,6,5,1,1,10,382
700840406,181,7,3,1,5,1,2,200
700840407,186,11,2,0,1,0,4,204
700840408,257,12,3,0,0,0,3,275
700840409,263,5,1,0,0,0,4,273
700840410,262,20,0,0,0,2,7,291
700840411,185,13,0,0,1,1,13,213
700840412,328,14,7,7,7,0,8,371
700840413,199,17,2,2,0,0,5,225
700840414,149,6,7,4,2,0,8,176
700840415,199,12,1,0,0,0,1,213
700840416,213,8,3,4,3,0,5,236
700840417,196,7,3,18,2,0,3,229
700840501,303,25,3,3,0,5,5,344
700840502,223,22,0,0,0,0,8,253
700840503,384,4,2,3,0,0,0,393
700840504,535,52,4,9,0,0,63,663
700840505,187,1,0,52,0,0,0,240
700840506,198,6,0,79,0,0,2,285
700840601,296,28,4,2,4,1,9,344
700840602,365,43,0,11,3,0,10,432
700840603,209,10,1,0,0,2,0,222
700840604,326,14,1,0,0,0,4,345
700840605,253,9,3,2,4,0,6,277
700840606,282,11,4,1,0,0,6,304
700840607,262,13,0,1,0,2,3,281
700840608,277,14,6,0,1,0,6,304
700840609,226,15,7,9,0,0,5,262
700840610,428,9,0,0,3,0,4,444
700840611,281,9,0,0,0,1,14,305
700840612,272,4,3,6,0,0,2,287
700840613,144,11,0,0,9,0,2,166
700910101,204,9,1,1,2,8,15,240
700910102,217,6,1,5,1,5,6,241
700910103,100,4,0,0,0,2,14,120
700910104,277,14,1,3,2,2,14,313
700910105,67,10,0,2,0,1,13,93
700910106,104,3,0,0,0,3,11,121
700910107,134,13,0,0,0,1,11,159
700910108,83,6,0,4,1,2,20,116
700910109,249,8,1,2,1,0,1,262
700910110,79,7,2,2,0,1,6,97
700910111,137,1,0,1,0,1,3,143
700910112,300,14,1,4,2,2,6,329
700910113,243,7,2,0,0,0,3,255
700910114,268,5,0,1,1,0,5,280
700910201,15,1,0,0,0,0,5,21
700980101,274,11,2,2,3,0,7,299
700980102,212,1,0,61,0,0,0,274
700980103,248,6,0,3,0,0,1,258
700980104,273,5,1,2,2,1,3,287
700980105,246,12,2,2,0,0,5,267
700980106,334,23,5,1,3,0,9,375
700980107,248,6,1,3,0,0,3,261
700980108,269,11,9,0,1,3,8,301
700980109,327,11,3,2,1,2,11,357
700980110,275,8,2,5,4,0,3,297
700980111,268,19,1,1,0,0,5,294
700980112,270,15,6,14,8,1,24,338
700980113,208,7,5,1,1,0,7,229
700980114,212,4,4,9,4,0,2,235
700980115,223,10,5,0,2,0,8,248
700980116,394,12,0,6,0,1,8,421
700980117,171,3,0,169,0,2,9,354
700980118,282,3,2,60,0,1,4,352
700980201,330,0,0,4,0,6,8,348
700980202,168,3,0,1,0,3,8,183
700980203,180,5,0,0,0,1,4,190
700980204,145,11,1,6,1,3,15,182
700980205,349,19,8,9,3,12,12,412
700980206,308,0,1,2,0,2,15,328
700980207,329,16,2,31,0,2,6,386
700980301,404,24,1,2,3,0,3,437
700980302,266,7,1,1,0,0,2,277
700980303,161,10,0,7,1,0,3,182
700980304,268,15,3,3,3,0,6,298
700980305,276,12,2,1,1,1,4,297
700980306,201,9,1,2,1,9,9,232
700980307,343,12,2,2,4,5,27,395
700980308,255,19,0,6,4,1,16,301
700980401,411,22,3,1,3,1,15,456
700980402,237,18,6,4,1,6,16,288
700980403,272,20,10,4,3,4,7,320
700980404,260,23,5,4,6,0,15,313
700980405,207,23,4,3,5,0,4,246
700980406,204,17,2,5,5,1,10,244
700980407,141,17,1,0,1,0,7,167
700980408,128,11,4,0,0,2,2,147
700980409,217,20,4,9,0,1,4,255
700980410,140,12,9,2,13,0,8,184
700980411,188,19,1,1,1,0,6,216
700980412,169,35,0,0,2,1,5,212
701050101,81,3,0,1,0,0,3,88
701050102,157,16,0,2,0,4,6,185
701050103,98,6,1,0,0,0,5,110
701050104,124,11,1,2,1,6,11,156
701050105,130,14,5,5,0,45,12,211
701050106,230,8,3,10,1,4,14,270
701050107,353,18,1,4,2,2,20,400
701050108,281,18,1,5,12,2,7,326
701050201,425,18,1,4,0,2,40,490
701050202,452,19,0,3,3,1,20,498
701050203,195,12,0,3,1,4,13,228
701050301,274,9,2,4,8,2,21,320
701050302,395,14,0,1,1,1,13,425
701050303,387,9,2,2,0,7,40,447
701050304,187,4,0,2,0,11,27,231
701050305,252,11,1,0,1,4,23,292
701050306,299,15,1,5,1,0,14,335
701050307,290,21,1,3,5,0,7,327
701050308,220,10,0,4,0,1,12,247
701120101,178,21,3,7,1,9,24,243
701120102,351,26,1,28,4,11,15,436
701120103,126,17,0,2,3,54,31,233
701120104,235,14,0,1,0,2,9,261
701120105,284,16,0,26,1,7,12,346
701120201,15,0,0,0,0,0,3,18
701190101,61,10,0,1,0,1,7,80
701190102,88,0,0,0,0,1,34,123
701190103,32,19,0,1,1,0,16,69
701190201,266,35,8,13,2,9,15,348
701190202,414,47,3,9,0,15,9,497
701190203,56,1,0,3,0,0,10,70
701190204,28,1,0,0,0,4,6,39
701190205,115,33,0,7,0,10,16,181
701190206,228,34,8,7,11,7,8,303
701190207,209,18,8,3,7,30,23,298
701190301,67,13,0,0,0,4,16,100
701190302,65,14,0,0,1,6,8,94
701190303,163,38,1,9,1,23,16,251
701260101,343,7,5,2,0,0,5,362
701260102,231,10,0,3,1,6,21,272
701260103,238,12,0,2,1,2,0,255
701260104,290,21,1,40,3,4,25,384
701260105,188,18,0,2,0,1,13,222
701260106,216,10,1,1,0,0,9,237
701260107,249,3,0,3,1,0,5,261
701260201,298,9,0,3,1,0,1,312
701260202,258,5,0,0,0,1,7,271
701260203,239,10,1,2,0,0,8,260
701260204,181,13,0,3,0,5,13,215
701260205,112,8,0,0,0,1,13,134
701260206,193,12,2,0,3,0,5,215
701260207,139,7,1,0,0,0,6,153
701260208,206,18,0,8,0,0,7,239
701260301,265,36,1,1,1,2,17,323
701260401,58,2,0,0,0,0,3,63
701330101,146,5,0,18,1,132,8,310
701330102,504,28,2,6,3,9,13,565
701330103,364,12,0,2,0,3,13,394
701330104,83,7,1,14,0,64,19,188
701330201,4,19,0,0,0,0,0,23
740070101,47,7,0,9,0,4,0,67
740070102,70,6,0,0,0,0,11,87
740070201,65,4,0,1,0,5,6,81
740070202,55,5,0,0,0,7,4,71
740070203,54,0,0,1,0,4,7,66
740070301,11,8,0,0,0,0,0,19
740070302,24,4,0,1,0,0,5,34
740070303,43,2,0,1,0,2,7,55
740070304,346,31,2,6,0,4,27,416
740070305,301,27,5,0,0,5,13,351
740070306,41,13,0,1,1,0,5,61
740070307,15,3,0,0,0,2,1,21
740070401,116,24,0,0,1,0,9,150
740070402,289,17,0,0,0,2,6,314
740070403,141,19,1,0,0,2,5,168
740070404,229,44,0,13,11,4,4,305
740070405,258,29,4,7,8,4,7,317
740070406,215,41,6,12,4,4,4,286
740070407,205,35,4,8,1,2,3,258
740070408,262,24,5,11,1,7,4,314
740070409,170,13,7,11,1,10,3,215
740070410,208,22,2,6,3,10,3,254
740070411,63,22,1,0,2,4,6,98
740070412,8,3,0,0,0,0,1,12
740070413,299,25,6,1,0,16,17,364
740070414,313,65,1,17,3,24,11,434
740070501,21,4,0,0,0,0,2,27
740070502,21,2,0,0,0,3,6,32
740070503,12,0,0,0,0,4,4,20
740070504,110,19,0,0,0,1,26,156
740070505,69,7,1,1,0,15,26,119
740070506,76,19,0,3,0,8,4,110
740070507,356,51,4,10,0,21,25,467
740070508,292,39,2,5,0,7,27,372
740070509,249,31,2,9,3,20,19,333
740070510,207,25,2,8,0,16,18,276
740140101,8,1,0,0,0,0,0,9
740140102,46,5,1,1,0,1,1,55
740140103,26,0,0,0,0,1,1,28
740140201,8,0,0,0,0,0,5,13
740140202,20,2,0,0,0,9,2,33
740140203,25,16,0,0,0,1,1,43
740140204,14,0,0,0,0,0,11,25
740140301,34,5,0,0,0,0,8,47
740140302,37,13,0,2,0,8,9,69
740140303,42,2,0,0,0,1,7,52
740140304,51,0,0,1,0,4,4,60
740140401,29,11,0,0,0,6,4,50
740140402,60,30,0,0,0,8,4,102
740140403,205,45,13,14,4,88,24,393
740140404,154,50,1,8,1,20,7,241
740140405,176,4,4,10,7,257,14,472
740140406,25,13,0,1,0,1,8,48
740140501,37,5,0,0,0,5,0,47
740140502,36,3,0,0,0,1,0,40
740140503,155,9,2,7,0,2,8,183
740140504,13,1,0,0,0,0,1,15
740140505,45,4,0,4,0,6,7,66
740210101,16,3,0,0,0,0,0,19
740210102,78,17,1,9,1,18,1,125
740210103,48,24,0,6,0,6,4,88
740210104,26,3,0,1,0,1,0,31
740210105,71,22,9,3,1,69,9,184
740210106,46,35,0,3,0,97,13,194
740210107,78,3,20,11,1,161,22,296
740210108,73,3,8,4,0,171,10,269
740210109,136,49,6,5,3,151,35,385
740210110,89,7,7,1,0,31,3,138
740210111,82,1,0,0,0,4,23,110
740210112,89,26,0,2,4,14,31,166
740210113,14,4,0,0,0,9,3,30
740210201,54,0,0,0,0,4,2,60
740210202,41,0,0,0,0,0,0,41
740210203,104,9,2,0,0,3,5,123
740210204,64,21,2,2,0,10,4,103
740210301,16,10,0,3,0,0,8,37
740210302,37,11,0,0,0,2,0,50
740210303,276,26,5,7,6,1,2,323
740210304,277,38,1,4,7,7,8,342
740210305,415,23,4,6,2,12,12,474
740210306,250,15,3,4,4,2,12,290
740210307,331,30,3,4,1,4,8,381
740210308,378,24,3,2,0,2,2,411
740210309,187,18,0,0,0,0,5,210
740210310,42,9,1,0,0,6,7,65
740210311,29,10,1,0,0,0,1,41
740210401,84,17,0,6,1,8,13,129
740210402,12,2,0,0,0,0,0,14
740210403,26,13,0,0,0,1,1,41
740210404,47,3,0,0,0,0,9,59
740210405,282,14,1,9,1,7,16,330
740210406,36,15,0,0,0,2,5,58
740210407,28,0,0,0,0,7,0,35
740280101,52,9,0,0,0,5,7,73
740280102,317,26,0,10,0,3,4,360
740280103,277,23,0,10,1,1,9,321
740280104,165,9,1,3,0,1,3,182
740280105,158,10,7,6,0,3,52,236
740280106,236,19,7,3,5,1,10,281
740280107,326,21,4,6,4,5,12,378
740280108,60,9,0,1,0,1,2,73
740280109,74,12,0,3,1,5,14,109
740280110,38,13,0,0,0,8,1,60
740280201,73,20,0,0,0,3,6,102
740280202,175,56,31,30,1,23,11,327
740280203,257,118,14,9,2,23,50,473
740280204,87,39,0,1,0,2,18,147
740280205,135,17,9,9,2,18,9,199
740280206,185,32,5,4,0,27,19,272
740280301,127,10,1,3,0,13,1,155
740280302,71,4,1,1,0,6,1,84
740280303,12,0,0,0,1,3,6,22
740280304,73,15,0,3,0,11,8,110
740280305,40,4,0,0,0,4,8,56
740280306,229,25,4,2,9,4,15,288
740280307,22,9,0,0,0,0,11,42
740280308,282,15,1,1,1,5,4,309
740280309,218,14,0,2,2,0,9,245
740280310,272,21,1,17,1,1,7,320
740280311,250,12,4,2,1,0,11,280
740280401,18,13,0,0,0,0,0,31
740280402,152,12,0,2,0,1,10,177
740280403,314,16,1,3,5,7,16,362
740280404,321,19,2,4,2,4,5,357
740280405,376,16,1,6,0,3,12,414
740280406,176,11,0,3,0,2,1,193
740280407,265,17,0,4,1,0,3,290
740280408,253,23,3,6,0,3,5,293
740280409,66,11,0,4,0,4,12,97
740280410,50,0,0,1,0,16,24,91
740280411,16,0,0,0,0,5,3,24
740350101,9,0,0,0,0,0,0,9
740350102,13,6,0,0,0,0,0,19
740350103,84,11,0,5,0,1,2,103
740350104,17,13,0,0,0,2,1,33
740350201,10,5,0,0,0,0,0,15
740350202,6,5,1,0,0,3,1,16
740350203,24,12,0,8,0,26,2,72
740350204,19,9,0,0,0,0,6,34
740350205,13,7,0,0,0,0,0,20
740350301,23,17,0,0,0,3,5,48
740350302,36,7,0,1,1,2,10,57
740350303,20,11,1,0,0,1,3,36
740350304,64,15,0,1,2,5,9,96
740350305,21,3,0,0,0,5,10,39
740350401,22,4,0,1,0,11,8,46
740350402,22,11,0,0,0,0,16,49
740350403,42,17,0,0,0,10,12,81
740350404,37,3,2,1,0,4,2,49
740350405,9,0,0,0,0,0,0,9
740350406,16,6,0,1,0,0,1,24
740350407,153,7,0,3,0,3,2,168
740350501,30,20,0,0,0,1,5,56
740350502,22,6,0,1,0,1,4,34
740350601,65,21,0,6,0,9,0,101
740350602,70,19,0,2,1,11,7,110
740350603,33,15,0,0,0,0,0,48
740350604,12,5,0,0,0,3,0,20
740350605,13,5,0,0,0,0,5,23
740350701,25,1,1,2,1,0,1,31
740350702,193,12,1,3,0,2,1,212
740350703,266,15,1,9,0,0,6,297
740350704,182,10,0,3,0,0,9,204
740350705,159,2,4,5,0,1,20,191
740350706,210,13,2,0,4,0,6,235
740350707,238,7,2,2,0,0,14,263
740350708,272,20,4,9,0,5,3,313
740350709,218,5,4,5,1,1,2,236
740350710,324,8,7,10,1,0,8,358
740350711,235,0,5,1,0,0,4,245
740350712,249,0,0,1,0,0,4,254
740350713,330,6,2,3,1,1,3,346
740350714,264,24,11,9,4,1,6,319
740350715,201,14,9,0,2,1,7,234
740350716,247,18,3,5,0,1,15,289
740350801,235,5,22,8,0,0,1,271
740350802,150,9,2,2,0,0,3,166
740350803,2,0,0,0,0,0,0,2
740350804,340,22,1,5,0,1,11,380
740350805,320,11,0,1,0,0,0,332
740350806,182,20,2,3,1,0,5,213
740350807,137,2,2,2,2,1,1,147
740350808,249,20,5,4,5,3,15,301
740350809,251,9,5,11,4,0,4,284
740350810,253,29,1,2,0,1,6,292
740350811,365,9,0,0,0,0,2,376
740350812,212,4,0,2,1,0,4,223
740350813,195,13,2,1,1,0,5,217
740350814,303,14,8,6,6,0,23,360
740350815,269,32,2,3,0,2,6,314
740350816,231,10,0,5,1,0,7,254
740350817,331,26,3,2,2,0,5,369
740350818,285,12,6,7,0,0,3,313
740350819,303,8,1,16,2,0,8,338
740350820,186,2,1,4,0,1,1,195
740350821,24,1,0,1,0,2,1,29
740350901,189,32,11,3,17,1,12,265
740350902,272,26,5,5,2,0,10,320
740350903,256,18,4,0,0,3,3,284
740350904,274,7,2,4,0,0,3,290
740350905,45,1,0,1,0,0,0,47
740350906,199,7,2,2,0,1,13,224
740350907,342,20,4,6,0,1,4,377
740350908,273,27,14,8,3,1,11,337
740350909,216,59,10,2,25,2,8,322
740350910,323,38,7,8,5,0,13,394
740350911,295,35,10,0,16,1,8,365
740350912,240,39,4,2,3,1,36,325
740350913,263,13,12,5,10,1,10,314
740350914,295,16,6,4,0,0,6,327
740350915,247,9,0,4,0,1,5,266
740350916,259,14,3,1,3,0,2,282
740350917,239,12,4,9,0,5,5,274
740351001,449,16,3,11,0,0,3,482
740351002,203,16,3,0,1,2,16,241
740351003,230,19,3,0,0,0,9,261
740351004,196,31,2,1,1,0,9,240
740351005,431,27,5,7,0,1,5,476
740351006,396,19,0,3,0,0,2,420
740351007,316,7,1,1,0,0,1,326
740351008,281,19,0,0,2,0,4,306
740351009,254,12,0,1,0,0,2,269
740351010,186,6,5,2,0,0,2,201
740351011,277,20,1,1,2,0,4,305
740351012,122,16,3,1,0,0,9,151
740351013,145,26,3,1,1,0,3,179
740351014,158,10,1,0,8,0,6,183
740351015,194,16,1,2,2,0,0,215
740351016,327,42,9,3,4,3,9,397
740351017,180,7,1,3,0,0,2,193
740351018,218,10,7,6,1,1,6,249
740351019,343,12,1,7,2,1,6,372
740351020,42,12,1,6,0,15,0,76
740351101,57,1,0,16,0,11,1,86
740351102,204,16,2,5,0,1,2,230
740351103,231,21,1,1,0,1,8,263
740351104,225,20,5,3,3,0,0,256
740351105,165,21,3,0,1,0,7,197
740351106,211,52,5,4,21,0,18,311
740351107,174,44,39,2,11,0,21,291
740351108,165,15,9,4,4,6,13,216
740351109,162,28,8,1,0,1,10,210
740351110,298,31,5,0,0,0,1,335
740351111,334,10,3,5,1,0,12,365
740351112,336,10,1,2,0,0,6,355
740351113,187,0,0,0,0,0,13,200
740351114,304,7,2,4,0,1,31,349
740351201,278,19,10,6,2,2,6,323
740351202,260,12,13,0,0,0,3,288
740351203,209,23,0,0,0,0,7,239
740351204,209,3,1,0,0,0,22,235
740351205,314,11,3,0,0,0,7,335
740351206,221,7,0,3,0,1,7,239
740351207,212,14,4,7,2,0,3,242
740351208,260,15,2,5,1,0,5,288
740351209,289,7,1,1,0,0,7,305
740351210,327,20,10,5,2,1,10,375
740351211,147,21,14,2,29,1,10,224
740351212,176,44,20,2,15,2,3,262
740351213,148,7,2,1,0,0,4,162
740351214,280,11,0,1,1,0,1,294
740351215,242,11,1,2,0,0,2,258
740351216,220,9,0,2,0,0,3,234
740351217,163,0,1,0,0,0,4,168
740351218,109,5,0,4,0,0,1,119
740351301,279,11,0,0,0,0,2,292
740351302,1,0,0,0,0,0,0,1
740351303,339,38,0,0,1,1,4,383
740351304,279,33,1,1,1,0,5,320
740351305,258,17,0,0,1,8,8,292
740351306,241,17,2,0,2,3,3,268
740351307,38,2,0,0,0,0,0,40
740351308,307,32,0,2,0,2,11,354
740351309,270,16,0,0,0,0,6,292
740351310,262,11,1,0,0,4,5,283
740351311,282,26,1,0,0,0,5,314
740351401,382,3,0,0,0,0,3,388
740351402,16,3,1,4,1,2,0,27
740351403,286,15,1,0,0,0,11,313
740351404,290,17,1,0,0,0,9,317
740351405,216,15,1,2,0,1,2,237
740351406,341,15,0,0,1,0,1,358
740351407,311,9,1,0,0,0,1,322
740351408,344,6,1,0,0,0,5,356
740351409,261,12,1,0,0,1,5,280
740351410,330,13,0,0,0,0,14,357
740351501,11,2,0,0,0,0,4,17
740351502,134,19,2,11,0,12,4,182
740351503,53,12,0,0,0,0,8,73
740351504,72,1,0,13,0,0,53,139
740351505,3,0,0,0,0,0,2,5
740351506,7,4,0,0,0,3,8,22
740351507,19,3,0,0,0,0,0,22
740351601,203,9,2,1,1,4,5,225
740351602,193,14,1,3,0,1,8,220
740351603,195,22,4,0,6,1,9,237
740351604,225,23,4,2,3,0,11,268
740351605,175,9,1,1,0,1,7,194
740351606,138,6,2,3,0,0,2,151
740351607,231,36,1,1,1,0,9,279
740351608,218,20,1,0,0,0,1,240
740351609,248,10,2,0,0,0,7,267
740351610,354,13,0,0,1,2,0,370
740351611,240,9,1,0,2,0,2,254
740351612,258,11,1,0,0,0,2,272
740351701,57,16,0,7,0,13,0,93
740351702,60,21,0,4,0,1,19,105
740351703,20,2,0,1,0,1,4,28
740351704,55,6,0,0,0,2,6,69
740351705,51,30,0,0,0,3,0,84
740351801,49,9,0,0,0,5,3,66
740351802,37,0,0,0,0,0,5,42
740351803,34,3,0,0,0,3,1,41
740351804,17,4,0,0,0,0,5,26
740351805,29,5,0,0,0,3,12,49
740351806,20,1,0,0,0,0,4,25
740420101,18,8,0,0,0,0,5,31
740420102,32,6,0,1,0,0,1,40
740420103,35,28,0,0,0,0,6,69
740420201,23,14,0,0,0,0,1,38
740420202,105,10,0,0,0,0,1,116
740420203,19,9,0,0,0,0,2,30
740420204,120,11,1,3,1,0,7,143
740420205,90,34,0,2,0,0,17,143
740420206,83,10,2,2,0,0,0,97
740420207,336,30,3,3,4,0,19,395
740420208,351,43,0,12,3,1,11,421
740420301,6,3,0,0,0,0,0,9
740420302,64,5,0,1,0,1,1,72
740420303,23,5,0,0,0,0,0,28
740420304,226,16,1,1,2,1,18,265
740420305,31,8,0,0,0,3,7,49
740420306,379,37,3,7,0,14,21,461
740420307,53,11,0,0,0,0,8,72
740420308,168,32,2,1,0,3,8,214
740420401,20,5,0,0,0,0,3,28
740420402,61,26,2,0,0,1,12,102
740420403,298,33,4,3,2,3,14,357
740420404,383,37,6,16,0,3,20,465
740420405,73,9,0,0,0,1,3,86
740420406,18,11,0,0,0,0,0,29
740420501,27,11,0,0,0,0,9,47
740420502,7,0,0,0,0,1,2,10
740420601,23,12,0,0,0,0,1,36
740420602,30,14,0,0,0,9,2,55
740420603,292,40,3,2,0,0,4,341
740490101,29,0,2,0,0,0,9,40
740490102,36,3,1,1,0,3,10,54
740490103,114,11,8,0,1,8,29,171
740490104,73,14,0,1,0,2,11,101
740490105,40,2,0,0,0,0,3,45
740490106,43,3,0,0,0,0,11,57
740490107,9,3,0,0,0,0,1,13
740490201,60,14,0,1,0,3,3,81
740490202,21,1,0,1,0,1,9,33
740490203,51,11,1,1,0,8,4,76
740490204,252,24,16,10,0,12,13,327
740490205,192,23,1,2,0,0,12,230
740490206,246,16,3,6,0,8,13,292
740490207,211,26,3,16,0,7,9,272
740490208,185,17,5,2,1,5,4,219
740490209,255,15,2,1,1,10,7,291
740490210,178,16,10,4,1,7,4,220
740490211,131,7,1,8,0,2,5,154
740490212,44,3,1,1,0,2,17,68
740490213,83,10,0,1,0,0,5,99
740490301,98,16,2,0,0,17,11,144
740490302,42,3,2,1,0,8,3,59
740490303,386,55,23,19,1,121,54,659
740490304,283,15,25,14,7,44,28,416
740490305,225,23,13,20,0,73,6,360
740490306,213,22,8,21,2,46,10,322
740490401,398,55,16,9,0,14,7,499
740490402,295,33,6,11,2,38,17,402
740490403,191,15,18,26,2,22,15,289
740490404,166,7,2,1,0,5,5,186
740490405,433,26,2,7,1,4,6,479
740490406,429,34,13,7,6,8,13,510
740490407,234,12,14,1,1,23,21,306
740490408,181,24,13,3,4,7,3,235
740490409,181,8,27,8,0,58,12,294
740490410,270,28,31,8,2,54,13,406
740490411,295,55,75,36,3,193,16,673
740490412,213,29,27,11,1,84,11,376
740490413,347,48,14,5,3,15,3,435
740490414,245,27,6,6,2,3,6,295
740490415,445,20,6,12,1,15,14,513
740490416,261,19,22,11,4,45,5,367
740490417,190,12,15,13,0,26,4,260
740490418,182,23,4,4,1,52,8,274
740490419,182,36,62,12,0,49,17,358
740560101,34,1,0,0,0,0,4,39
740560102,17,2,0,0,0,0,1,20
740560103,54,0,1,0,0,1,2,58
740560104,72,0,0,4,0,0,16,92
740560105,170,0,8,3,1,6,25,213
740560201,57,6,0,0,0,0,9,72
740560202,84,6,0,1,0,4,3,98
740560203,103,3,0,3,0,25,0,134
740560204,296,24,2,14,1,0,7,344
740560205,104,9,1,0,0,0,2,116
740560206,208,9,1,0,0,0,8,226
740560301,9,0,0,0,0,0,29,38
740560302,203,27,3,1,0,4,8,246
740560303,127,12,0,0,0,0,3,142
740560304,182,6,0,0,0,0,1,189
740560305,205,32,2,0,0,1,8,248
740560306,320,21,1,0,0,0,8,350
740560307,265,31,1,0,1,2,8,308
740560308,282,9,0,0,0,0,24,315
740560309,0,0,0,0,0,0,1,1
740560310,330,21,0,0,1,1,8,361
740560311,343,17,2,0,1,1,7,371
740560312,305,24,6,0,0,2,4,341
740560313,334,14,3,0,1,5,10,367
740560314,285,17,0,0,1,0,8,311
740560315,242,13,0,0,0,0,1,256
740560316,334,28,0,0,0,2,4,368
740560317,0,0,0,0,0,0,1,1
740560318,8,0,0,0,0,0,5,13
740560401,58,19,0,7,1,15,4,104
740560402,79,36,9,11,0,50,26,211
740560403,150,17,12,9,0,96,13,297
740560404,149,10,64,23,1,80,6,333
740560405,144,10,91,18,4,99,5,371
740560406,263,27,22,10,0,106,29,457
740560407,208,37,9,4,0,64,14,336
740560408,53,2,0,2,0,8,1,66
740560501,151,13,6,10,1,19,15,215
740560502,340,49,4,4,0,5,9,411
740560503,100,12,0,4,0,2,1,119
740560504,209,24,0,0,0,7,11,251
740560505,203,18,0,0,0,5,10,236
740560506,237,15,6,11,1,9,6,285
740560507,210,23,7,10,1,19,13,283
740560508,301,15,0,39,0,13,9,377
740560509,400,32,4,17,1,15,16,485
740560510,257,29,0,12,2,5,2,307
740560511,127,20,6,2,0,10,22,187
740560512,357,24,11,13,3,10,7,425
740560513,346,21,5,1,5,3,6,387
740560514,253,12,6,6,1,4,2,284
740560515,26,0,0,1,0,0,0,27
740560601,8,2,0,0,0,0,214,224
740560602,61,0,1,3,0,0,0,65
740560603,237,4,1,1,1,0,2,246
740560604,207,4,0,0,0,0,2,213
740560605,313,4,7,8,1,2,4,339
740560606,392,24,4,5,0,1,7,433
740560607,227,13,4,0,4,1,4,253
740560608,156,12,4,2,0,0,6,180
740560609,271,14,1,1,1,1,17,306
740560610,298,11,0,1,1,0,8,319
740560611,278,2,2,0,0,0,0,282
740560612,264,15,1,0,0,0,21,301
740560613,258,8,2,0,1,1,1,271
740560614,244,9,2,0,1,0,2,258
740560615,279,14,5,0,2,0,7,307
740560616,217,14,1,2,2,2,6,244
740560617,342,32,4,2,4,0,16,400
740560701,235,19,0,6,0,3,4,267
740560702,324,17,0,7,0,0,2,350
740560703,21,1,0,0,0,1,1,24
740560704,428,12,0,3,1,0,6,450
740560705,400,17,0,7,0,0,5,429
740560706,332,13,0,2,0,1,4,352
740560707,120,6,0,0,1,1,1,129
740560708,342,6,0,0,0,0,8,356
740560709,294,14,5,0,0,0,5,318
740560710,326,25,3,1,2,0,10,367
740560711,132,6,1,1,1,0,0,141
740560712,295,20,3,1,0,0,5,324
740560713,385,13,2,3,2,0,7,412
740560714,248,9,1,0,0,0,1,259
740560715,236,1,0,2,0,1,6,246
740560716,272,8,1,0,0,0,0,281
740560717,310,10,2,2,0,0,1,325
740560718,190,9,2,1,0,0,4,206
740560719,264,20,4,0,1,0,0,289
740560720,153,9,0,2,0,0,3,167
740560721,344,17,2,2,6,0,10,381
740560722,207,12,5,0,0,0,0,224
740560723,157,5,2,0,2,0,16,182
740560724,205,9,5,0,2,0,9,230
740560725,186,20,2,5,0,1,9,223
740560726,313,23,5,3,2,0,9,355
740560801,255,17,0,5,0,0,7,284
740560802,303,19,0,0,1,0,9,332
740560803,209,17,0,0,0,1,8,235
740560804,235,14,0,1,0,1,0,251
740560805,239,13,1,0,0,0,3,256
740560806,97,5,0,0,0,0,0,102
740560807,245,9,0,0,0,0,4,258
740560808,252,15,0,1,2,0,4,274
740560809,223,11,1,2,1,0,6,244
740560810,294,19,0,1,1,0,5,320
740560811,171,3,0,0,0,0,12,186
740560812,285,12,0,0,0,0,1,298
740560813,232,6,1,0,1,1,1,242
740560814,201,12,1,1,0,0,3,218
740560815,223,19,0,1,1,0,2,246
740560901,220,17,4,0,0,4,5,250
740560902,261,14,0,1,0,0,0,276
740560903,270,7,0,0,1,0,2,280
740560904,160,2,0,0,0,3,1,166
740560905,215,8,0,0,0,1,3,227
740560906,256,15,1,1,1,0,7,281
740560907,213,8,0,0,1,2,2,226
740560908,281,8,1,0,1,0,1,292
740560909,235,8,0,0,0,0,2,245
740560910,306,15,0,0,0,1,1,323
740560911,224,9,0,1,1,0,3,238
740560912,160,14,0,0,0,0,5,179
740560913,67,13,0,10,0,1,2,93
740560914,220,8,0,13,1,2,11,255
740560915,275,13,3,0,0,0,9,300
740560916,133,15,5,4,0,0,11,168
740561001,308,52,5,3,3,0,4,375
740561002,185,22,6,2,2,0,10,227
740561003,343,22,5,3,1,0,6,380
740561004,248,18,2,4,0,0,2,274
740561005,310,15,2,1,0,1,6,335
740561006,307,19,3,2,0,1,4,336
740561007,310,9,0,0,0,0,1,320
740561008,213,8,1,0,0,0,1,223
740561009,111,7,8,20,0,0,1,147
740561010,285,12,2,5,13,1,5,323
740561011,334,23,7,20,1,1,16,402
740561012,370,24,4,4,0,0,7,409
740561013,274,18,6,2,3,0,7,310
740561014,250,8,3,1,0,0,2,264
740561015,281,21,6,8,1,1,1,319
740561016,262,21,10,3,3,2,17,318
740561017,306,25,12,1,2,5,26,377
740561018,287,39,15,1,8,0,26,376
740561101,207,6,1,0,0,0,3,217
740561102,342,13,4,2,0,1,5,367
740561103,298,51,4,1,1,0,7,362
740561104,260,33,18,2,5,0,9,327
740561105,213,45,10,0,9,0,11,288
740561106,257,66,23,1,1,0,8,356
740561107,348,98,11,3,12,1,37,510
740561108,227,40,3,6,4,2,11,293
740561109,151,26,2,2,0,0,8,189
740561110,198,30,4,3,8,0,18,261
740561111,198,35,14,0,18,0,9,274
740561112,217,57,9,1,14,2,12,312
740561113,229,35,10,1,11,1,8,295
740561114,117,36,4,0,4,0,8,169
740561115,151,50,5,0,2,2,15,225
740561116,161,35,17,5,22,2,11,253
740561117,211,35,26,0,16,6,14,308
740561118,323,25,8,0,20,2,21,399
740561119,147,14,1,1,2,0,1,166
740561120,202,11,1,2,0,0,5,221
740561121,224,16,6,1,1,2,1,251
740561122,255,6,1,3,1,0,11,277
740561201,440,20,2,6,0,0,6,474
740561202,250,3,0,1,0,0,1,255
740561203,401,6,1,0,0,0,5,413
740561204,289,15,0,0,0,1,3,308
740561205,221,6,0,2,0,0,6,235
740561206,200,6,2,3,0,0,7,218
740561207,170,15,2,1,0,2,6,196
740561208,182,8,21,4,12,0,6,233
740561209,177,10,2,1,0,1,4,195
740561210,163,14,0,1,0,0,14,192
740561211,173,7,1,1,1,0,1,184
740561212,214,16,0,0,0,1,4,235
740561213,288,8,0,1,1,0,5,303
740561214,251,5,0,0,0,0,3,259
740561215,313,12,3,1,0,1,9,339
740561216,347,7,1,0,0,0,1,356
740561217,132,3,2,1,0,0,6,144
740561218,24,0,0,0,0,0,0,24
740561219,166,12,1,0,0,0,4,183
740561220,194,25,1,3,0,0,1,224
740561301,173,21,2,1,2,0,5,204
740561302,141,33,3,2,0,0,16,195
740561303,215,48,14,0,51,2,34,364
740561304,211,66,13,2,41,4,21,358
740561305,218,25,14,6,30,0,18,311
740561306,125,19,6,1,2,0,12,165
740561307,263,16,11,4,11,3,16,324
740561308,237,22,2,1,2,1,10,275
740561309,318,36,10,1,4,0,14,383
740561310,156,15,5,1,6,1,7,191
740561311,325,19,4,3,4,1,18,374
740561312,229,17,2,3,1,0,11,263
740561401,229,58,21,3,12,4,18,345
740561402,199,33,16,4,29,0,15,296
740561403,275,29,11,4,20,4,11,354
740561404,287,46,13,1,19,0,18,384
740561405,302,35,10,8,1,2,15,373
740561406,277,35,7,13,6,1,6,345
740561407,187,14,0,0,0,0,8,209
740561408,244,10,1,2,1,0,3,261
740561409,275,14,4,7,0,0,10,310
740561410,159,22,6,2,5,0,7,201
740561411,175,5,6,6,0,0,6,198
740561412,208,18,19,3,2,0,5,255
740561413,267,15,12,2,16,4,10,326
740561414,276,12,3,6,0,0,9,306
740561415,341,25,4,1,0,1,17,389
740561416,334,20,2,0,1,1,1,359
740561417,349,12,0,0,1,0,1,363
740561418,270,6,0,4,0,1,4,285
740561501,190,4,0,1,0,0,4,199
740561502,187,3,1,1,0,0,2,194
740561503,300,12,1,0,0,0,1,314
740561504,82,0,0,0,0,0,0,82
740561505,231,4,0,2,1,0,5,243
740561506,297,6,1,0,0,0,5,309
740561507,303,4,2,0,1,0,8,318
740561508,296,9,1,0,0,0,4,310
740561509,240,8,0,0,0,0,5,253
740561510,220,2,1,0,0,0,1,224
740561511,264,10,0,1,0,0,4,279
740561512,279,22,1,0,0,0,2,304
740561513,291,19,1,0,0,2,2,315
740561514,239,4,0,0,0,1,0,244
740561515,108,7,1,0,0,0,0,116
740561601,91,13,0,1,0,3,11,119
740561602,50,13,0,0,0,0,4,67
740561603,42,23,0,0,0,0,1,66
740561701,32,3,1,0,0,0,2,38
740561702,4,8,0,0,0,1,0,13
740561703,11,17,0,0,0,0,1,29
740561704,18,8,0,0,0,0,0,26
740561705,23,10,0,2,2,1,3,41
740561706,5,0,0,0,0,1,5,11
740561707,229,20,0,3,0,6,7,265
740561801,4,2,0,0,0,0,0,6
740561802,61,23,0,1,0,0,2,87
740561803,13,2,0,0,0,0,10,25
740561804,13,1,0,0,0,0,2,16
740561805,5,4,0,0,0,0,0,9
740561901,27,10,0,0,0,0,2,39
740561902,49,6,0,5,1,0,0,61
740561903,5,0,0,0,0,0,0,5
740561904,3,0,0,0,0,0,0,3
740630101,83,2,0,0,0,0,3,88
740630102,217,22,5,5,10,15,32,306
740630201,72,7,0,1,0,2,3,85
740630202,137,14,7,0,0,1,2,161
740630301,126,16,0,2,0,4,12,160
740630302,59,7,0,1,0,2,3,72
740630303,80,6,1,0,0,6,5,98
740630304,58,2,0,0,0,0,0,60
740630305,66,16,0,0,0,2,4,88
740630401,115,28,3,0,0,13,7,166
740630402,143,5,0,0,0,5,4,157
740630501,30,19,0,0,0,3,10,62
740630502,16,2,1,0,0,12,7,38
740630503,138,13,7,5,0,9,9,181
740630504,118,22,0,1,1,16,2,160
780070101,19,0,0,0,0,0,11,30
780070201,30,0,0,0,0,0,20,50
780070301,12,2,0,0,0,14,3,31
780070302,14,11,0,0,0,7,18,50
780070401,41,22,0,0,1,18,20,102
780070501,304,25,2,6,1,2,9,349
780070502,467,57,19,17,4,1,3,568
780070503,424,57,15,62,12,4,20,594
780070504,166,20,2,2,0,4,10,204
780070505,491,45,3,10,0,1,12,562
780070601,241,34,4,5,1,0,12,297
780070602,504,41,5,24,1,0,24,599
780070603,296,29,7,35,0,0,18,385
780070604,290,28,2,30,3,5,17,375
780140101,28,26,1,0,0,2,6,63
780140102,30,8,0,0,0,1,35,74
780140103,448,49,11,33,12,2,11,566
780140104,478,56,0,2,4,1,8,549
780140105,317,44,3,17,3,3,13,400
780140106,609,44,3,66,0,16,26,764
780140107,373,36,3,27,4,2,17,462
780140108,458,63,5,13,5,1,17,562
780140109,567,39,6,19,0,0,17,648
780140201,34,7,0,0,0,3,29,73
780140202,329,31,0,27,0,1,5,393
780140203,505,38,3,17,0,0,9,572
780140204,372,19,0,0,0,0,12,403
780140205,406,25,3,3,0,0,6,443
780140206,391,42,7,7,0,3,10,460
780140207,308,27,3,10,1,0,20,369
780140208,389,62,2,40,0,0,18,511
780140209,195,73,7,36,2,30,33,376
780140210,359,31,3,5,2,1,14,415
780140211,452,19,1,3,0,0,5,480
780140212,537,45,6,15,0,1,6,610
780140213,401,29,2,4,1,0,3,440
780140214,290,20,9,33,3,1,36,392
780140215,8,0,0,0,0,0,0,8
780140216,449,33,0,4,1,0,8,495
780140217,245,18,0,43,4,0,16,326
780140218,351,30,3,55,0,0,13,452
780140219,322,28,0,60,0,0,6,416
780140220,343,44,11,36,2,0,16,452
780140221,440,28,0,105,0,0,8,581
780140222,312,25,0,155,0,0,9,501
780140301,23,6,3,0,0,2,7,41
780140302,22,14,3,0,0,3,16,58
780140303,71,5,4,5,1,0,1,87
780140304,349,47,2,228,0,1,15,642
780140305,515,35,0,14,0,0,28,592
780140401,26,6,0,2,0,5,8,47
780140402,98,8,1,11,0,0,2,120
780140403,104,20,0,0,0,0,3,127
780140501,29,4,0,1,1,29,1,65
780140502,25,7,0,0,0,15,14,61
780140503,24,11,2,9,0,8,14,68
780140504,170,51,1,16,2,0,17,257
780140505,512,19,5,25,0,1,21,583
780140506,263,15,0,15,2,0,10,305
780140507,359,37,4,2,1,1,13,417
780140601,17,5,0,0,0,6,32,60
780140701,16,0,0,1,0,1,47,65
780140801,197,18,9,2,3,1,4,234
780140802,455,51,7,1,5,2,23,544
780140803,379,53,10,4,12,1,24,483
780140804,375,43,1,3,1,1,15,439
780140805,345,34,4,2,1,0,7,393
780140901,521,4,6,7,4,2,30,574
780140902,429,2,11,69,7,0,20,538
780140903,271,19,5,3,1,0,15,314
780140904,238,21,0,6,2,0,5,272
780140905,347,26,5,4,0,4,23,409
780140906,455,36,7,4,5,0,12,519
780140907,223,19,4,3,1,1,7,258
780140908,466,27,5,5,0,0,6,509
780140909,307,39,0,3,0,0,5,354
780140910,322,20,2,13,1,0,6,364
780140911,323,19,1,2,0,0,9,354
780140912,364,20,1,26,0,1,11,423
780140913,365,20,2,41,1,0,16,445
780140914,291,30,5,6,0,3,13,348
780141001,243,14,8,4,1,4,14,288
780141101,404,28,4,28,1,0,14,479
780141102,316,24,5,4,2,0,34,385
780141103,144,9,0,7,0,0,15,175
780141104,281,38,8,3,8,1,19,358
780141105,165,32,5,1,13,19,3,238
780141106,226,28,22,3,1,0,11,291
780141107,213,24,6,4,12,3,5,267
780141108,408,48,13,12,31,0,17,529
780141109,284,28,7,3,9,0,8,339
780141110,245,37,4,0,0,0,7,293
780141111,366,26,9,11,8,0,9,429
780141112,371,30,5,7,1,0,14,428
780141113,327,18,2,0,0,0,34,381
780141114,327,14,2,7,3,2,17,372
780141115,388,35,7,7,1,1,19,458
780141116,227,25,3,7,0,1,6,269
780141117,247,14,2,3,1,1,10,278
780141118,131,11,0,4,2,0,3,151
780141119,221,21,5,2,1,1,5,256
780141120,471,44,9,16,0,0,11,551
780141121,257,30,0,3,3,0,2,295
780141122,234,8,1,1,0,1,6,251
780141123,223,19,11,3,2,0,6,264
780141124,202,15,5,2,3,0,5,232
780141125,215,17,6,4,3,1,4,250
780141201,275,20,14,14,0,0,17,340
780141202,328,27,3,0,0,0,4,362
780141203,455,21,17,9,1,0,13,516
780141204,239,26,6,0,3,0,4,278
780141205,223,40,6,1,5,0,17,292
780141206,341,47,5,7,12,1,22,435
780141207,279,50,4,12,4,0,16,365
780141208,311,31,3,1,2,1,11,360
780210101,77,22,1,2,0,6,14,122
780210102,22,4,0,1,1,10,5,43
780210201,29,23,0,1,0,13,5,71
780210301,63,10,0,0,0,0,0,73
780210401,92,19,4,31,2,24,19,191
780210402,42,38,4,20,0,29,19,152
780210403,43,4,0,17,0,11,33,108
780210404,1,0,0,3,0,0,1,5
780210405,403,92,19,190,1,34,121,860
780210406,40,7,0,24,0,1,15,87
780210501,34,6,0,0,0,0,0,40
780210601,50,1,0,0,0,1,4,56
780210701,58,16,5,6,0,53,11,149
780210702,87,0,0,3,0,0,3,93
780210703,7,0,0,2,0,1,2,12
780210704,82,10,0,0,0,0,0,92
780210705,7,0,0,0,0,0,7,14
780210706,43,8,0,102,0,8,1,162
780210801,308,26,5,29,1,0,13,382
780210802,586,32,1,105,2,0,14,740
780210803,11,0,0,0,0,0,0,11
780210804,261,17,2,4,2,2,7,295
780210805,287,36,2,4,1,0,9,339
780210806,378,24,0,6,1,0,12,421
780210807,447,31,1,27,0,0,16,522
780210901,452,69,5,36,9,1,18,590
780210902,573,44,7,45,8,0,15,692
780210903,471,31,0,8,0,0,2,512
780211001,241,2,4,9,0,1,13,270
780211002,395,7,3,7,3,1,11,427
780211003,218,14,3,4,3,4,11,257
780211004,229,20,6,4,8,0,4,271
780211005,180,34,12,10,9,1,10,256
780211006,208,19,9,1,8,0,5,250
780211007,167,29,4,1,1,1,11,214
780211008,325,29,3,4,7,0,15,383
780211009,158,6,2,1,1,1,5,174
780211010,329,25,4,4,1,0,4,367
780211011,326,21,5,4,4,1,10,371
780211012,310,7,9,2,2,0,8,338
780211013,211,18,1,6,8,0,6,250
780211014,316,13,3,2,1,0,13,348
780211015,192,46,4,6,1,1,8,258
780211016,226,17,7,2,8,1,10,271
780211101,244,38,6,2,2,0,5,297
780211102,197,38,6,2,10,4,10,267
780211103,368,50,11,4,9,1,22,465
780211104,154,38,2,1,0,1,5,201
780211105,356,40,2,2,2,0,11,413
780211106,254,52,15,0,6,0,16,343
780211107,227,63,45,2,2,0,16,355
780211108,163,40,6,1,3,0,19,232
780211109,287,28,13,1,3,2,26,360
780211110,176,19,6,2,0,0,3,206
780211111,203,8,6,5,1,1,5,229
780211112,284,10,6,6,0,0,7,313
780211113,248,8,2,1,2,0,3,264
780211114,253,31,3,2,1,2,20,312
780211115,297,47,3,6,13,0,7,373
780211116,178,20,5,1,2,0,2,208
780211117,169,30,14,3,1,0,5,222
780211118,217,22,1,5,0,0,3,248
780211119,116,20,2,1,8,0,5,152
780211120,274,15,8,1,3,2,8,311
780211121,187,5,2,4,1,0,8,207
780211122,303,28,2,3,1,0,6,343
780211123,262,9,7,1,0,0,1,280
780211201,371,4,3,0,0,0,14,392
780211202,195,1,0,2,0,0,14,212
780211203,225,0,1,1,1,0,9,237
780211204,277,5,0,1,0,0,14,297
780211205,420,27,2,7,2,0,4,462
780211206,152,27,7,0,0,0,12,198
780211207,353,24,1,2,0,2,4,386
780211208,352,20,0,1,2,1,11,387
780211209,322,27,3,3,4,0,13,372
780211210,225,13,0,208,0,0,4,450
780211211,225,18,6,3,2,0,2,256
780211212,384,34,7,5,3,1,12,446
780211213,192,14,0,1,0,0,0,207
780211214,238,16,2,5,1,0,3,265
780211215,208,17,2,3,2,0,1,233
780211216,234,18,3,1,2,0,11,269
780211217,216,8,5,0,0,0,4,233
780211218,200,26,8,2,0,0,9,245
780211219,207,10,1,1,0,0,9,228
780211220,368,28,8,10,2,0,4,420
780211221,546,25,0,1,0,0,12,584
780211301,283,30,7,47,4,0,15,386
780211302,206,9,5,40,4,0,9,273
780211303,159,3,2,4,1,0,10,179
780211304,423,67,13,30,0,2,25,560
780211305,454,36,7,8,3,1,12,521
780211306,501,52,3,11,0,0,23,590
780211307,464,34,0,8,0,0,5,511
780211308,422,27,2,24,0,0,14,489
780211309,303,28,0,19,1,0,11,362
780211310,310,27,4,9,4,0,5,359
780211311,264,6,0,0,0,0,1,271
780211312,567,16,0,55,0,0,14,652
780211313,175,30,7,11,1,7,24,255
780211314,231,19,1,3,0,0,8,262
780211315,409,17,0,16,4,1,12,459
780211316,52,3,4,8,1,2,17,87
780211317,486,36,1,23,1,5,22,574
780211318,185,27,3,40,1,8,5,269
780211319,134,6,1,0,2,0,5,148
780211320,550,36,2,43,0,0,27,658
780211321,322,11,1,25,0,0,17,376
780211322,356,21,2,0,0,0,6,385
780211401,347,13,6,2,7,0,12,387
780211402,324,19,4,3,0,1,7,358
780211403,260,13,1,1,3,1,7,286
780211404,217,10,0,3,0,0,4,234
780211405,204,11,1,3,0,0,5,224
780211406,340,37,6,6,2,2,5,398
780211407,397,23,1,10,4,0,8,443
780211408,321,16,6,1,3,0,5,352
780211409,264,17,13,8,5,1,9,317
780211410,309,15,7,2,3,1,6,343
780211411,176,13,4,2,1,0,13,209
780211412,216,12,4,4,3,0,4,243
780211413,144,13,2,5,1,1,3,169
780211414,381,21,5,26,0,0,8,441
780211415,234,37,4,0,0,0,54,329
780280101,16,0,0,0,0,0,3,19
780280102,20,3,0,0,0,0,1,24
780280103,437,10,9,19,1,11,24,511
780280201,9,3,0,0,0,0,2,14
780280301,9,15,0,1,0,2,0,27
780280401,24,5,0,0,0,3,8,40
780280402,81,13,3,1,2,2,4,106
780280501,22,4,0,0,0,0,0,26
780280502,14,10,0,0,0,1,2,27
780280503,453,113,55,34,3,8,11,677
780280504,718,60,17,28,2,1,14,840
780280505,97,43,0,18,0,1,6,165
780280506,100,26,2,8,0,5,9,150
780280507,4,1,0,4,0,0,0,9
780280508,12,14,0,11,0,7,8,52
780280509,40,3,5,0,0,0,7,55
780280510,277,59,27,23,5,3,36,430
780280511,14,7,13,16,0,2,2,54
780280512,28,4,5,4,1,2,4,48
780280513,575,46,43,32,1,2,28,727
780280514,400,45,7,19,0,7,20,498
780280601,19,15,0,2,0,4,2,42
780280701,175,45,16,3,13,3,10,265
780280702,275,40,11,4,3,6,29,368
780280703,335,53,15,6,5,6,16,436
780280704,469,56,25,15,4,6,14,589
780280705,239,25,1,2,2,1,9,279
780280706,274,25,6,4,10,2,7,328
780350101,15,12,0,0,0,4,0,31
780350102,14,17,0,0,0,0,0,31
780350201,21,6,0,0,0,14,1,42
780350301,15,9,0,0,0,18,2,44
780350401,31,19,0,0,0,0,4,54
780350402,213,44,6,52,0,15,11,341
780350403,415,48,8,18,6,11,22,528
780350404,357,37,3,18,0,10,7,432
780350501,3,2,0,0,0,5,2,12
780350601,194,20,3,8,2,2,5,234
780350602,398,64,7,13,7,3,23,515
780350603,390,43,3,33,13,2,15,499
780350604,267,28,0,11,6,1,6,319
780350605,99,13,3,11,1,13,6,146
780420101,32,4,3,0,0,0,9,48
780420201,15,9,1,0,0,0,2,27
780420202,172,27,0,0,1,0,25,225
780420203,140,6,0,0,0,0,0,146
780420301,297,39,5,22,4,0,21,388
780420302,390,41,5,11,18,0,44,509
780420303,120,6,1,3,2,0,24,156
780420304,282,72,14,3,22,0,39,432
780420305,378,44,7,22,10,2,29,492
780420306,523,42,8,40,3,2,8,626
780420307,315,30,1,12,3,1,8,370
780490101,39,11,0,0,0,3,28,81
780490102,7,9,0,0,0,0,0,16
780490103,88,26,2,24,3,5,9,157
780490201,30,4,0,0,0,0,30,64
780490301,20,16,0,0,0,0,10,46
780490401,8,10,0,0,0,0,10,28
780490501,507,52,3,10,2,1,10,585
780490502,448,42,3,14,2,2,8,519
780490503,224,73,5,27,0,21,28,378
820070101,64,11,0,0,0,4,36,115
820070102,117,17,0,0,0,13,33,180
820070103,384,32,9,8,3,2,12,450
820070104,71,18,0,1,0,5,39,134
820070201,321,8,5,7,2,1,7,351
820070202,357,14,6,8,0,0,9,394
820070203,287,19,3,10,6,5,8,338
820070204,328,15,1,12,2,0,3,361
820070205,328,7,1,2,0,0,2,340
820070206,265,20,4,8,3,1,4,305
820070207,234,20,5,6,6,0,5,276
820070208,475,22,4,9,3,1,8,522
820070209,95,12,1,0,1,16,48,173
820070210,223,6,0,1,0,0,3,233
820070211,352,7,2,6,0,2,2,371
820070212,91,5,0,0,0,6,113,215
820070213,245,14,10,3,0,1,8,281
820070214,227,12,5,6,0,6,4,260
820070215,214,8,5,4,1,4,15,251
820070216,272,8,1,3,0,0,0,284
820070217,239,14,5,6,0,0,11,275
820070301,289,11,8,3,3,0,5,319
820070302,374,18,5,11,11,4,10,433
820070303,372,44,15,14,19,4,34,502
820070304,346,25,5,7,10,8,23,424
820070305,320,15,1,6,0,0,8,350
820070306,331,16,3,4,2,0,8,364
820070307,91,15,0,3,0,2,36,147
820070308,258,10,8,2,3,1,10,292
820070309,84,8,0,0,1,12,33,138
820070310,483,21,11,15,7,4,15,556
820070311,324,20,5,8,3,10,12,382
820070312,399,26,6,16,18,4,25,494
820070313,251,10,8,6,5,1,11,292
820070314,237,6,0,3,0,0,9,255
820070315,315,24,8,15,3,3,13,381
820070401,247,11,4,9,1,2,12,286
820070402,194,10,9,3,6,1,19,242
820070403,313,17,6,1,4,2,22,365
820070404,209,17,13,11,24,3,12,289
820070405,272,15,9,2,2,5,13,318
820070406,280,8,7,4,0,0,9,308
820070407,330,34,5,9,1,10,16,405
820070408,316,9,6,15,1,2,7,356
820070409,425,11,4,14,0,0,9,463
820070410,233,5,5,5,0,0,29,277
820070411,233,10,5,2,1,1,13,265
820070412,374,20,7,5,0,2,9,417
820070413,278,12,3,12,1,2,8,316
820070414,308,8,5,3,1,2,10,337
820140101,401,21,5,12,0,12,35,486
820140102,404,17,4,13,1,12,23,474
820140103,270,10,5,4,7,0,4,300
820140104,220,12,3,3,14,5,10,267
820140105,280,28,9,8,4,3,14,346
820140106,354,15,5,1,2,6,17,400
820140107,318,16,4,4,2,2,4,350
820140108,273,5,3,7,1,1,9,299
820140109,434,23,4,8,3,3,27,502
820140110,424,20,6,6,6,3,21,486
820140111,331,23,2,5,0,2,12,375
820140112,399,24,7,8,3,5,18,464
820140113,299,7,2,5,0,1,13,327
820140114,367,17,6,10,0,3,15,418
820140115,443,30,8,6,1,2,16,506
820140116,243,4,1,2,0,0,11,261
820140117,273,10,4,7,0,3,10,307
820140118,7,1,0,0,0,0,28,36
820140119,21,4,0,0,0,1,14,40
820140120,34,3,0,0,0,0,9,46
820140121,45,26,0,0,0,2,9,82
820140122,17,2,0,0,0,0,34,53
820140123,6,0,0,0,0,0,33,39
820140124,26,4,0,1,1,3,35,70
820140125,19,1,0,0,0,7,65,92
820140126,46,19,0,0,0,14,52,131
820140127,32,10,0,3,0,3,32,80
820140128,53,4,0,0,0,18,40,115
820140129,44,1,0,2,0,2,3,52
820140130,259,11,1,6,3,0,21,301
820140201,51,6,0,0,0,16,48,121
820140202,32,15,0,0,1,5,16,69
820140203,288,16,3,5,1,2,13,328
820140204,467,24,12,8,2,1,8,522
820140205,281,14,9,11,5,1,16,337
820140206,309,18,4,6,1,0,19,357
820140207,313,9,1,6,11,4,16,360
820140208,255,26,20,2,2,0,9,314
820140209,222,16,3,3,9,1,5,259
820140210,330,25,15,3,19,1,33,426
820140211,230,34,10,2,11,0,24,311
820140212,168,20,3,4,12,0,6,213
820140213,200,22,8,2,1,0,5,238
820140214,196,28,6,1,18,2,9,260
820140215,183,17,4,1,2,0,6,213
820140216,197,12,9,7,6,0,11,242
820140217,233,10,12,8,2,1,5,271
820140218,381,19,4,21,2,2,5,434
820140219,259,20,3,13,0,9,4,308
820140301,212,12,3,2,7,0,9,245
820140302,248,24,13,3,7,1,5,301
820140303,406,46,18,2,3,1,15,491
820140304,201,8,4,4,5,0,19,241
820140305,279,8,4,2,8,1,10,312
820140306,89,6,0,6,0,9,3,113
820140307,432,14,12,7,4,1,19,489
820140308,254,15,1,0,0,0,6,276
820140309,269,13,7,2,1,1,13,306
820140310,280,34,3,2,8,1,4,332
820140311,288,42,19,18,3,13,4,387
820140312,39,1,0,0,1,11,32,84
820140401,277,10,0,8,2,2,23,322
820140402,325,9,1,5,3,4,11,358
820140403,338,7,2,6,1,0,9,363
820140404,317,16,3,10,2,1,16,365
820140405,294,27,5,2,11,1,26,366
820140406,382,16,7,16,4,4,12,441
820140407,280,14,2,5,1,0,5,307
820140408,319,10,0,14,1,1,12,357
820140409,220,12,2,3,4,2,12,255
820140410,262,8,2,9,0,2,4,287
820140411,321,21,5,6,5,4,6,368
820140412,308,8,2,9,3,0,7,337
820140413,19,0,0,0,0,3,40,62
820140414,5,2,0,0,0,0,45,52
820140415,93,14,0,6,0,5,33,151
820140416,74,9,0,0,0,17,37,137
820140417,55,3,0,0,0,1,47,106
820140418,78,17,1,0,0,5,55,156
820140419,338,15,6,6,1,0,18,384
820140420,272,3,2,2,3,0,12,294
820140501,17,16,0,0,0,0,31,64
820140502,50,0,0,1,0,2,112,165
820140503,401,14,12,10,0,4,15,456
820140504,363,32,11,11,6,6,21,450
820140505,83,15,0,2,0,5,136,241
820140506,356,28,8,5,4,6,6,413
820140507,303,10,4,2,1,0,13,333
820140508,321,22,7,4,5,4,22,385
820140509,222,12,2,4,2,1,9,252
820140510,343,15,7,3,2,0,11,381
820140511,314,13,9,8,0,1,8,353
820140512,17,6,0,0,0,3,35,61
820140513,209,32,1,3,0,0,14,259
820140514,321,17,3,13,5,1,23,383
820140515,23,3,0,0,0,0,7,33
820140516,23,7,0,0,0,2,63,95
820140517,358,21,6,5,0,1,18,409
820140518,210,13,3,1,4,2,9,242
820140519,267,9,6,4,3,5,13,307
820140520,10,1,0,0,0,0,22,33
820140521,5,4,0,0,0,7,3,19
820140522,9,3,0,0,1,1,14,28
820140523,258,11,3,4,2,2,6,286
820140524,173,17,1,3,0,1,19,214
820140601,726,16,1,10,1,8,20,782
820140602,422,21,9,13,1,7,23,496
820140603,219,11,9,4,9,1,9,262
820140604,344,9,5,5,6,8,15,392
820140605,433,18,7,30,11,12,18,529
820140606,248,16,11,11,0,14,12,312
820140607,415,18,2,3,4,2,21,465
820140608,333,27,7,14,7,3,27,418
820140609,393,14,1,21,0,8,2,439
820140610,16,11,0,1,0,4,15,47
820140611,26,4,0,1,0,13,39,83
820149001,22,0,0,0,0,5,63,90
820210101,55,2,0,0,0,0,5,62
820210102,19,0,0,0,0,0,28,47
820210103,415,5,12,47,3,7,40,529
820210104,319,18,6,6,4,6,10,369
820210105,231,15,10,1,1,1,18,277
820210106,324,20,7,8,4,0,22,385
820210107,289,5,7,7,5,1,14,328
820210108,93,16,0,0,0,9,85,203
820210109,34,0,1,0,0,0,1,36
820210110,367,12,5,11,7,2,19,423
820210111,85,2,0,0,0,3,13,103
820210112,140,3,0,0,6,7,22,178
820210113,63,0,0,0,0,0,2,65
820210114,48,4,0,0,0,1,10,63
820210115,223,14,0,2,1,1,16,257
820210116,99,14,0,0,0,1,15,129
820210117,70,7,0,0,0,7,19,103
820210118,200,1,2,2,0,2,10,217
820210119,473,23,4,19,1,4,32,556
820210120,69,6,0,1,0,2,12,90
820210121,49,3,0,0,0,0,22,74
820210122,49,6,0,0,0,0,8,63
820210123,85,4,0,3,0,3,8,103
820210124,392,14,10,33,8,18,33,508
820210125,24,0,0,0,0,1,5,30
820210126,52,10,0,0,0,1,27,90
820210127,39,4,0,0,0,0,6,49
820210128,96,2,0,0,0,5,13,116
820210129,35,1,0,0,0,1,7,44
820210130,51,2,0,0,0,1,18,72
820210131,56,3,1,0,0,3,36,99
820210132,81,23,0,0,1,4,14,123
820210133,351,17,7,14,1,4,18,412
820210134,326,29,11,21,4,5,22,418
820210201,376,19,6,5,14,0,8,428
820210202,372,11,3,7,0,0,5,398
820210203,365,13,6,2,6,1,1,394
820210204,412,18,5,4,6,1,20,466
820210205,410,9,8,1,0,2,4,434
820210206,310,12,3,2,2,1,3,333
820210207,352,11,7,11,2,1,8,392
820210208,355,21,11,4,6,2,9,408
820210209,386,16,9,8,17,0,25,461
820210210,346,9,4,2,4,3,24,392
820210211,287,6,2,1,5,2,6,309
820210212,394,28,2,49,2,17,67,559
820210213,202,7,2,5,1,1,11,229
820210214,316,9,3,5,3,0,10,346
820210215,569,20,6,44,0,6,23,668
820210216,321,13,3,7,0,1,7,352
820210217,443,6,0,8,0,0,6,463
820210218,345,14,5,3,1,0,11,379
820210301,20,0,0,0,0,0,4,24
820210302,527,21,8,14,0,0,7,577
820210303,56,10,0,0,0,0,26,92
820210304,100,2,7,0,0,0,9,118
820210305,419,28,7,9,7,5,29,504
820210306,64,1,0,0,0,0,56,121
820210307,62,0,0,5,0,0,5,72
820210308,88,1,0,0,0,1,10,100
820210309,10,0,0,0,0,0,11,21
820210310,126,4,0,1,0,19,49,199
820210311,199,16,5,18,2,88,14,342
820210312,35,2,2,0,0,4,4,47
820210313,336,24,4,12,1,47,20,444
820210314,94,21,2,0,1,4,51,173
820210315,63,6,1,1,0,0,4,75
820210316,26,3,0,1,0,0,2,32
820210317,366,26,13,1,11,2,22,441
820210318,355,21,10,6,2,1,29,424
820210319,62,15,0,8,0,1,56,142
820210320,107,0,0,1,1,1,4,114
820210321,415,24,6,4,1,2,7,459
820210322,90,18,1,0,1,3,57,170
820210323,35,0,0,0,0,0,32,67
820210324,26,0,0,0,0,0,38,64
820210325,28,0,0,0,0,0,48,76
820210326,34,0,0,0,0,0,30,64
820210327,167,11,4,7,0,43,40,272
820210328,43,0,0,0,0,0,45,88
820210329,46,1,0,0,0,1,29,77
820210330,41,1,0,0,0,1,30,73
820210331,43,0,0,0,0,1,55,99
820210332,88,4,0,2,0,1,11,106
820210333,140,0,4,4,2,6,11,167
820210401,468,8,5,4,1,0,13,499
820210402,285,15,2,0,0,0,10,312
820210403,209,7,1,1,0,0,3,221
820210404,328,20,7,3,7,1,9,375
820210405,230,13,2,1,1,2,7,256
820210406,423,19,8,4,5,0,8,467
820210407,139,6,4,1,0,0,3,153
820210408,343,24,9,13,6,1,13,409
820210409,327,18,14,0,2,1,15,377
820210410,154,22,3,1,40,1,16,237
820210411,306,9,5,2,2,0,23,347
820210412,238,15,4,1,6,0,15,279
820210413,245,30,8,3,28,0,4,318
820210414,309,17,8,1,11,2,4,352
820210415,323,19,11,6,6,3,10,378
820210416,661,40,4,3,3,58,22,791
820210417,375,8,0,6,1,0,5,395
820210418,416,8,6,2,1,1,8,442
820210419,386,8,3,2,0,0,5,404
820210420,234,9,5,4,2,1,5,260
820210421,196,2,6,0,3,0,10,217
820210422,825,20,1,2,0,0,19,867
820210501,242,1,0,0,0,0,3,246
820210502,282,3,0,0,1,0,4,290
820210503,350,1,4,1,2,0,3,361
820210504,255,2,4,1,0,4,9,275
820210505,450,16,15,6,1,1,11,500
820210506,315,15,6,5,16,0,8,365
820210507,215,9,5,0,4,0,10,243
820210508,348,24,10,4,5,0,5,396
820210509,241,31,26,0,24,1,16,339
820210510,200,19,16,1,33,3,20,292
820210511,244,27,13,1,23,0,17,325
820210512,333,0,3,2,0,1,4,343
820210513,493,13,3,3,0,0,5,517
820210514,406,20,10,3,4,0,11,454
820210601,320,13,1,0,1,0,2,337
820210602,354,21,19,1,4,1,5,405
820210603,291,50,31,1,20,0,27,420
820210604,275,14,6,3,13,1,27,339
820210605,350,17,10,5,1,0,8,391
820210606,318,25,11,5,9,3,10,381
820210607,444,18,22,2,3,1,19,509
820210608,388,11,6,2,3,0,3,413
820210609,407,9,5,7,1,4,10,443
820210610,355,32,5,33,0,121,29,575
820210611,341,4,0,1,0,0,9,355
820210612,380,22,12,9,3,2,12,440
820210613,264,5,4,5,6,4,10,298
820210614,370,19,4,4,0,1,4,402
820210615,119,5,2,2,0,53,19,200
820210616,929,47,17,48,2,6,19,1068
820210617,253,9,6,0,2,5,6,281
820210618,423,23,3,1,6,0,15,471
820210619,386,22,4,7,1,4,10,434
820210620,391,26,7,7,0,0,10,441
820210701,230,14,7,8,2,2,20,283
820210702,475,26,2,9,1,0,39,552
820210703,45,7,0,1,0,4,17,74
820210704,49,2,0,0,0,4,61,116
820210705,32,4,0,0,0,3,24,63
820210706,215,19,2,3,1,2,11,253
820210707,281,12,1,0,0,0,5,299
820210708,5,3,0,0,0,1,0,9
820210709,31,0,0,0,0,0,30,61
820210710,240,14,3,10,0,0,5,272
820210711,34,1,0,0,0,0,71,106
820210712,309,22,5,12,6,1,19,374
820210713,229,11,4,1,1,0,10,256
820210714,56,1,0,0,0,1,31,89
820210715,28,3,0,1,0,0,16,48
820210716,11,7,0,0,0,1,4,23
820210717,395,16,10,2,19,0,16,458
820210718,332,9,4,2,1,1,7,356
820210719,224,3,0,1,1,0,7,236
820210720,280,8,9,5,5,0,6,313
820210721,226,3,3,3,6,0,6,247
820210722,547,11,5,7,3,0,7,580
820210723,7,0,0,0,0,1,1,9
820210724,246,14,1,6,4,1,5,277
820210725,185,2,2,3,4,0,2,198
820210726,282,18,3,8,3,1,7,322
820210801,195,34,17,2,22,5,11,286
820210802,321,43,8,2,17,3,22,416
820210803,265,21,13,3,9,1,10,322
820210804,307,30,7,1,17,2,30,394
820210805,292,15,6,5,4,1,10,333
820210806,194,9,4,2,2,1,13,225
820210807,374,15,3,9,0,0,5,406
820210808,264,11,4,1,2,0,21,303
820210809,303,5,4,2,3,0,6,323
820210810,355,8,4,2,1,2,2,374
820210811,351,14,13,5,7,2,11,403
820210812,197,10,4,4,15,0,10,240
820210813,255,8,2,0,1,1,11,278
820210814,357,14,3,2,0,2,2,380
820210815,264,11,3,1,0,0,2,281
820210901,422,44,11,11,4,3,8,503
820210902,344,22,10,9,2,2,14,403
820210903,355,22,11,10,1,1,4,404
820210904,506,16,16,20,2,20,9,589
820210905,238,13,7,1,0,1,2,262
820210906,245,27,3,3,8,0,9,295
820210907,332,29,14,2,11,1,19,408
820210908,56,5,2,0,16,0,5,84
820210909,249,18,17,1,6,1,13,305
820210910,179,16,6,0,0,0,10,211
820210911,344,19,7,6,0,1,7,384
820210912,396,9,2,4,1,5,2,419
820210913,245,11,2,4,2,0,8,272
820210914,279,11,7,2,4,2,6,311
820211001,74,0,2,2,1,0,19,98
820211002,204,12,3,3,0,1,3,226
820211003,63,6,0,1,0,0,12,82
820211004,44,0,2,1,0,3,8,58
820211005,48,8,0,1,0,2,12,71
820211006,454,15,10,11,2,2,12,506
820211007,377,25,7,8,2,0,1,420
820211008,416,12,9,4,4,0,17,462
820211009,411,25,10,10,1,3,20,480
820211010,15,0,0,0,0,0,0,15
820211011,45,0,1,0,0,2,49,97
820211012,75,2,1,0,0,1,10,89
820211013,435,17,1,9,1,9,35,507
820211014,343,20,5,2,1,1,7,379
820211015,390,12,4,9,6,1,20,442
820211016,272,19,6,2,3,1,11,314
820211017,349,26,6,5,4,2,12,404
820211018,315,14,2,1,2,1,4,339
820280101,511,32,5,15,2,1,30,596
820280102,235,10,1,5,7,1,10,269
820280103,219,11,5,9,1,3,5,253
820280104,439,24,6,12,2,1,16,500
820280105,583,17,4,6,1,0,37,648
820280106,20,0,0,0,0,0,86,106
820280107,134,6,0,13,0,15,123,291
820280108,232,9,0,2,0,1,3,247
820280109,213,18,4,1,0,0,3,239
820280110,80,1,1,27,0,19,23,151
820280111,47,24,0,0,0,0,38,109
820280112,354,11,4,3,3,2,25,402
820280113,356,15,13,5,7,3,39,438
820280114,292,11,6,3,4,5,41,362
820280115,12,4,0,0,0,4,72,92
820280116,21,0,0,0,0,8,76,105
820280117,326,22,1,7,2,7,30,395
820280118,20,0,0,0,0,0,17,37
820280119,42,5,0,0,0,5,26,78
820280120,166,16,2,1,1,1,5,192
820280121,216,7,7,3,2,3,20,258
820280122,260,19,3,8,1,0,10,301
820280123,194,26,4,5,1,1,7,238
820280124,225,8,3,5,1,2,9,253
820280201,569,15,8,16,2,3,17,630
820280202,44,1,0,0,0,9,16,70
820280203,139,18,0,3,1,5,15,181
820280204,319,12,9,2,5,7,17,371
820280205,462,24,5,1,0,5,9,506
820280206,39,9,0,0,2,6,40,96
820280207,282,16,4,5,7,2,21,337
820280208,83,5,0,0,1,8,32,129
820280209,112,2,0,0,1,8,21,144
820280210,23,4,0,0,0,0,10,37
820280211,333,24,4,2,1,6,10,380
820280212,264,9,5,2,0,4,21,305
820280213,14,0,0,0,0,9,36,59
820280214,219,8,5,2,0,2,22,258
820280215,21,2,0,0,0,3,28,54
820280216,230,19,5,6,2,0,14,276
820280217,28,2,0,0,0,10,23,63
820280218,13,3,0,0,0,3,8,27
820280219,14,4,0,0,0,0,0,18
820280220,265,18,3,5,3,1,15,310
820280221,281,13,10,2,1,3,19,329
820280301,207,29,3,5,0,0,8,252
820280302,320,14,2,2,7,0,6,351
820280303,333,13,3,2,5,0,8,364
820280304,315,9,9,11,2,1,13,360
820280305,256,9,1,0,0,0,3,269
820280306,397,31,1,12,1,18,24,484
820280307,352,23,5,16,0,4,5,405
820280308,316,23,4,6,25,0,15,389
820280309,688,14,1,22,1,0,14,740
820280310,56,7,0,2,0,4,23,92
820280311,272,14,7,3,7,0,11,314
820280312,103,9,0,15,0,2,10,139
820280313,155,1,3,3,1,3,9,175
820280314,169,11,6,7,5,5,12,215
820280315,61,12,0,0,0,5,6,84
820280316,225,8,4,4,13,4,18,276
820280317,37,2,0,0,0,1,31,71
820280318,315,9,6,12,3,1,9,355
820280319,151,3,2,0,0,1,8,165
820280320,224,3,8,9,5,7,15,271
820280321,219,12,3,3,5,0,25,267
820280322,193,12,2,3,1,2,4,217
820280323,51,5,0,0,0,3,26,85
820280324,256,25,0,27,0,7,16,331
820280325,29,7,0,0,0,3,15,54
820280326,489,16,1,11,3,12,5,537
820280327,93,6,4,11,0,15,8,137
820280401,343,17,4,4,18,1,12,399
820280402,266,18,2,2,5,2,7,302
820280403,347,14,4,5,3,1,19,393
820280404,360,6,3,4,3,0,15,391
820280405,344,8,4,5,0,0,11,372
820280406,239,13,7,4,4,1,14,282
820280407,320,18,14,3,5,0,5,365
820280408,246,5,5,2,14,2,14,288
820280409,305,12,9,7,5,0,27,365
820280410,464,23,8,4,2,2,4,507
820280411,287,11,11,4,3,0,9,325
820280412,336,14,1,3,0,0,8,362
820280413,373,1,1,11,0,0,26,412
820280414,381,14,2,10,0,0,3,410
820280415,289,6,0,6,2,2,4,309
820280501,155,3,4,6,2,1,4,175
820280502,235,9,5,3,2,2,6,262
820280503,275,5,9,4,4,0,6,303
820280504,292,18,1,3,0,0,3,317
820280505,453,14,8,9,5,0,8,497
820280506,508,21,2,12,5,0,4,552
820280507,300,15,1,1,1,1,1,320
820280508,400,11,3,10,4,1,15,444
820280509,337,12,4,5,1,0,7,366
820280510,219,11,0,2,0,0,5,237
820280511,447,10,2,7,12,1,12,491
820280512,479,6,0,6,5,0,9,505
820280513,387,7,2,1,12,0,10,419
820280514,329,7,1,7,2,0,6,352
820280515,357,10,0,4,1,2,7,381
820280516,230,6,0,6,5,0,11,258
820280517,386,0,1,2,0,0,4,393
820289201,49,5,0,0,0,2,41,97
820350101,100,3,0,5,1,12,18,139
820350102,232,8,2,5,0,38,21,306
820350103,64,9,0,4,0,30,19,126
820350104,9,8,0,0,0,1,12,30
820350105,16,8,0,1,0,1,0,26
820350106,203,4,0,1,0,42,27,277
820350107,28,0,0,0,0,4,9,41
820350108,95,10,0,0,0,2,0,107
820350109,74,10,0,0,0,1,4,89
820350110,146,5,6,1,0,5,22,185
820350111,376,17,2,12,2,3,24,436
820350112,231,32,0,3,2,2,7,277
820350113,317,21,13,10,4,16,15,396
820350114,337,22,6,6,2,6,16,395
820350115,21,0,0,1,0,12,4,38
820350116,138,13,1,6,0,71,26,255
820350117,268,4,6,1,2,5,14,300
820350201,5,9,0,0,0,0,5,19
820350202,522,43,8,12,3,158,67,813
820350203,32,3,0,0,0,1,3,39
820350204,16,1,0,0,0,0,21,38
820350205,49,5,0,1,0,9,11,75
820350206,126,10,2,4,0,15,5,162
820350207,215,14,1,3,0,7,46,286
820350208,82,4,0,7,1,9,13,116
820350209,317,15,10,16,2,137,49,546
820350210,363,14,8,6,6,34,13,444
820350211,530,19,4,31,2,50,13,649
820350212,360,25,10,6,4,17,19,441
820350213,299,5,3,7,1,13,10,338
820420101,43,0,1,0,0,2,69,115
820420102,224,3,2,10,0,1,24,264
820420103,274,2,3,7,1,3,22,312
820420104,109,1,0,2,0,2,32,146
820420105,31,0,0,0,0,1,21,53
820420106,56,2,0,0,0,4,35,97
820420107,315,0,5,3,3,0,15,341
820420108,418,1,2,11,4,2,4,442
820420109,403,16,4,21,5,2,3,454
820420110,153,83,0,0,0,3,62,301
820420111,340,17,11,4,2,2,14,390
820420112,302,14,14,4,4,5,20,363
820420113,53,4,0,0,0,0,10,67
820420115,267,8,2,2,5,1,17,302
820420116,93,4,0,2,4,25,21,149
820420117,99,25,1,2,1,17,13,158
820420118,61,14,0,2,0,4,2,83
820420119,92,31,0,2,1,8,9,143
820420120,51,10,0,0,0,4,51,116
820420121,88,16,4,1,1,3,50,163
820420122,319,14,3,3,1,0,14,354
820420123,250,26,3,4,0,5,10,298
820420124,106,39,0,2,1,7,29,184
820420201,73,3,2,0,0,2,2,82
820420202,153,10,0,2,0,4,10,179
820420203,58,16,0,0,0,9,14,97
820420204,75,8,0,0,0,13,44,140
820420205,337,31,12,7,2,3,11,403
820420206,322,14,6,4,3,4,24,377
820420207,245,25,1,2,3,0,8,284
820420208,235,14,4,1,1,1,10,266
820420209,34,0,0,1,0,6,25,66
820420210,168,0,1,2,0,0,38,209
820420211,96,7,0,0,0,14,30,147
820420212,273,21,3,3,0,1,8,309
820420213,300,7,7,4,2,2,11,333
820420214,400,8,5,12,1,0,18,444
820420215,424,30,8,4,0,0,12,478
820420216,102,12,0,2,0,5,28,149
820420217,89,0,13,0,0,12,7,121
820420218,119,8,5,0,0,6,44,182
820420219,371,18,3,6,1,6,27,432
820420220,331,20,6,6,1,2,12,378
820420221,418,21,8,1,1,1,3,453
820420222,299,18,6,1,0,2,13,339
820420301,67,4,0,0,1,20,2,94
820420302,163,0,1,0,3,31,84,282
820420303,68,8,0,0,3,5,40,124
820420304,72,2,0,0,1,3,45,123
820420305,100,3,3,2,0,2,5,115
820420306,83,7,3,8,2,2,18,123
820420307,45,5,0,0,0,0,9,59
820420308,196,0,0,7,2,7,29,241
820420309,155,2,2,6,0,3,21,189
820420310,231,5,15,1,2,8,9,271
820420311,282,16,8,2,1,9,10,328
820420312,354,1,7,3,0,26,20,411
820420313,529,2,7,11,1,4,13,567
820420314,313,1,4,4,5,6,20,353
820420315,303,8,3,8,0,0,26,348
820420316,354,18,13,5,17,6,25,438
820420317,250,5,12,5,32,3,5,312
820420318,377,9,6,12,3,4,23,434
820420319,176,1,11,20,0,4,8,220
820420320,25,1,0,0,0,1,9,36
820420321,27,6,1,0,0,4,6,44
820420322,25,0,0,0,0,5,31,61
820420323,271,11,6,0,3,6,9,306
820420324,221,0,8,3,0,10,12,254
820420401,411,21,10,10,8,5,29,494
820420402,532,17,4,9,3,3,19,587
820420403,460,14,5,3,0,2,6,490
820420404,422,22,6,11,3,0,14,478
820420405,216,15,9,4,5,1,7,257
820420406,330,12,21,4,8,2,15,392
820420407,231,6,9,2,0,1,8,257
820420408,386,22,8,13,2,8,9,448
820420409,274,15,10,1,7,0,8,315
820420410,213,15,9,1,7,2,13,260
820420411,154,13,3,1,3,0,8,182
820420412,198,9,1,4,3,1,3,219
820420413,364,12,2,3,0,0,19,400
820420414,251,17,2,6,1,0,20,297
820420415,335,10,5,15,3,0,21,389
820420416,197,16,9,1,2,0,8,233
820420417,474,27,15,11,4,2,15,548
820420418,292,8,4,7,6,27,12,356
820420419,273,16,0,0,0,0,5,294
820420420,36,0,0,0,0,1,0,37
820420421,401,15,11,13,1,0,3,444
820420501,405,40,2,9,0,0,5,461
820420502,372,0,8,15,3,5,32,435
820420503,445,24,5,2,1,1,13,491
820420504,188,7,1,4,1,0,14,215
820420505,244,22,8,1,8,2,9,294
820420506,335,21,8,12,1,3,10,390
820420507,326,4,6,13,1,5,22,377
820420508,418,20,2,11,3,0,27,481
820420509,176,2,9,2,0,0,2,191
820420601,291,10,10,1,0,0,11,323
820420602,222,9,4,7,1,0,17,260
820420603,379,11,7,6,0,1,18,422
820420604,373,19,7,9,1,3,21,433
820420605,322,14,2,11,1,2,19,371
820420606,396,24,5,14,1,1,36,477
820420607,310,21,12,6,1,1,19,370
820420608,342,41,6,3,2,4,28,426
820420609,124,8,5,2,0,0,9,148
820420610,429,16,8,13,2,6,39,513
820420611,347,39,11,2,4,2,20,425
820420612,300,34,15,15,8,0,20,392
820420613,316,30,5,7,2,0,20,380
820420614,255,8,5,1,10,1,9,289
820420615,97,6,2,1,2,0,5,113
820420616,260,20,5,8,0,1,15,309
820420617,210,7,1,3,0,0,17,238
820420618,252,21,2,4,0,1,5,285
820420619,310,25,3,33,2,4,15,392
820420620,347,13,6,12,4,36,16,434
820420621,243,28,2,4,0,9,16,302
820420622,225,22,10,2,0,2,4,265
820420701,275,28,1,25,0,51,14,394
820420702,254,20,2,9,0,0,7,292
820420703,200,11,1,5,2,0,14,233
820420704,385,22,5,5,3,1,5,426
820420705,425,12,2,1,0,1,9,450
820420706,375,33,10,7,5,2,3,435
820420707,372,39,16,6,12,1,18,464
820420708,241,32,12,2,0,2,11,300
820420709,267,19,13,1,7,2,12,321
820420710,327,29,11,6,9,1,17,400
820420711,289,11,3,3,0,0,11,317
820420712,318,34,15,8,27,5,18,425
820420713,245,46,8,3,4,5,8,319
820420714,351,40,5,7,9,1,10,423
820420715,419,13,5,19,1,13,27,497
820420716,428,20,5,15,5,1,9,483
820420717,399,25,11,9,0,2,8,454
820420718,256,28,7,0,2,0,8,301
820420719,191,12,3,3,4,1,14,228
820420720,218,14,6,3,2,0,1,244
820420721,225,19,3,2,3,0,7,259
820420801,288,37,15,5,7,1,35,388
820420802,354,60,11,4,6,6,54,495
820420803,237,91,19,2,25,2,23,399
820420804,270,2,34,7,34,14,51,412
820420805,369,49,25,5,15,7,66,536
820420806,298,34,16,15,7,1,31,402
820420807,260,23,13,2,34,11,26,369
820420808,295,31,27,3,29,15,35,435
820420809,323,43,21,7,23,2,17,436
820420810,336,5,25,2,2,0,15,385
820420811,290,13,5,8,2,2,11,331
820420901,426,42,8,24,2,1,6,509
820420902,284,1,1,9,4,2,26,327
820420903,508,27,22,8,5,2,22,594
820420904,211,10,16,4,5,0,8,254
820420905,344,25,2,3,1,0,4,379
820420906,520,3,7,10,2,4,33,579
820420907,393,13,9,5,3,3,12,438
820420908,247,17,5,1,7,2,6,285
820420909,402,24,17,5,16,3,16,483
820420910,189,10,28,0,17,3,14,261
820420911,234,24,14,2,12,2,18,306
820420912,253,12,23,7,22,3,4,324
820420913,238,10,7,3,2,0,16,276
820420914,274,21,3,2,3,2,16,321
820420915,222,11,6,0,2,3,9,253
820420916,501,6,6,26,1,1,15,556
820420917,326,1,16,16,1,2,13,375
820420918,298,40,12,4,28,2,31,415
820420919,322,18,10,3,1,21,14,389
820420920,281,13,7,10,0,4,9,324
820420921,464,23,11,16,0,3,10,527
820420922,395,41,1,5,0,0,4,446
820420923,488,9,9,14,0,6,27,553
820420924,229,18,6,3,1,0,12,269
820420925,289,20,6,2,3,1,10,331
820420926,254,10,3,12,1,0,17,297
820421001,243,16,10,3,0,2,12,286
820421002,429,19,9,11,6,2,9,485
820421003,323,7,13,4,1,1,16,365
820421004,347,10,4,6,3,1,12,383
820421005,244,1,7,1,3,2,9,267
820421006,244,12,3,3,0,0,1,263
820421007,330,5,5,1,0,1,14,356
820421008,401,13,12,5,0,7,13,451
820421009,216,18,5,6,1,0,2,248
820421010,385,10,3,2,0,1,9,410
820421011,666,23,4,1,1,0,6,701
820421012,306,8,6,6,0,1,7,334
820421013,269,19,5,12,1,0,3,309
820421014,213,7,6,0,2,1,8,237
820421015,350,13,3,2,5,0,10,383
820421016,419,11,4,5,0,0,8,447
820421102,20,19,0,0,0,3,12,54
820421103,114,4,0,0,2,2,21,143
820421104,19,3,0,0,0,0,21,43
820421105,329,24,10,2,4,6,29,404
820421106,353,24,11,5,1,3,21,418
820421107,34,0,0,0,0,14,60,108
820421108,234,23,3,4,0,2,30,296
820421109,304,18,22,1,6,7,29,387
820421110,193,21,2,2,2,3,16,239
820421111,202,29,5,21,4,15,60,336
820421112,215,10,2,1,0,1,22,251
820421113,241,7,10,4,0,2,7,271
820421114,277,20,17,4,7,2,16,343
820421115,309,19,16,3,4,3,11,365
820421116,359,30,4,2,2,8,12,417
820421117,89,20,0,0,0,2,45,156
820421118,303,25,5,10,0,0,23,366
820421119,246,4,6,4,2,1,32,295
820421120,262,5,8,11,3,3,4,296
820421121,220,9,1,4,0,0,9,243
820421201,102,15,4,1,1,11,11,145
820421202,72,17,0,0,1,4,21,115
820421203,452,18,7,10,2,4,17,510
820421204,315,16,9,9,0,5,13,367
820421205,297,21,3,5,3,1,15,345
820421206,268,13,5,7,6,3,7,309
820421207,279,21,4,10,1,2,10,327
820421208,401,21,7,9,1,5,17,461
820421209,120,12,0,2,0,11,78,223
820421210,461,11,7,1,0,0,9,489
820421211,338,36,8,6,2,2,17,409
820421212,385,16,3,1,0,0,10,415
820421213,281,12,1,5,2,2,19,322
820421214,388,21,1,6,0,1,9,426
820421215,30,5,0,0,1,7,34,77
820421216,335,13,5,6,2,7,26,394
820429101,15,12,0,0,0,1,39,67
820490101,403,10,0,2,0,0,20,435
820490102,649,40,8,9,8,3,12,729
820490103,151,7,0,0,0,0,11,169
820490104,13,1,0,0,0,1,2,17
820490105,87,24,0,0,0,0,31,142
820490106,28,3,1,0,0,2,5,39
820490107,172,8,0,3,0,0,6,189
820490108,417,17,1,2,2,3,12,454
820490109,348,23,1,1,1,0,16,390
820490110,146,7,0,1,0,0,4,158
820490111,61,6,0,0,0,4,4,75
820490112,267,9,2,1,1,5,19,304
820490113,39,10,0,0,0,1,5,55
820490114,90,13,0,1,0,0,6,110
820490115,42,3,0,0,0,0,4,49
820490116,676,17,1,4,0,2,13,713
820490117,323,17,6,4,0,0,15,365
820490118,368,6,2,5,7,1,13,402
820490119,284,6,2,2,0,1,7,302
820490120,16,4,0,0,0,6,2,28
820490121,521,12,0,5,0,0,9,547
820490122,49,1,0,0,0,0,6,56
820490123,613,26,6,9,10,3,17,684
820490124,338,18,1,10,13,4,12,396
820490125,308,13,2,1,0,1,8,333
820490126,71,26,0,0,0,0,4,101
820490127,170,11,0,2,1,0,10,194
820490128,348,6,3,1,0,0,9,367
820490201,249,11,0,0,0,1,15,276
820490202,271,13,0,3,0,2,27,316
820490203,34,9,0,0,0,0,1,44
820490204,4,4,0,0,0,0,3,11
820490205,28,2,0,0,0,0,9,39
820490206,9,2,0,0,0,0,2,13
820490207,11,0,0,0,0,0,6,17
820490208,12,2,0,0,0,0,5,19
820490209,25,7,0,0,0,0,5,37
820490210,56,12,0,0,0,0,5,73
820490211,8,0,0,0,0,0,6,14
820490212,22,4,0,0,0,2,5,33
820490213,235,25,0,0,0,0,12,272
820490301,262,9,1,10,0,1,5,288
820490302,339,10,3,7,1,3,13,376
820490303,299,15,4,3,2,0,6,329
820490304,303,25,7,3,3,3,11,355
820490305,444,11,4,4,0,1,14,478
820490306,324,4,2,0,1,0,4,335
820490307,103,5,0,0,0,0,1,109
820490308,335,14,0,5,3,1,33,391
820490309,10,0,0,1,0,34,4,49
820490310,85,3,0,0,0,0,4,92
820490311,202,2,0,2,0,0,10,216
820490312,36,5,0,0,0,1,6,48
820490313,117,10,1,0,0,1,0,129
820490314,32,23,0,0,0,0,2,57
820490315,69,1,0,0,0,0,3,73
820490316,12,4,1,0,0,0,1,18
820490317,23,4,0,0,0,0,4,31
820490318,22,0,0,0,0,0,6,28
820490319,49,7,0,0,0,0,1,57
820490320,23,3,0,2,0,5,3,36
820490321,31,1,0,0,0,0,3,35
820490322,23,5,0,0,0,0,1,29
820490323,92,1,0,1,0,2,9,105
820490324,137,8,0,0,0,1,10,156
820490325,34,1,0,0,0,0,4,39
820490326,398,8,0,1,0,0,12,419
820490327,86,8,0,4,0,0,4,102
820490328,97,2,0,0,0,0,3,102
820490329,335,13,6,5,0,5,7,371
820490330,306,12,2,8,2,1,17,348
820490331,318,10,2,4,4,1,9,348
820490332,320,13,9,5,10,1,9,367
820490333,242,15,1,3,0,0,7,268
820490334,304,4,1,2,1,0,2,314
820490401,41,3,0,0,0,1,0,45
820490402,95,2,0,1,0,0,6,104
820490403,144,5,2,3,0,15,12,181
820490404,111,3,1,1,0,0,22,138
820490405,62,1,2,3,0,0,0,68
820490406,227,12,3,1,0,0,6,249
820490407,33,7,0,1,0,3,1,45
820490408,307,20,1,3,0,1,8,340
820490409,78,0,0,0,0,2,6,86
820490410,118,4,1,7,0,0,4,134
820490411,127,8,0,1,0,1,23,160
820490412,129,4,0,0,0,5,15,153
820490413,80,8,0,0,0,1,10,99
820490414,10,0,0,0,0,2,0,12
820490415,66,2,0,1,0,0,6,75
820490416,193,16,0,0,0,0,4,213
820490417,7,0,0,0,0,0,2,9
820490418,101,4,0,0,0,1,11,117
820490419,3,0,0,0,0,0,2,5
820490501,22,8,0,0,0,0,1,31
820490502,71,4,0,0,0,2,12,89
820490503,46,4,0,1,0,3,2,56
820490504,132,2,0,3,0,0,7,144
820490505,75,0,0,0,0,0,8,83
820490506,75,3,0,0,0,8,6,92
820490507,90,7,0,0,0,0,0,97
820490508,59,3,0,0,0,14,3,79
820490509,302,29,8,15,1,5,20,380
820490510,726,26,2,9,0,1,6,770
820490511,292,8,2,11,2,0,3,318
820490512,291,10,1,4,0,0,6,312
820490513,369,31,8,5,5,1,16,435
820490514,539,20,3,13,0,1,14,590
820490515,267,11,3,4,1,1,6,293
820490516,369,16,5,0,1,1,9,401
820490517,258,12,9,9,4,1,6,299
820490518,296,0,1,9,0,2,11,319
820490519,4,0,0,0,0,56,0,60
820490520,1,3,0,0,0,4,2,10
820490521,202,6,3,5,1,0,0,217
820490522,336,13,5,2,0,0,9,365
820490523,161,5,0,4,0,0,3,173
820490524,410,10,3,7,3,3,9,445
820490525,299,9,3,11,8,2,12,344
820490526,303,20,1,2,1,0,4,331
820490527,481,15,0,1,3,2,14,516
820490601,249,3,1,1,1,0,6,261
820490602,281,5,1,3,1,0,11,302
820490603,457,42,7,2,6,1,16,531
820490604,452,10,12,5,2,0,31,512
820490605,376,27,6,1,0,0,5,415
820490606,314,38,5,0,2,1,7,367
820490607,127,1,0,1,0,0,1,130
820490608,450,15,1,4,1,0,1,472
820490609,126,14,6,10,0,1,6,163
820490610,368,16,14,1,7,2,8,416
820490611,270,46,15,4,3,1,11,350
820490612,229,44,11,1,20,1,20,326
820490613,297,30,4,2,13,2,25,373
820490614,187,21,6,2,3,3,4,226
820490615,235,20,5,5,4,0,6,275
820490616,336,36,8,3,9,2,8,402
820490701,293,13,0,2,0,1,7,316
820490702,307,25,9,2,2,0,12,357
820490703,219,24,2,0,7,2,8,262
820490704,257,13,8,0,0,0,4,282
820490705,243,12,1,0,1,2,5,264
820490706,394,24,1,0,2,0,12,433
820490707,492,29,4,7,1,3,13,549
820490708,427,21,3,5,3,0,8,467
820490709,410,20,8,1,3,1,14,457
820490710,272,18,16,2,5,2,8,323
820490711,256,12,4,3,9,0,11,295
820490712,444,50,3,2,24,3,34,560
820490713,204,23,4,3,14,0,12,260
820490714,232,13,1,1,0,0,9,256
820490715,475,25,9,5,3,1,8,526
820490716,407,8,2,2,1,0,1,421
820490717,473,17,8,4,3,3,4,512
820490718,565,45,4,34,3,1,18,670
820490719,457,6,0,1,0,3,6,473
820490801,136,7,0,2,0,4,23,172
820490802,57,2,0,0,0,0,0,59
820490803,119,4,5,0,0,3,4,135
820490804,3,2,0,1,0,8,2,16
820490805,10,4,0,0,0,2,2,18
820490806,84,10,21,4,1,5,76,201
820490807,75,1,1,0,0,4,21,102
820490808,88,10,0,2,1,19,16,136
820490809,88,5,0,3,0,8,6,110
820490810,231,13,0,1,0,4,16,265
820490811,0,0,0,0,0,0,0,0
820490812,51,3,0,1,0,10,7,72
820490813,9,1,0,0,0,0,0,10
820490814,74,1,0,1,0,0,2,78
820490815,44,0,0,0,0,1,5,50
820490816,17,0,0,0,0,3,7,27
820490817,47,3,0,0,2,0,1,53
820490818,136,0,0,0,0,2,10,148
820490819,79,6,0,0,2,2,1,90
820490901,108,5,1,4,0,1,0,119
820490902,28,9,0,0,0,1,10,48
820490903,122,11,0,0,1,1,3,138
820490904,93,1,0,0,0,10,25,129
820490905,102,3,0,2,1,4,12,124
820490906,494,17,1,6,2,1,14,535
820490907,230,6,3,1,0,0,14,254
820490908,277,10,2,4,0,2,3,298
820490909,75,11,0,0,0,6,6,98
820490910,105,2,1,2,5,2,10,127
820490911,103,8,0,0,0,0,16,127
820490912,74,3,0,0,0,3,15,95
820490913,204,4,0,0,0,11,21,240
820490914,294,10,5,0,0,1,6,316
820490915,323,12,3,4,1,1,18,362
820490916,284,21,4,3,1,1,4,318
820491001,265,12,2,2,1,1,16,299
820491002,256,10,4,4,3,2,11,290
820491003,286,5,1,0,0,0,2,294
820491004,342,12,0,0,0,0,1,355
820491005,430,15,10,5,1,0,4,465
820491006,252,7,0,0,1,0,5,265
820491007,680,19,14,20,2,1,17,753
820491008,372,14,4,3,3,0,0,396
820491009,357,7,6,7,0,1,5,383
820491010,364,18,6,6,3,1,12,410
820491011,398,17,1,10,0,4,8,438
820491012,317,13,11,5,0,3,7,356
820491013,268,6,5,7,0,0,6,292
820491014,604,12,8,16,0,9,23,672
820491015,426,15,6,10,1,3,9,470
820491016,443,17,6,10,0,14,12,502
820491017,491,15,2,7,0,5,21,541
820491018,382,10,11,23,0,9,5,440
820491019,513,17,7,10,2,15,31,595
820560101,306,29,4,5,1,8,23,376
820560102,61,5,0,0,0,2,37,105
820560103,325,28,5,8,2,3,15,386
820560104,211,20,3,7,1,19,12,273
820560105,336,37,6,17,0,10,16,422
820560106,109,6,0,2,1,60,20,198
820560107,13,2,0,0,0,3,0,18
820560108,276,11,3,4,0,1,13,308
820560109,273,11,4,4,1,3,10,306
820560110,103,12,0,0,0,6,40,161
820560111,256,58,3,18,0,31,20,386
820560112,130,5,8,25,1,159,13,341
820560113,131,20,10,5,3,174,11,354
820560114,79,15,1,1,0,29,37,162
820560115,245,7,1,1,3,2,4,263
820560116,214,7,1,6,3,2,16,249
820560117,308,21,6,32,2,134,44,547
820560118,102,16,5,6,0,93,9,231
820560201,173,5,0,1,1,4,86,270
820560202,320,11,4,14,0,0,12,361
820560203,236,18,2,5,2,3,10,276
820560204,367,17,3,4,4,1,14,410
820560205,381,14,6,9,6,8,19,443
820560206,329,11,2,3,1,3,4,353
820560207,180,9,1,1,0,3,18,212
820560208,175,5,0,0,0,28,70,278
820560209,105,2,0,6,0,1,3,117
820560210,311,3,0,3,1,1,17,336
820560211,80,9,0,0,0,0,96,185
820560212,107,9,2,4,0,8,11,141
820560213,81,0,1,0,0,13,35,130
820560214,142,4,1,1,1,2,10,161
820560215,468,18,9,4,7,1,13,520
820560216,228,2,1,1,1,1,15,249
820560217,264,12,1,8,4,3,19,311
820560218,328,9,3,6,1,2,4,353
820560219,287,9,1,5,3,3,5,313
820560301,372,16,7,4,2,1,22,424
820560302,147,19,1,7,2,8,97,281
820560303,498,19,3,17,3,0,12,552
820560304,218,7,1,5,3,1,8,243
820560305,397,23,2,2,2,2,14,442
820560306,249,19,7,6,18,0,14,313
820560307,277,10,7,6,4,2,11,317
820560308,212,51,3,3,0,38,140,447
820560309,255,18,3,4,0,1,20,301
820560310,221,5,7,0,0,0,11,244
820560311,532,28,8,14,1,5,20,608
820560312,90,14,0,0,0,25,45,174
820560313,97,6,0,0,0,12,38,153
820560314,88,9,0,0,0,27,30,154
820560401,405,27,10,15,2,12,19,490
820560402,368,6,5,9,1,2,15,406
820560403,326,11,4,1,5,0,14,361
820560404,269,16,7,3,5,0,25,325
820560405,397,32,6,4,4,1,36,480
820560406,289,24,21,3,25,4,14,380
820560407,174,16,6,3,5,0,23,227
820560408,258,24,11,3,16,5,14,331
820560409,315,19,10,3,8,2,22,379
820560410,248,14,2,1,2,0,10,277
820560411,305,34,8,4,5,0,13,369
820560412,224,9,4,2,4,0,4,247
820560413,169,20,12,7,11,0,6,225
820560414,485,17,2,11,2,2,18,537
820560415,238,9,1,9,0,4,3,264
820560501,148,0,4,7,1,71,11,242
820560502,500,13,9,7,3,6,12,550
820560503,321,6,2,10,0,1,10,350
820560504,268,1,3,2,4,0,17,295
820560505,367,15,23,7,7,1,25,445
820560506,233,9,4,2,1,1,16,266
820560507,452,12,2,5,0,0,20,491
820560508,180,15,8,4,2,0,20,229
820560509,397,22,0,1,1,0,9,430
820560510,269,18,2,3,2,0,4,298
820560511,408,10,0,1,0,1,16,436
820560512,294,7,1,4,0,0,13,319
820560513,262,10,1,16,0,20,21,330
820560514,314,22,4,20,2,3,12,377
820560515,220,4,2,6,0,3,9,244
820560516,246,5,3,3,0,0,15,272
820630101,219,2,1,16,5,7,11,261
820630102,20,0,0,0,0,0,4,24
820630103,325,16,5,11,8,3,14,382
820630104,279,6,2,5,8,0,18,318
820630105,377,8,4,4,1,1,1,396
820630106,101,5,1,0,0,28,32,167
820630107,269,7,7,16,1,9,20,329
820630108,77,4,2,2,2,0,6,93
820630109,285,7,2,7,2,0,9,312
820630110,357,11,0,9,0,2,11,390
820630111,150,8,3,1,0,10,16,188
820630112,89,9,1,1,2,31,47,180
820630113,37,4,2,0,0,6,23,72
820630114,98,1,0,0,2,14,49,164
820630115,50,0,0,0,1,3,5,59
820630116,29,2,0,0,0,3,8,42
820630117,31,12,0,0,0,1,5,49
820630118,261,15,1,4,3,2,27,313
820630119,398,22,9,2,1,3,11,446
820630120,275,10,5,7,2,1,8,308
820630121,210,17,3,8,3,3,9,253
820630122,343,9,3,13,4,0,23,395
820630123,249,7,7,15,1,11,3,293
820630124,243,3,0,6,2,0,4,258
820630125,303,8,4,4,1,3,6,329
820630126,485,24,9,21,1,25,17,582
820630127,298,11,8,11,1,3,4,336
820630128,324,10,0,4,1,3,6,348
820630129,541,24,4,14,1,9,33,626
820630201,88,0,4,7,2,0,11,112
820630202,37,5,1,0,0,8,11,62
820630203,22,4,0,0,0,4,9,39
820630204,314,18,2,2,1,3,19,359
820630205,289,11,2,1,3,3,12,321
820630206,321,12,6,5,2,0,13,359
820630207,382,20,4,4,2,2,12,426
820630208,459,12,4,6,1,0,14,496
820630209,271,14,6,3,5,2,5,306
820630210,261,11,3,6,15,1,29,326
820630211,258,15,2,2,3,1,9,290
820630212,380,19,4,5,1,0,18,427
820630213,391,10,4,47,1,0,26,479
820630214,71,8,1,6,0,11,12,109
820630215,78,24,0,3,1,1,2,109
820630216,219,7,7,4,1,9,4,251
820630217,24,6,0,0,0,5,66,101
820630218,49,5,1,2,0,16,8,81
820630219,45,17,4,1,1,111,18,197
820630220,286,16,2,38,0,7,15,364
820630221,463,2,9,11,7,3,17,512
820630222,387,18,3,6,1,11,18,444
820630223,96,3,2,5,0,3,12,121
820630224,91,3,0,6,1,1,9,111
820630225,164,4,1,2,1,0,5,177
820630226,71,26,2,5,1,46,9,160
820630227,83,8,0,1,0,15,14,121
820630228,80,4,0,9,0,1,6,100
820630229,25,1,0,0,0,3,4,33
820630230,28,11,0,1,0,2,16,58
820630231,287,24,3,2,0,2,7,325
820630232,372,9,3,9,1,4,13,411
820630301,174,8,7,3,0,153,20,365
820630302,217,42,3,7,0,69,34,372
820630303,164,39,6,18,4,222,46,499
820630304,1,3,0,0,0,0,0,4
820630305,202,18,2,4,4,60,23,313
820630306,188,21,0,2,0,13,8,232
820630307,339,29,16,12,3,88,48,535
820630308,269,12,6,6,0,31,23,347
820630309,318,26,11,16,1,60,22,454
820630310,348,11,0,2,7,23,17,408
820630311,396,15,3,12,0,12,41,479
820630312,420,36,7,27,0,66,16,572
820630313,215,31,1,4,0,27,31,309
820630314,330,15,4,10,0,39,42,440
820630315,217,14,0,2,1,2,4,240
820630316,358,9,3,6,1,1,21,399
820630317,308,43,14,16,0,70,71,522
820630318,10,0,0,0,0,0,0,10
820630319,397,19,1,12,4,13,28,474
820630320,2,0,0,0,0,0,0,2
820630321,0,1,0,0,0,0,0,1
820630322,321,64,6,18,3,146,73,631
820630323,236,7,3,9,1,33,6,295
820630324,409,59,10,9,3,126,27,643
820630325,351,35,1,8,4,28,26,453
820630326,211,41,6,17,0,68,12,355
820630327,211,23,13,21,1,131,70,470
820630401,14,1,0,6,0,7,4,32
820630402,357,6,1,0,0,1,7,372
820630403,116,5,0,0,1,0,1,123
820630404,364,12,0,2,1,0,4,383
820630405,58,2,0,0,0,1,3,64
820630406,5,0,0,0,0,4,4,13
820630407,253,3,0,3,1,2,5,267
820630408,198,18,1,0,1,1,3,222
820630409,737,12,1,1,1,2,44,798
820630410,820,10,7,2,1,2,28,870
820630411,251,27,1,3,0,37,16,335
820630412,514,18,1,1,0,0,8,542
820630501,501,3,0,4,0,0,2,510
820630502,387,0,0,0,0,0,2,389
820630503,265,0,0,0,0,0,9,274
820630504,292,0,0,1,0,0,5,298
820630505,266,2,0,0,4,0,7,279
820630506,532,1,1,4,0,0,6,544
820630507,235,0,0,1,0,0,4,240
820630508,378,5,3,0,0,0,10,396
820630509,549,2,1,1,2,0,24,579
820630510,191,4,0,1,0,0,11,207
820630511,320,0,0,0,0,0,15,335
820630512,223,4,16,6,6,0,14,269
820630513,288,0,0,1,1,0,8,298
820630601,387,11,2,3,1,0,9,413
820630602,296,6,2,3,0,0,6,313
820630603,409,10,7,5,1,1,10,443
820630604,349,9,6,4,0,1,14,383
820630605,201,3,3,1,0,0,3,211
820630606,245,6,0,0,0,0,3,254
820630607,213,2,7,1,0,2,5,230
820630608,204,6,1,4,1,0,8,224
820630609,429,10,5,12,8,0,21,485
820630610,211,6,6,1,0,0,8,232
820630611,218,5,1,2,1,1,8,236
820630612,237,3,2,1,1,0,9,253
820630613,263,8,3,5,1,1,1,282
820630614,303,7,7,5,7,1,12,342
820630615,276,16,7,2,3,0,8,312
820630616,286,16,3,5,2,0,14,326
820630617,290,16,16,2,3,0,17,344
820630618,217,22,6,1,1,0,14,261
820630701,286,5,3,0,1,5,7,307
820630702,242,5,7,5,0,0,6,265
820630703,196,36,15,2,7,8,16,280
820630704,418,24,22,2,6,1,13,486
820630705,412,15,15,9,6,5,27,489
820630706,460,2,20,6,2,1,28,519
820630707,283,18,9,7,3,10,9,339
820630708,240,21,5,2,0,0,7,275
820630709,232,10,5,1,7,1,4,260
820630710,238,0,7,5,10,2,21,283
820630711,268,2,5,7,1,3,6,292
820630712,282,10,16,8,2,9,14,341
820630713,309,4,6,10,0,7,7,343
820630714,212,0,5,3,1,1,13,235
820630801,231,15,8,7,3,2,11,277
820630802,321,15,5,1,3,0,7,352
820630803,250,12,2,4,3,0,12,283
820630804,263,13,16,4,5,1,19,321
820630805,232,7,6,3,3,0,9,260
820630806,254,7,2,2,2,0,6,273
820630807,221,12,2,2,1,0,18,256
820630808,281,19,13,1,3,0,11,328
820630809,258,9,8,5,2,1,5,288
820630810,299,12,10,5,3,2,7,338
820630811,264,11,3,4,3,0,7,292
820630812,318,23,7,7,3,3,19,380
820630813,198,7,10,2,2,0,8,227
820630814,219,11,2,1,0,1,7,241
820630901,392,15,7,5,2,0,8,429
820630902,235,9,0,3,1,0,7,255
820630903,355,12,7,3,9,1,16,403
820630904,222,13,5,6,0,0,13,259
820630905,233,5,6,1,0,0,13,258
820630906,332,19,8,3,4,1,6,373
820630907,235,6,5,3,1,0,9,259
820630908,350,8,4,3,3,0,15,383
820630909,278,18,8,3,2,0,16,325
820630910,331,5,10,2,1,0,22,371
820631001,264,12,8,5,0,0,11,300
820631002,357,9,5,2,3,1,9,386
820631003,228,3,0,2,1,0,8,242
820631004,198,4,3,1,0,0,4,210
820631005,227,6,5,0,0,0,10,248
820631006,235,12,3,3,11,3,7,274
820631007,390,14,5,2,0,0,4,415
820631008,456,19,0,2,4,0,4,485
820631009,298,7,1,0,5,1,8,320
820631010,338,20,5,2,26,1,5,397
820631011,364,10,0,5,1,0,21,401
820631012,196,3,3,1,4,0,7,214
820631013,399,16,3,1,0,1,8,428
820631101,369,3,0,4,1,0,8,385
820631102,268,2,2,2,1,0,7,282
820631103,351,0,2,1,0,0,1,355
820631104,225,7,1,2,12,0,3,250
820631105,319,9,4,9,27,0,41,409
820631106,393,3,4,0,0,0,12,412
820631107,587,0,9,4,4,0,16,620
820631108,192,3,3,3,0,1,9,211
820631109,110,3,1,1,0,2,10,127
820631110,369,6,2,3,1,0,15,396
820631111,350,1,4,1,2,0,3,361
820631112,219,2,3,0,0,0,7,231
820631113,299,4,1,1,0,0,5,310
820631114,231,0,0,0,0,0,29,260
820631115,334,16,0,1,0,0,4,355
820631116,277,11,1,3,1,0,23,316
820631117,245,0,1,1,1,0,3,251
820631118,276,3,1,2,0,1,10,293
820631119,199,10,0,0,0,0,4,213
820631201,327,25,5,2,2,0,9,370
820631202,192,6,8,2,0,0,2,210
820631203,157,3,0,0,0,0,4,164
820631204,314,15,1,4,0,0,5,339
820631205,205,4,0,0,0,1,2,212
820631206,87,19,2,0,0,0,7,115
820631207,354,21,7,1,0,0,10,393
820631208,359,10,3,1,5,0,11,389
820631209,381,10,10,8,4,1,21,435
820631210,241,1,1,1,0,0,5,249
820631211,188,26,10,4,1,1,10,240
820631212,282,14,14,2,5,0,21,338
820631213,213,26,6,3,2,1,13,264
820631214,238,5,1,0,0,0,4,248
820631215,160,0,0,0,0,0,7,167
820631301,262,7,4,0,15,0,13,301
820631302,339,12,8,1,2,0,12,374
820631303,165,10,5,4,3,0,4,191
820631304,290,8,9,3,3,0,18,331
820631305,246,12,8,4,2,0,11,283
820631306,225,4,20,2,6,0,8,265
820631307,244,10,3,2,4,2,11,276
820631308,219,1,3,1,0,0,0,224
820631309,387,7,3,1,0,2,11,411
820631310,213,7,8,0,0,0,2,230
820631311,256,6,3,6,7,0,13,291
820631312,285,9,1,4,5,1,7,312
820631313,354,11,10,2,16,1,37,431
820631314,274,8,2,3,1,0,6,294
820631315,351,8,12,4,5,1,8,389
820631316,389,12,12,4,6,1,16,440
820631317,358,9,11,8,1,2,13,402
820631318,260,8,6,2,3,1,11,291
820631319,212,8,1,1,2,0,2,226
820631320,212,9,2,3,0,0,15,241
820631401,291,17,9,8,8,0,30,363
820631402,370,20,5,4,3,4,9,415
820631403,367,9,15,4,5,2,13,415
820631404,330,18,13,3,5,2,17,388
820631405,276,16,4,3,1,0,4,304
820631406,266,27,15,6,4,1,7,326
820631407,273,21,26,1,4,1,10,336
820631408,296,22,5,2,1,2,12,340
820631409,349,49,8,4,6,1,13,430
820631410,330,25,11,2,11,1,13,393
820631411,317,33,5,3,6,1,16,381
820631501,349,24,7,7,1,1,41,430
820631502,282,15,13,3,1,0,7,321
820631503,291,38,8,2,2,1,12,354
820631504,235,9,9,7,6,1,20,287
820631505,299,22,7,3,2,0,27,360
820631506,186,8,6,8,2,0,6,216
820631507,262,34,2,5,12,0,15,330
820631508,250,11,6,9,1,1,19,297
820631509,264,21,4,4,12,1,18,324
820631510,327,25,15,3,3,0,8,381
820631511,267,20,8,4,1,1,30,331
820631512,307,6,1,3,6,1,16,340
820631513,156,21,5,2,5,1,20,210
820631601,301,15,7,3,2,2,13,343
820631602,318,3,12,3,3,0,16,355
820631603,384,20,20,9,0,2,10,445
820631604,242,15,1,4,3,1,14,280
820631605,218,6,18,5,5,1,10,263
820631606,232,31,9,0,0,10,7,289
820631607,166,9,10,4,8,0,5,202
820631608,331,10,14,3,3,1,12,374
820631609,220,1,2,1,0,1,4,229
820631610,360,27,6,4,7,0,13,417
820631611,230,1,4,0,0,0,8,243
820631612,240,5,4,4,12,0,23,288
820631701,350,20,12,5,5,4,19,415
820631702,445,35,7,3,4,2,23,519
820631703,205,8,1,0,0,0,0,214
820631704,170,17,7,5,0,0,12,211
820631705,336,24,4,9,3,2,21,399
820631706,308,30,7,8,1,2,7,363
820631707,237,26,17,2,4,1,13,300
820631708,288,11,9,5,7,3,18,341
820631709,277,19,2,4,4,1,13,320
820631710,281,1,5,4,5,2,13,311
820631711,306,22,18,2,6,0,12,366
820631712,265,45,8,2,4,7,18,349
820631713,311,13,8,9,7,2,27,377
820631714,313,2,17,4,5,3,20,364
820631801,320,47,44,6,6,2,24,449
820631802,380,103,31,8,20,8,43,593
820631803,307,78,21,2,4,0,19,431
820631804,264,65,14,1,13,3,17,377
820631805,94,14,17,2,19,5,11,162
820631806,250,38,18,4,28,1,15,354
820631807,454,18,43,6,61,51,29,662
820631808,336,62,42,6,63,3,27,539
820631809,214,73,22,2,9,5,31,356
820631810,260,92,28,2,7,7,27,423
820631811,336,100,11,2,12,1,34,496
820631812,191,69,14,2,1,1,10,288
820631813,176,18,15,2,10,2,38,261
820631901,296,7,2,1,0,0,9,315
820631902,243,11,4,4,0,0,21,283
820631903,355,14,12,6,3,1,9,400
820631904,184,3,5,3,0,0,7,202
820631905,234,15,14,1,3,0,4,271
820631906,153,13,31,6,6,1,4,214
820631907,356,6,14,4,3,7,38,428
820631908,169,0,0,0,0,0,4,173
820631909,387,33,16,3,6,0,4,449
820631910,392,17,0,2,2,0,7,420
820631911,239,3,0,1,0,0,4,247
820631912,276,15,8,2,4,0,25,330
820631913,588,23,8,32,2,0,41,694
820632001,304,16,3,4,2,1,24,354
820632002,118,15,1,1,1,1,10,147
820632003,205,2,13,2,1,9,10,242
820632004,0,0,0,0,0,0,0,0
820632005,154,15,9,0,4,0,10,192
820632006,227,23,12,0,9,0,15,286
820632007,163,16,3,2,9,2,6,201
820632008,302,22,11,1,2,0,16,354
820632009,229,17,3,2,1,0,14,266
820632010,294,16,11,4,1,1,7,334
820632011,254,26,5,4,1,1,6,297
820632012,287,12,2,2,1,1,20,325
820632101,319,38,23,3,4,3,13,403
820632102,326,29,11,1,15,3,24,409
820632103,283,9,37,2,26,3,79,439
820632104,446,42,28,8,21,3,47,595
820632105,334,18,23,4,9,1,41,430
820632106,253,20,9,7,7,0,12,308
820632107,311,36,13,6,12,13,31,422
820632108,256,11,23,2,12,0,27,331
820632109,344,32,20,3,6,1,16,422
820632110,99,11,3,0,6,1,10,130
820632111,300,27,32,9,14,0,29,411
820632112,340,30,15,1,6,1,57,450
820632113,208,43,9,3,10,2,28,303
820632114,325,71,21,1,6,0,26,450
820632115,163,34,7,1,5,1,11,222
820632201,217,42,23,4,13,1,10,310
820632202,237,48,41,1,28,3,59,417
820632203,182,58,22,8,8,4,38,320
820632204,125,42,16,4,12,0,13,212
820632205,150,36,20,1,17,0,12,236
820632206,105,38,20,0,83,4,11,261
820632207,312,87,11,0,22,2,25,459
820632208,314,87,38,2,17,4,13,475
820632209,252,79,17,2,10,0,17,377
820632210,200,43,29,4,14,0,8,298
820632211,159,37,22,1,9,1,15,244
820632212,236,67,30,2,10,2,31,378
820632213,225,62,14,2,17,10,9,339
820632214,224,50,22,3,12,0,19,330
820632301,277,23,4,3,11,6,23,347
820632302,305,43,15,5,11,3,17,399
820632303,257,33,17,5,4,0,25,341
820632304,316,41,11,8,12,1,23,412
820632305,247,15,29,7,19,4,20,341
820632306,424,56,31,4,32,0,26,573
820632307,155,16,5,0,5,4,11,196
820632308,358,0,30,4,39,14,56,501
820632309,277,30,20,1,9,1,42,380
820632310,346,39,7,11,6,1,28,438
820632311,157,18,5,7,15,0,8,210
820632312,257,13,12,1,4,0,36,323
820632313,145,26,7,0,15,1,11,205
820632314,294,41,5,12,6,0,34,392
820632401,292,67,33,6,35,5,17,455
820632402,255,83,17,2,31,4,10,402
820632403,295,77,42,2,15,1,9,441
820632404,231,41,16,2,9,2,14,315
820632405,182,71,5,16,18,1,12,305
820632406,171,30,20,0,16,0,5,242
820632407,134,37,13,0,25,0,4,213
820632408,224,59,8,0,16,5,4,316
820632409,248,34,19,1,22,0,14,338
820632410,230,39,12,1,22,1,7,312
820632411,242,16,12,11,30,5,21,337
820632412,254,27,35,7,13,3,11,350
820632413,177,20,11,2,9,0,14,233
820632414,226,25,36,4,32,1,25,349
820632415,215,49,20,3,16,0,4,307
820632416,210,18,32,4,23,1,9,297
820632417,219,48,25,5,22,0,12,331
820632418,101,33,14,5,25,1,6,185
820632501,172,9,3,2,8,1,0,195
820632502,356,19,12,0,10,2,13,412
820632503,396,68,22,3,16,2,15,522
820632504,189,27,4,2,17,2,12,253
820632505,170,20,7,2,5,0,6,210
820632506,169,12,7,0,1,2,18,209
820632507,172,1,13,4,0,1,11,202
820632508,191,1,8,3,4,1,10,218
820632509,316,26,15,7,5,3,13,385
820632510,279,24,9,2,9,0,12,335
820632511,244,14,13,3,6,0,5,285
820632512,119,0,5,0,1,0,1,126
820632513,218,23,4,0,9,0,8,262
820632601,536,6,0,2,0,0,6,550
820632602,232,8,3,2,0,0,8,253
820632603,295,6,4,2,1,0,8,316
820632604,267,2,4,4,0,0,12,289
820632605,338,13,2,2,1,0,4,360
820632606,270,6,4,3,0,3,8,294
820632607,408,20,1,3,1,0,5,438
820632608,315,11,7,2,7,0,17,359
820632609,370,9,4,1,1,0,5,390
820632610,243,3,0,0,0,0,18,264
820632611,251,16,1,0,0,0,1,269
820632612,347,17,2,0,2,0,4,372
820632613,445,6,4,1,7,0,10,473
820632614,293,9,6,1,2,0,17,328
820632615,197,6,1,2,1,0,8,215
820632616,157,3,0,1,0,0,10,171
820632617,356,17,6,3,1,0,15,398
820632701,211,21,3,5,0,1,7,248
820632702,255,10,6,7,1,0,9,288
820632703,262,9,4,3,2,1,4,285
820632704,339,28,10,3,3,1,12,396
820632705,279,16,10,4,24,2,20,355
820632706,400,32,15,3,5,4,17,476
820632707,302,17,9,8,3,0,15,354
820632708,254,11,3,4,0,1,10,283
820632709,481,13,9,7,1,0,10,521
820632710,457,26,16,4,2,4,19,528
820632711,366,17,6,12,8,2,17,428
820632712,353,14,9,6,0,1,2,385
820632713,435,12,3,3,2,14,11,480
820632714,466,12,5,15,2,2,11,513
820632715,330,7,18,7,8,0,10,380
820632716,118,0,0,6,0,8,16,148
820632801,301,8,5,6,9,0,3,332
820632802,366,17,8,7,7,0,12,417
820632803,409,21,5,2,3,0,7,447
820632804,15,2,0,0,0,0,10,27
820632805,513,23,7,13,1,1,3,561
820632806,557,19,4,5,1,1,6,593
820632807,404,9,10,10,1,2,3,439
820632808,301,13,6,4,1,2,8,335
820632809,399,11,7,5,5,8,13,448
820632810,453,11,7,13,1,2,9,496
820632811,638,22,7,17,1,2,8,695
820632812,3,0,0,0,0,0,5,8
820632813,7,0,0,0,0,0,3,10
820632814,451,27,8,42,1,32,12,573
820632815,163,13,1,9,0,2,10,198
820632816,155,7,3,20,0,75,29,289
820632817,235,43,9,13,0,193,82,575
820632818,214,6,1,16,0,2,11,250
820632819,345,28,15,7,16,78,11,500
820632820,5,0,0,0,0,0,5,10
820632821,54,10,0,3,0,4,2,73
820632822,54,5,0,1,0,0,5,65
820632823,196,22,7,24,2,24,2,277
820632824,2,4,0,0,0,0,2,8
820632825,154,47,11,19,3,89,16,339
820632826,198,31,6,25,0,87,108,455
820632827,78,11,2,10,1,72,13,187
820632828,256,98,18,9,9,208,78,676
820632829,284,32,5,26,2,141,45,535
820632901,507,26,7,57,0,58,61,716
820632902,220,4,1,2,0,0,9,236
820632903,256,12,6,4,1,4,9,292
820632904,407,14,14,3,2,2,15,457
820632905,322,16,2,4,0,0,13,357
820632906,336,5,5,12,0,0,7,365
820632907,244,8,0,2,1,0,1,256
820632908,276,12,5,1,1,0,5,300
820632909,327,15,5,8,1,0,8,364
820632910,257,8,3,2,0,0,5,275
820632911,226,0,0,5,1,0,11,243
820632912,224,15,6,0,2,1,5,253
820632913,326,31,15,4,7,2,21,406
820632914,211,8,1,1,2,0,14,237
820632915,334,13,7,6,3,0,6,369
820633001,315,30,10,0,10,0,6,371
820633002,373,14,29,0,9,1,9,435
820633003,215,4,14,3,2,11,13,262
820633004,194,8,7,3,0,2,11,225
820633005,222,1,4,1,0,0,8,236
820633006,283,4,14,4,3,5,5,318
820633007,438,26,17,7,10,0,17,515
820633008,457,20,11,7,3,0,8,506
820633009,424,25,6,13,5,3,22,498
820633010,397,16,6,3,0,0,10,432
820633011,353,8,6,6,4,0,4,381
820633012,252,10,7,3,7,0,1,280
820633013,367,9,10,9,11,8,8,422
820633101,560,22,8,113,0,5,25,733
820633102,176,1,2,9,2,4,7,201
820633103,322,4,9,10,12,3,7,367
820633104,641,35,4,11,1,4,16,712
820633105,28,8,0,0,0,1,1,38
820633106,308,7,4,2,1,0,11,333
820633107,386,19,16,9,1,0,13,444
820633108,204,5,0,0,1,0,11,221
820633109,639,33,7,10,3,0,16,708
820633110,355,4,2,2,2,0,3,368
820633111,281,0,0,6,0,0,5,292
820633112,334,0,1,4,0,0,23,362
820633113,353,10,2,2,0,0,13,380
820633114,339,7,1,1,2,0,8,358
820633115,364,2,2,3,1,0,9,381
820633201,333,15,7,6,5,0,7,373
820633202,294,2,8,2,2,0,6,314
820633203,385,5,0,7,1,0,13,411
820633204,231,4,3,0,0,0,3,241
820633205,314,4,2,1,0,0,12,333
820633206,246,6,1,4,0,0,10,267
820633207,451,20,2,5,0,0,13,491
820633208,336,16,4,2,7,3,12,380
820633209,439,16,7,0,4,0,13,479
820633210,283,3,0,0,0,1,15,302
820633211,361,13,3,1,0,0,17,395
820633212,556,27,2,10,3,0,11,609
820633213,520,34,3,4,3,0,16,580
820633214,281,18,12,0,0,0,13,324
820633215,224,19,12,0,1,0,26,282
820633216,277,15,6,4,1,2,3,308
820633301,194,15,0,1,0,0,2,212
820633302,255,7,3,0,0,0,2,267
820633303,297,13,0,2,0,0,3,315
820633304,265,8,0,3,0,2,7,285
820633305,239,5,8,11,4,0,7,274
820633306,320,6,12,4,6,0,22,370
820633307,294,19,9,4,9,1,11,347
820633308,292,13,3,0,0,0,2,310
820633309,209,6,4,3,1,0,7,230
820633310,267,6,0,2,0,0,0,275
820633401,708,27,2,0,0,0,14,751
820633402,366,6,3,4,0,0,5,384
820633403,433,6,5,9,0,1,13,467
820633404,250,4,2,2,0,0,7,265
820633405,1377,24,6,9,0,0,28,1444
820633406,529,19,5,3,0,1,10,567
820633407,258,8,2,5,1,0,3,277
820633408,209,9,7,2,0,0,6,233
820633409,256,8,4,3,1,0,1,273
820633410,234,11,3,5,0,0,1,254
820633411,276,6,9,10,2,0,12,315
820633412,401,3,1,5,0,0,5,415
820633413,824,32,1,2,2,0,13,874
820633501,204,7,0,0,0,0,3,214
820633502,258,10,5,1,3,2,12,291
820633503,232,3,0,1,0,0,4,240
820633504,227,7,11,0,1,0,5,251
820633505,218,10,3,2,0,0,4,237
820633506,318,25,9,3,3,0,14,372
820633507,305,56,14,4,13,1,39,432
820633508,316,63,11,1,9,2,11,413
820633509,296,29,23,4,5,2,19,378
820700101,281,10,5,9,4,0,14,323
820700102,90,8,1,1,3,2,26,131
820700103,32,4,0,0,0,0,10,46
820700104,277,19,6,10,4,1,20,337
820700105,97,3,0,1,1,3,51,156
820700106,28,0,0,0,0,1,28,57
820700107,46,1,0,0,0,4,62,113
820700108,229,17,3,5,3,3,5,265
820700109,61,10,0,1,0,6,35,113
820700110,185,18,4,23,4,1,13,248
820700111,463,16,9,22,3,3,12,528
820700112,76,9,0,0,1,16,54,156
820700113,36,0,3,0,0,1,5,45
820700114,34,7,1,0,0,3,13,58
820700115,79,11,0,1,0,13,40,144
820700116,45,9,0,0,2,0,27,83
820700117,201,14,4,1,4,1,11,236
820700201,353,0,9,2,6,1,20,391
820700202,156,1,1,10,0,3,50,221
820700203,88,0,0,3,0,1,0,92
820700204,319,1,8,10,4,5,12,359
820700205,112,11,11,1,0,9,34,178
820700206,65,0,0,1,0,52,12,130
820700207,188,16,4,4,3,1,7,223
820700208,107,0,0,0,0,12,47,166
820700209,274,21,5,6,4,3,16,329
820700210,136,7,0,0,0,3,48,194
820700211,151,9,4,8,0,9,21,202
820700212,94,9,0,1,0,13,42,159
820700213,386,3,13,6,5,5,16,434
820700214,149,7,1,10,0,9,37,213
820700215,40,0,0,8,0,2,6,56
820700216,56,1,0,1,0,3,17,78
820700217,61,11,0,0,0,0,9,81
820700218,348,12,5,3,2,0,6,376
820700219,469,24,9,20,0,3,10,535
820700220,154,20,2,1,1,4,33,215
820700221,350,7,2,10,1,3,13,386
820700222,333,4,1,14,4,2,22,380
820700301,192,11,2,2,1,25,15,248
820700302,109,6,1,4,0,97,34,251
820700303,401,29,7,28,6,113,42,626
820700304,160,14,1,3,0,6,18,202
820700305,352,55,9,4,5,2,15,442
820700306,239,20,6,7,5,2,14,293
820700307,248,11,2,6,0,1,4,272
820700308,323,22,14,7,16,8,18,408
820700309,317,38,16,3,33,3,15,425
820700310,442,37,6,4,2,0,12,503
820700311,402,12,4,16,5,2,4,445
820700312,242,18,8,1,3,0,12,284
820700313,265,11,6,3,0,0,6,291
820700314,327,23,11,2,2,0,8,373
820700315,442,17,10,8,0,1,11,489
820700316,281,19,4,10,2,4,3,323
820700317,282,22,4,2,13,0,5,328
820700318,465,20,4,3,4,0,5,501
820700319,348,13,7,9,0,3,14,394
820700320,309,14,4,12,4,0,10,353
820700401,607,13,4,22,1,0,24,671
820700402,548,18,21,35,2,1,3,628
820700403,373,37,13,6,2,1,8,440
820700404,341,29,8,3,3,0,3,387
820700405,288,25,5,4,1,0,13,336
820700406,297,6,11,13,0,3,4,334
820700407,223,32,8,1,1,0,5,270
820700408,211,34,13,0,3,0,13,274
820700409,250,26,7,3,5,0,17,308
820700410,517,99,12,22,1,2,6,659
820700411,315,58,12,23,32,6,32,478
820700412,291,20,13,2,2,1,18,347
820700413,337,31,7,0,6,1,19,401
820700414,302,21,9,5,0,2,5,344
820700415,431,10,19,11,2,1,12,486
820700416,425,26,17,16,8,6,14,512
820700417,602,22,14,45,2,5,13,703
820700418,231,43,14,0,2,1,4,295
820700419,318,52,20,3,8,0,13,414
820700420,192,4,21,0,1,0,11,229
820700501,389,23,12,10,3,3,20,460
820700502,196,8,4,4,1,6,12,231
820700503,403,8,9,7,3,5,20,455
820700504,193,11,4,3,0,26,5,242
820700505,177,9,1,2,0,2,47,238
820700506,47,12,0,0,0,0,23,82
820700507,61,1,0,0,0,1,29,92
820700508,438,13,8,17,2,3,11,492
820700509,278,18,10,9,6,5,14,340
820700510,346,10,10,6,5,4,13,394
820700511,597,24,15,14,2,1,20,673
820700512,253,17,2,10,0,11,45,338
820700513,44,0,0,1,0,4,10,59
820700514,33,2,1,1,1,7,6,51
820700515,103,2,2,4,0,1,5,117
820700516,48,0,0,0,0,0,38,86
820700517,296,9,3,6,6,1,8,329
820700518,117,6,0,3,0,1,31,158
820700519,102,5,0,2,2,5,21,137
820700520,67,4,0,0,0,22,24,117
820700521,178,18,1,5,3,0,26,231
820700522,251,9,10,2,2,1,8,283
820700523,466,17,4,16,17,2,9,531
820700524,396,10,12,26,1,2,14,461
820700525,418,18,13,19,3,4,20,495
820700601,509,17,4,5,2,0,17,554
820700602,94,11,0,0,0,1,46,152
820700603,236,27,3,1,0,1,12,280
820700604,52,4,0,0,0,2,28,86
820700605,241,2,3,12,1,4,14,277
820700606,72,4,1,1,1,1,11,91
820700607,212,10,9,6,2,8,17,264
820700608,102,6,2,1,1,3,48,163
820700609,68,9,6,7,0,3,10,103
820700610,44,1,0,0,0,0,44,89
820700611,333,22,4,10,3,3,9,384
820700612,466,21,3,16,2,0,27,535
820700613,189,23,0,1,0,7,68,288
820700701,254,7,2,8,3,2,4,280
820700702,275,18,6,5,3,0,13,320
820700703,275,19,13,4,9,1,20,341
820700704,232,16,6,2,6,1,10,273
820700705,303,13,3,4,9,3,8,343
820700706,235,7,6,2,3,2,8,263
820700707,300,4,8,8,4,0,24,348
820700708,479,11,3,8,2,4,7,514
820700709,102,12,0,1,1,4,21,141
820700710,219,14,3,5,0,1,16,258
820700711,54,1,0,1,0,5,29,90
820700712,336,23,3,13,3,1,11,390
820700713,290,16,3,6,0,1,12,328
820700714,51,6,0,1,0,5,29,92
820700715,366,11,5,20,2,1,20,425
820700716,250,10,3,10,0,3,12,288
820700717,316,8,9,9,7,1,8,358
820700718,296,12,9,22,14,1,10,364
820770101,106,19,0,5,0,1,9,140
820770102,92,22,0,0,0,3,21,138
820770103,367,53,3,17,7,2,21,470
820770104,134,27,0,0,0,0,16,177
820770105,103,19,1,1,1,7,5,137
820770106,259,35,1,3,0,0,10,308
820770107,259,34,0,6,1,1,19,320
820770201,159,21,4,7,0,2,20,213
820770202,201,12,4,3,2,4,30,256
820770203,322,13,3,5,4,4,6,357
820770204,149,15,0,0,1,10,60,235
820770205,51,15,0,0,0,0,5,71
820770206,445,41,3,12,2,3,25,531
820770207,421,37,4,11,3,2,15,493
820770301,139,54,2,0,0,1,28,224
820770302,281,36,4,1,0,6,12,340
820770303,389,34,6,5,0,1,22,457
820770304,490,34,7,10,0,0,18,559
820770305,436,52,3,18,3,5,22,539
820770306,316,19,0,10,0,0,10,355
820770307,338,31,7,2,8,0,18,404
820770308,399,11,1,2,1,1,22,437
820770309,236,88,1,9,0,8,31,373
820770310,97,47,0,0,0,2,22,168
820770311,90,25,0,0,0,12,22,149
820770312,252,22,2,6,2,1,9,294
820770313,372,43,4,6,3,6,17,451
820770314,235,22,12,6,1,0,12,288
820770315,212,30,1,3,8,0,10,264
820770316,302,22,2,10,0,1,11,348
820770317,270,13,3,6,0,5,17,314
820770401,81,32,0,0,0,3,43,159
820770402,193,34,0,7,4,1,11,250
820770403,46,3,0,0,0,2,57,108
820770404,56,12,0,0,0,0,6,74
820770405,5,5,0,0,0,0,0,10
820770406,15,2,0,0,0,0,5,22
820770407,49,1,0,0,0,0,11,61
820770408,42,2,0,3,0,0,3,50
820770409,3,0,0,0,0,1,4,8
820840101,173,7,8,6,0,22,68,284
820840102,430,14,5,36,5,29,17,536
820840103,620,42,18,51,5,172,85,993
820840201,116,11,0,2,0,11,10,150
820840202,166,8,2,5,0,1,9,191
820840203,333,9,5,6,0,0,12,365
820840204,340,8,9,24,3,34,29,447
820840205,253,8,7,6,6,3,13,296
820840206,568,31,0,17,2,2,13,633
820840207,226,15,3,4,1,22,8,279
820840208,438,24,19,16,1,18,19,535
820840209,442,18,15,13,3,25,15,531
820840210,493,17,6,12,13,2,13,556
820840211,272,6,0,2,0,0,5,285
820840212,283,8,3,6,0,1,5,306
820840213,14,1,0,1,1,1,4,22
820840214,396,19,5,10,0,2,13,445
820840301,98,5,0,0,0,0,1,104
820840302,256,1,0,2,0,0,19,278
820840303,297,2,0,2,0,2,2,305
820840304,263,6,2,11,3,0,10,295
820840305,412,15,5,12,5,2,7,458
820840306,395,13,5,4,1,0,14,432
820840307,587,38,8,47,2,53,34,769
820840308,450,14,2,5,0,0,11,482
820840309,288,3,0,2,5,3,11,312
820840310,187,3,1,5,0,1,10,207
820840311,304,8,3,3,4,3,17,342
820840401,155,2,0,2,4,2,6,171
820840402,248,6,8,2,5,1,7,277
820840403,331,22,11,0,11,1,18,394
820840404,312,5,2,8,6,2,17,352
820840405,362,18,14,7,5,5,13,424
820840406,337,21,7,8,0,3,27,403
820840407,208,21,5,0,1,0,7,242
820840408,276,15,9,1,2,0,8,311
820840409,397,27,9,4,3,3,8,451
820840410,241,14,4,4,1,1,10,275
820840411,289,18,6,3,0,0,18,334
820840412,293,9,2,0,0,0,14,318
820840413,316,26,7,3,4,0,6,362
820840414,253,14,4,1,5,0,12,289
820840415,228,4,2,1,7,4,22,268
820840416,112,2,1,2,3,0,6,126
820840417,90,8,0,3,0,4,4,109
820840418,134,11,2,2,0,1,5,155
820840419,69,4,5,1,0,0,1,80
820840420,333,11,10,3,6,0,16,379
820840421,381,23,5,12,1,3,11,436
820840422,235,0,5,0,1,2,8,251
820840501,252,6,12,2,5,0,34,311
820840502,642,43,8,8,34,2,50,787
820840503,246,70,17,5,11,1,36,386
820840504,128,7,4,5,2,2,11,159
820840505,419,41,9,8,10,3,41,531
820840506,329,11,12,4,2,1,26,385
820840507,329,22,15,9,6,7,35,423
820840508,301,8,15,1,9,1,26,361
820840509,289,14,7,7,1,4,31,353
820840510,243,16,11,4,3,1,20,298
820840511,296,20,14,4,13,9,23,379
820840512,174,1,5,3,0,3,27,213
820840513,222,11,12,0,0,0,11,256
820840514,350,16,7,5,1,0,15,394
820840515,211,18,5,9,4,6,7,260
820840516,304,2,9,6,6,9,28,364
820840517,338,22,14,2,7,4,13,400
820840518,395,16,17,3,3,0,11,445
820840519,372,13,10,9,7,1,20,432
820840601,222,7,2,0,1,0,10,242
820840602,328,15,14,0,3,0,8,368
820840603,271,15,16,1,2,0,3,308
820840604,345,15,2,0,6,0,5,373
820840605,436,15,2,0,0,0,7,460
820840606,324,12,1,4,2,1,18,362
820840607,262,8,3,0,3,0,17,293
820840608,289,21,10,0,5,0,8,333
820840609,262,12,8,0,0,0,6,288
820840610,353,14,7,2,10,1,15,402
820840611,335,7,5,4,8,0,8,367
820840612,356,22,6,1,13,0,13,411
820840613,367,18,5,5,12,0,13,420
820840614,451,12,6,4,1,0,14,488
820840615,133,9,0,0,0,1,9,152
820840616,550,31,9,5,0,0,5,600
820840617,266,8,2,1,1,0,3,281
820840618,246,5,0,4,1,1,22,279
820840619,199,12,3,1,2,1,7,225
820840620,292,30,6,0,0,0,4,332
820840621,275,14,1,0,0,0,3,293
820840622,329,25,1,0,0,0,15,370
820840623,270,0,0,0,1,1,10,282
820840624,147,11,9,0,0,0,5,172
820840701,225,7,0,2,2,0,5,241
820840702,306,3,1,0,0,0,12,322
820840703,438,23,1,4,2,0,6,474
820840704,392,2,3,1,0,0,7,405
820840705,458,15,2,0,18,0,23,516
820840706,618,4,0,6,0,0,3,631
820840707,284,5,5,5,0,0,9,308
820840708,260,4,1,0,2,1,12,280
820840709,477,29,8,0,1,0,23,538
820840710,205,12,6,4,4,1,11,243
820840711,222,19,2,4,1,1,9,258
820840712,268,33,3,4,7,0,17,332
820840713,175,0,10,2,4,0,5,196
820840714,261,10,2,1,6,1,12,293
820840715,268,5,5,8,1,0,8,295
820840716,210,5,5,3,1,0,15,239
820840717,316,4,2,5,2,0,10,339
820840718,374,8,5,5,1,0,13,406
820840719,264,15,2,5,1,0,25,312
820840720,314,20,9,5,10,4,23,385
820840721,189,1,0,0,0,0,3,193
820840722,169,22,3,2,3,0,10,209
820840723,276,16,0,0,0,0,3,295
820840724,237,6,1,2,1,0,4,251
820840801,248,43,8,0,4,0,14,317
820840802,293,19,8,6,24,1,27,378
820840803,285,16,12,3,9,1,31,357
820840804,299,12,9,2,4,1,26,353
820840805,313,13,5,5,6,1,33,376
820840806,297,21,6,1,0,0,17,342
820840807,322,13,4,0,3,0,28,370
820840808,330,8,6,0,4,1,5,354
820840809,288,35,14,6,8,2,13,366
820840810,271,20,11,2,5,1,16,326
820840811,326,5,3,3,2,0,8,347
820840901,276,9,10,4,12,0,21,332
820840902,342,30,8,6,8,2,28,424
820840903,222,13,5,6,2,0,11,259
820840904,265,25,9,4,2,0,9,314
820840905,304,27,38,2,8,3,16,398
820840906,264,37,4,0,1,0,10,316
820840907,668,52,15,1,14,2,14,766
820840908,275,13,8,4,6,0,19,325
820840909,196,18,19,2,26,2,7,270
820840910,201,12,3,2,2,0,4,224
820840911,194,13,15,1,0,0,10,233
820841001,133,2,0,3,0,0,5,143
820841002,397,14,7,10,1,0,10,439
820841003,213,3,5,3,2,0,4,230
820841004,290,6,6,3,1,0,17,323
820841005,197,6,3,5,1,0,4,216
820841006,209,5,3,10,3,0,5,235
820841007,380,7,1,3,2,1,6,400
820841008,372,20,7,2,6,0,18,425
820841009,383,14,1,4,5,0,13,420
820841010,341,14,2,8,2,1,22,390
820841011,355,18,7,3,4,0,6,393
820841012,374,15,2,3,0,1,4,399
820841013,259,4,6,2,4,0,26,301
820841014,266,11,3,4,3,2,9,298
820841015,117,11,5,4,1,2,18,158
820841016,150,8,3,1,6,0,6,174
820841017,305,35,9,5,11,1,13,379
820841018,352,13,0,7,2,4,9,387
820841019,1255,36,10,11,22,3,59,1396
820841020,287,2,9,2,0,21,8,329
820841101,237,17,1,4,0,8,4,271
820841102,186,2,4,1,4,14,12,223
820841103,291,1,10,1,3,14,27,347
820841104,224,3,8,1,2,5,20,263
820841105,283,1,2,1,24,0,20,331
820841106,290,8,1,2,4,0,7,312
820841107,451,20,8,6,1,1,10,497
820841108,264,6,6,4,3,7,10,300
820841109,19,0,0,4,0,0,1,24
820841110,463,12,8,26,1,11,10,531
820841111,363,7,5,9,3,17,25,429
820841112,295,17,4,0,13,10,22,361
820841113,165,5,1,0,0,0,1,172
820841114,217,3,1,0,0,0,17,238
820841115,203,4,5,1,0,1,14,228
820841116,270,8,2,0,0,0,20,300
820841117,321,31,4,5,7,4,23,395
820841118,305,32,5,8,9,3,5,367
820841119,312,21,5,3,5,2,8,356
820841201,368,3,0,0,2,0,13,386
820841202,230,6,6,10,5,0,6,263
820841203,296,10,6,9,4,0,12,337
820841204,323,6,1,5,0,0,4,339
820841205,288,16,0,4,2,0,13,323
820841206,205,10,3,0,0,0,10,228
820841207,215,4,4,1,8,2,12,246
820841208,219,5,7,1,1,1,12,246
820841209,277,2,0,1,0,0,8,288
820841210,217,6,0,0,7,0,14,244
820841211,267,9,0,0,1,0,2,279
820841212,242,2,5,1,0,1,20,271
820841213,262,3,3,1,0,0,10,279
820841214,317,23,9,4,6,0,5,364
820841215,291,14,7,13,2,0,7,334
820841216,137,14,0,4,2,1,10,168
820841217,140,3,7,1,2,4,23,180
820841218,217,7,1,1,4,0,14,244
820841219,112,0,1,1,0,0,2,116
820841220,212,4,0,1,0,0,2,219
820841221,329,1,4,0,0,1,13,348
820841301,307,4,6,1,2,0,34,354
820841302,403,30,1,5,1,2,14,456
820841303,313,13,0,2,0,0,10,338
820841304,551,12,0,1,2,0,9,575
820841305,263,17,7,5,4,0,12,308
820841306,318,13,3,3,7,0,17,361
820841307,135,20,3,0,0,1,5,164
820841308,277,28,9,4,1,0,15,334
820841309,207,5,9,4,8,0,15,248
820841310,300,25,15,5,2,0,6,353
820841311,265,15,10,9,1,0,15,315
820841312,224,24,15,2,4,1,10,280
820841313,402,18,3,2,4,1,11,441
820841314,222,14,5,1,0,0,8,250
820841401,270,16,3,2,2,0,21,314
820841402,200,10,5,2,5,0,35,257
820841403,271,20,19,7,6,3,17,343
820841404,290,18,5,4,9,0,12,338
820841405,258,6,4,0,1,0,33,302
820841406,328,5,12,5,2,0,21,373
820841407,284,10,7,9,6,1,21,338
820841408,291,8,6,3,6,0,14,328
820841409,223,5,4,4,2,0,7,245
820841410,336,13,2,5,1,0,20,377
820841411,150,8,9,4,0,0,6,177
820841501,244,14,1,1,2,0,12,274
820841502,252,15,6,0,6,0,25,304
820841503,234,14,5,3,11,0,17,284
820841504,248,15,4,5,9,1,24,306
820841505,227,6,2,10,12,1,18,276
820841506,254,41,2,1,15,0,28,341
820841507,177,9,6,0,5,0,23,220
820841508,227,20,3,4,0,0,9,263
820841509,212,82,1,2,3,0,15,315
820841601,307,50,53,5,4,0,21,440
820841602,329,32,31,5,9,0,19,425
820841603,374,46,18,1,10,6,25,480
820841604,287,17,8,3,7,4,17,343
820841605,341,26,9,7,16,2,22,423
820841606,289,27,21,4,17,1,19,378
820841607,427,131,46,9,15,9,45,682
820841608,201,16,51,1,10,1,12,292
820841609,361,56,40,3,17,3,30,510
820841610,224,23,41,3,5,5,15,316
820841611,177,14,14,5,3,3,6,222
820841612,194,38,15,2,2,6,70,327
820841701,160,5,14,8,7,0,30,224
820841702,239,56,31,6,16,0,15,363
820841703,199,41,24,2,22,2,17,307
820841704,276,54,13,6,35,1,8,393
820841705,219,20,6,2,14,0,22,283
820841706,258,35,7,1,7,0,25,333
820841707,248,36,17,4,12,4,9,330
820841708,142,31,13,4,9,1,20,220
820841709,309,65,8,3,11,5,17,418
820841710,252,59,31,1,14,0,21,378
820841711,357,127,22,4,9,4,28,551
820841712,251,47,4,1,8,0,19,330
820841713,263,47,15,1,10,9,29,374
820841714,215,73,26,5,10,1,12,342
820841715,359,110,24,4,11,39,28,575
820841716,171,37,3,0,6,0,26,243
820841717,176,37,12,1,14,0,12,252
820841718,283,126,12,2,5,2,19,449
820841719,253,53,13,3,19,4,11,356
820841801,407,69,21,0,17,2,26,542
820841802,151,58,16,1,3,5,3,237
820841803,172,36,15,2,8,1,29,263
820841804,428,103,17,1,8,5,25,587
820841805,257,73,36,2,4,6,28,406
820841806,228,51,14,1,0,0,7,301
820841807,429,135,28,1,1,2,79,675
820841808,247,79,17,0,11,6,12,372
820841809,244,37,7,1,6,2,13,310
820841810,203,31,31,2,4,16,14,301
820841811,331,97,16,1,17,2,18,482
820841812,214,18,17,0,14,7,39,309
820841813,369,82,49,2,3,18,39,562
820841814,205,39,9,7,3,7,33,303
820841815,221,84,6,3,0,3,11,328
820841816,150,43,21,0,5,5,4,228
820841817,195,42,10,0,7,3,16,273
820841818,269,83,22,2,11,11,23,421
820841901,245,75,34,6,6,12,21,399
820841902,245,26,25,9,5,11,10,331
820841903,352,25,28,1,7,51,18,482
820841904,189,30,13,4,12,25,3,276
820841905,193,40,12,1,6,1,7,260
820841906,201,62,11,10,23,2,24,333
820841907,174,44,1,4,20,11,14,268
820841908,302,81,46,0,18,3,19,469
820841909,351,119,51,2,42,2,28,595
820841910,340,86,11,0,9,7,38,491
820841911,257,27,11,1,13,31,23,363
820841912,264,62,16,4,70,34,14,464
820841913,154,39,31,0,9,1,9,243
820841914,144,124,14,1,1,1,7,292
820841915,220,58,7,3,7,2,20,317
820841916,191,69,14,3,31,1,9,318
820841917,266,75,19,6,4,3,20,393
820841918,325,99,17,1,18,8,22,490
820841919,153,37,5,0,5,0,20,220
820841920,186,68,1,6,6,1,21,289
820841921,153,37,11,2,10,2,11,226
820841922,72,28,5,0,15,0,3,123
820841923,116,43,11,2,29,4,12,217
820841924,244,25,68,0,6,2,12,357
820842001,210,63,31,3,10,7,25,349
820842002,249,55,15,1,2,3,42,367
820842003,347,87,16,2,14,18,17,501
820842004,208,41,11,1,21,4,9,295
820842005,158,32,17,1,2,0,7,217
820842006,239,52,30,0,5,4,26,356
820842007,260,81,12,1,57,3,40,454
820842008,226,89,11,0,2,1,10,339
820842009,287,39,73,0,17,18,11,445
820842010,161,73,9,0,11,1,7,262
820842011,227,49,12,3,15,13,36,355
820842012,208,60,20,4,36,7,10,345
820842013,297,68,12,0,7,1,18,403
820842014,240,60,13,1,6,0,10,330
820842015,127,30,11,0,1,1,6,176
820842016,151,13,7,0,6,0,20,197
820842017,115,19,4,0,46,1,9,194
820842101,257,61,12,3,5,0,21,359
820842102,285,76,16,0,20,6,22,425
820842103,288,60,10,0,11,10,42,421
820842104,346,75,23,1,17,12,30,504
820842105,165,37,33,7,4,6,7,259
820842106,43,0,7,1,10,0,7,68
820842107,290,99,22,2,22,17,33,485
820842108,255,86,22,4,42,0,20,429
820842109,243,78,27,3,16,18,18,403
820842110,244,0,24,1,7,0,63,339
820842111,215,38,31,0,27,11,11,333
820842112,146,21,8,1,4,2,43,225
820842113,60,0,0,0,12,24,4,100
820842114,316,54,16,1,10,1,5,403
820842115,193,25,48,0,13,3,14,296
820842116,263,60,19,2,43,3,11,401
820842117,200,76,21,1,6,10,13,327
820842201,240,61,19,0,52,5,19,396
820842202,251,50,31,1,9,6,51,399
820842203,232,47,27,2,1,0,10,319
820842204,4,0,0,0,0,0,0,4
820842205,267,3,31,1,20,1,50,373
820842206,300,70,18,2,10,7,19,426
820842207,320,49,24,5,6,4,21,429
820842208,296,19,16,3,13,17,67,431
820842209,247,51,42,1,9,12,62,424
820842210,352,113,30,5,15,9,15,539
820842211,324,24,37,2,15,7,64,473
820842212,351,68,54,0,7,9,36,525
820842213,185,1,39,1,10,0,40,276
820842301,283,66,13,1,21,4,8,396
820842302,223,48,8,3,9,0,16,307
820842303,295,77,5,0,8,1,26,412
820842304,188,39,14,1,6,6,10,264
820842305,273,54,7,4,2,1,9,350
820842306,255,35,33,1,7,9,28,368
820842307,318,78,16,2,1,11,16,442
820842308,326,99,29,0,5,1,27,487
820842309,238,38,34,2,16,3,10,341
820842310,215,77,46,1,5,23,10,377
820842311,389,140,19,1,11,7,34,601
820842312,312,38,34,0,6,46,46,482
820842313,319,87,25,0,7,1,29,468
820842314,279,95,10,2,3,5,45,439
820842315,231,42,8,2,4,1,14,302
820842316,234,38,17,1,3,3,42,338
820842317,170,46,15,1,2,3,8,245
820842318,230,32,9,1,10,0,26,308
820842319,197,47,14,4,12,2,11,287
820842320,191,5,20,0,2,2,34,254
820842321,114,2,25,0,3,68,2,214
820842322,188,51,16,2,1,6,11,275
820842323,221,44,25,3,9,1,11,314
820842324,167,27,15,3,3,3,14,232
820842401,193,32,37,0,9,3,46,320
820842402,254,58,32,10,2,1,8,365
820842403,147,26,18,1,20,8,10,230
820842404,294,92,12,6,20,1,22,447
820842405,234,66,8,6,8,1,17,340
820842406,223,33,15,34,3,2,9,319
820842407,258,53,65,1,9,2,7,395
820842408,213,53,16,0,11,1,11,305
820842409,327,64,98,0,6,2,28,525
820842410,182,28,4,0,4,0,14,232
820842411,173,39,0,2,1,4,20,239
820842412,297,38,7,0,7,1,63,413
820842413,305,54,22,1,3,13,36,434
820842414,165,22,13,2,8,15,18,243
820842415,219,50,64,3,6,5,21,368
820842416,237,65,16,1,4,0,5,328
820842417,112,29,10,5,9,0,9,174
820842418,247,67,16,2,8,1,22,363
820842419,211,41,2,1,13,3,44,315
820842501,243,20,22,2,15,9,37,348
820842502,207,17,50,0,32,8,42,356
820842503,189,44,14,1,110,9,10,377
820842504,171,0,3,0,30,0,55,259
820842505,241,11,21,3,108,11,79,474
820842506,330,1,32,3,14,1,39,420
820842507,262,2,8,0,5,4,37,318
820842508,304,1,95,1,27,33,25,486
820842509,255,4,12,1,17,3,13,305
820842510,152,8,19,0,7,3,5,194
820842511,252,2,25,0,2,1,11,293
820842512,546,10,18,0,2,9,8,593
820842513,328,1,14,1,7,6,11,368
820842514,86,1,14,0,42,1,46,190
820842515,185,0,99,1,158,7,30,480
820842516,77,0,5,0,6,0,22,110
820842601,266,72,58,0,4,4,74,478
820842602,218,12,34,0,3,8,21,296
820842603,304,2,26,0,3,0,139,474
820842604,329,0,31,1,24,33,50,468
820842605,194,15,47,1,2,36,52,347
820842606,168,76,6,0,12,0,5,267
820842607,254,0,34,1,4,142,9,444
820842608,273,25,9,2,5,9,89,412
820842609,146,15,24,2,10,1,24,222
820842610,314,108,50,1,15,4,48,540
820842611,184,3,18,0,6,83,3,297
820842612,169,78,26,1,11,5,23,313
820842613,350,39,22,0,18,6,92,527
820842614,286,7,32,5,4,114,29,477
820842615,291,74,17,1,7,9,5,404
820842616,340,110,22,1,11,6,22,512
820842617,187,49,11,0,2,0,25,274
820842618,203,14,38,8,5,76,16,360
820842619,137,9,14,0,4,0,50,214
820842620,187,76,10,1,3,1,9,287
820842621,315,21,30,4,39,12,92,513
820842622,153,0,23,3,2,1,81,263
820842623,217,48,17,0,4,6,37,329
820842701,308,10,137,5,36,3,10,509
820842702,276,10,105,5,13,2,18,429
820842703,174,18,7,0,20,20,20,259
820842704,178,7,41,1,12,13,16,268
820842705,180,0,97,1,22,3,5,308
820842706,146,2,47,4,16,0,3,218
820842707,223,39,39,0,7,0,25,333
820842708,281,8,138,1,11,42,10,491
820842709,115,3,3,2,20,16,8,167
820842710,254,0,49,1,41,46,2,393
820842711,224,3,98,4,22,24,7,382
820842712,346,71,118,12,32,6,24,609
820842713,230,0,45,1,23,64,6,369
820842714,229,9,67,3,6,11,22,347
820842715,299,12,84,6,36,3,14,454
820842716,252,4,66,0,55,15,7,399
820842717,150,0,25,2,8,3,17,205
820842718,156,1,22,0,8,13,5,205
820842719,178,39,13,0,14,9,28,281
820842720,195,26,35,2,23,78,7,366
820842721,239,24,33,8,10,20,68,402
820842722,181,11,42,1,2,10,32,279
820842801,150,31,8,0,39,2,22,252
820842802,374,128,22,1,28,3,41,597
820842803,186,86,11,1,3,2,35,324
820842804,226,106,11,1,13,9,24,390
820842805,107,42,5,1,7,2,1,165
820842806,28,0,0,0,0,0,14,42
820842807,350,66,20,1,9,23,78,547
820842808,208,38,21,1,0,13,26,307
820842809,335,21,78,0,21,66,54,575
820842810,360,32,42,0,23,19,54,530
820842811,410,72,6,2,20,8,35,553
820842812,185,17,19,2,7,1,34,265
820842813,225,51,11,0,5,1,3,296
820842814,158,54,11,1,10,1,3,238
820842815,282,3,62,0,11,5,102,465
820842816,294,4,23,1,84,3,123,532
820842817,314,36,33,3,50,10,129,575
820842818,197,36,18,2,10,6,87,356
820842819,213,0,8,1,7,66,0,295
820842820,254,59,18,1,10,20,25,387
820842821,202,21,36,0,12,22,52,345
820842822,197,71,14,5,7,5,23,322
820842823,144,10,8,21,4,4,59,250
820842824,278,97,29,1,18,11,50,484
820842825,217,115,10,0,3,4,26,375
820842901,481,71,37,4,20,34,73,720
820842902,336,18,47,0,9,101,21,532
820842903,311,47,9,1,25,11,51,455
820842904,321,69,35,1,19,1,35,481
820842905,366,107,21,0,7,0,9,510
820842906,164,11,3,2,5,15,45,245
820842907,293,77,23,7,15,1,36,452
820842908,286,49,31,2,14,17,30,429
820842909,203,45,15,7,19,9,36,334
820842910,366,36,24,2,11,35,57,531
820842911,362,15,22,5,14,9,95,522
820842912,263,26,43,1,9,7,75,424
820842913,252,10,18,2,3,2,61,348
820842914,286,41,39,3,9,8,26,412
820842915,308,48,33,2,9,9,29,438
820842916,179,31,1,4,10,1,12,238
820842917,248,48,0,15,17,2,15,345
820842918,296,37,10,0,13,0,12,368
820842919,227,42,31,2,19,3,20,344
820842920,220,11,13,3,10,35,17,309
820842921,156,33,18,2,7,5,34,255
820842922,149,30,20,1,6,3,7,216
820842923,152,3,23,3,5,25,18,229
820842924,275,4,13,4,35,51,27,409
820843001,229,5,2,0,0,0,1,237
820843002,277,14,0,1,1,0,4,297
820843003,527,37,12,5,8,1,32,622
820843004,395,15,8,3,2,0,13,436
820843005,276,18,3,1,6,0,13,317
820843006,208,9,1,1,2,0,5,226
820843007,413,12,1,5,0,1,9,441
820843008,269,14,2,2,0,2,4,293
820843009,325,21,2,0,1,0,11,360
820843010,332,13,0,2,0,0,5,352
820843011,246,9,2,0,0,0,4,261
820843012,262,10,0,0,1,0,2,275
820843013,229,11,2,1,0,0,6,249
820843014,344,22,5,3,6,0,9,389
820843101,365,17,7,4,2,0,15,410
820843102,290,16,8,3,6,0,6,329
820843103,284,4,2,2,5,0,6,303
820843104,283,33,6,3,11,0,22,358
820843105,163,1,4,0,1,0,2,171
820843106,288,11,4,3,4,0,17,327
820843107,188,6,5,1,5,1,8,214
820843108,229,6,1,0,0,0,20,256
820843109,195,8,1,1,0,1,7,213
820843110,281,9,2,3,0,0,7,302
820843111,319,18,7,3,1,0,8,356
820843112,300,17,5,2,6,2,8,340
820843113,281,16,1,1,0,1,15,315
820843114,259,18,7,2,2,0,11,299
820843115,247,9,7,3,6,1,16,289
820843116,315,19,4,2,3,1,8,352
820843117,268,7,6,3,8,1,31,324
820843118,263,14,5,0,2,0,22,306
820843119,237,15,7,3,4,1,14,281
820843120,223,14,3,1,4,0,10,255
820843121,272,23,5,3,4,1,4,312
820843201,406,7,1,0,0,1,3,418
820843202,317,13,6,3,2,1,9,351
820843203,318,21,5,2,5,0,13,364
820843204,318,15,10,3,5,0,16,367
820843205,289,9,4,2,2,0,15,321
820843206,323,12,1,6,1,0,1,344
820843207,262,11,1,4,0,1,10,289
820843208,426,14,3,6,1,2,6,458
820843209,216,17,3,5,3,0,7,251
820843210,200,5,2,4,0,0,6,217
820843211,302,11,3,1,2,1,12,332
820843212,374,5,1,2,0,0,4,386
820843213,387,5,1,1,2,0,7,403
820843214,220,3,5,5,0,0,8,241
820843215,269,7,2,1,2,0,4,285
820843301,285,0,1,1,8,0,13,308
820843302,296,2,4,6,5,0,17,330
820843303,360,5,4,1,10,0,10,390
820843304,296,4,3,2,0,0,11,316
820843305,398,0,15,9,4,0,14,440
820843306,321,14,5,1,5,0,15,361
820843307,216,14,8,1,8,0,13,260
820843308,246,0,7,0,1,0,5,259
820843309,426,0,12,4,7,1,9,459
820843310,390,0,1,0,20,0,17,428
820843311,361,0,7,1,6,0,5,380
820843312,364,3,2,4,4,0,10,387
820843313,283,0,4,0,1,0,32,320
820843314,263,1,0,1,0,0,4,269
820843315,453,3,0,1,0,0,15,472
820843316,345,0,5,2,7,0,13,372
820843317,341,4,0,4,1,0,17,367
820843318,329,2,3,4,6,0,7,351
820843319,250,12,1,4,0,0,9,276
820843401,110,0,7,0,0,0,4,121
820843402,346,6,0,0,8,0,7,367
820843403,131,1,0,0,0,0,3,135
820843404,264,5,2,1,3,0,6,281
820843405,346,19,21,6,16,3,22,433
820843406,335,24,3,3,2,0,34,401
820843407,313,35,5,2,3,0,29,387
820843408,332,40,19,3,7,1,11,413
820843409,272,7,27,3,2,2,40,353
820843410,292,46,7,2,3,0,21,371
820843411,183,13,4,3,3,0,10,216
820843412,206,15,3,1,3,0,10,238
820843413,173,22,9,1,6,0,6,217
820843414,281,22,6,2,16,1,15,343
820843415,237,4,2,1,0,0,3,247
820843416,383,2,7,3,0,0,13,408
820843417,247,5,5,3,13,0,26,299
820843418,150,7,10,3,0,1,8,179
820843419,129,1,1,0,0,0,3,134
820843501,303,20,6,3,2,0,10,344
820843502,106,9,4,3,10,0,4,136
820843503,236,14,5,1,22,0,13,291
820843504,320,16,7,6,3,0,21,373
820843505,275,9,12,2,8,1,37,344
820843506,245,17,8,4,5,0,5,284
820843507,184,14,3,1,3,0,8,213
820843508,118,20,4,2,2,0,3,149
820843509,381,8,6,1,9,1,21,427
820843510,207,12,4,3,6,0,5,237
820843511,229,14,1,1,1,0,11,257
820843512,447,8,1,15,1,0,12,484
820843513,238,15,7,3,0,0,1,264
820843514,284,12,5,5,2,0,10,318
820843515,386,19,3,4,2,0,17,431
820843516,243,4,3,5,1,1,20,277
820843517,621,11,2,0,0,0,14,648
820843601,240,11,8,2,7,0,17,285
820843602,235,20,2,4,8,2,9,280
820843603,224,3,7,1,4,0,16,255
820843604,282,3,13,6,4,0,10,318
820843605,164,10,3,3,9,0,20,209
820843606,160,26,8,2,15,2,16,229
820843607,266,25,13,4,2,1,9,320
820843608,322,23,20,11,6,0,28,410
820843609,307,22,6,4,13,2,10,364
820843610,322,40,15,2,11,1,21,412
820843611,298,21,11,1,7,0,18,356
820843612,607,21,8,1,0,1,25,663
820843613,279,14,27,3,13,3,27,366
820843614,208,17,7,0,7,0,10,249
820843615,190,5,2,2,3,0,8,210
820843616,380,6,0,0,0,0,4,390
820843617,195,0,16,7,16,1,13,248
820843618,194,4,2,1,1,0,10,212
820843619,202,9,11,12,24,2,23,283
820843701,351,47,15,2,16,2,22,455
820843702,388,42,22,5,10,2,25,494
820843703,280,24,2,1,9,0,20,336
820843704,194,10,62,5,44,0,15,330
820843705,241,46,6,4,12,3,22,334
820843706,334,104,17,4,12,3,23,497
820843707,270,39,18,0,19,2,55,403
820843708,377,32,32,3,38,10,42,534
820843709,211,65,20,1,4,0,16,317
820843710,316,28,28,5,13,6,57,453
820843711,227,24,24,4,10,1,30,320
820843712,322,46,5,4,8,3,9,397
820843713,322,8,6,0,7,0,40,383
820843714,301,29,19,8,13,3,37,410
820843715,243,55,25,2,16,6,30,377
820843716,253,8,29,5,10,21,47,373
820843801,417,109,40,2,14,1,27,610
820843802,308,31,20,6,11,1,29,406
820843803,297,49,25,8,23,0,25,427
820843804,346,39,31,3,24,4,52,499
820843805,281,21,37,6,10,2,21,378
820843806,295,24,10,5,13,5,45,397
820843807,237,22,7,4,7,1,28,306
820843808,183,3,2,2,3,0,7,200
820843809,183,11,18,0,17,3,11,243
820843810,294,34,7,1,2,0,12,350
820843811,313,20,9,5,8,2,17,374
820843812,168,13,19,1,0,0,7,208
820843813,323,18,13,3,10,1,23,391
820843814,347,23,3,0,1,0,9,383
820843815,194,18,11,3,5,0,24,255
820843901,172,25,24,0,2,1,4,228
820843902,201,41,10,2,4,0,10,268
820843903,272,43,15,4,16,4,17,371
820843904,227,23,7,1,2,3,12,275
820843905,398,89,18,4,19,2,33,563
820843906,302,2,17,2,7,0,61,391
820843907,338,29,16,4,21,2,38,448
820843908,412,25,32,7,15,27,80,598
820843909,201,50,7,3,4,0,12,277
820843910,168,29,13,4,11,0,17,242
820843911,207,11,14,2,3,0,22,259
820843912,354,43,20,2,15,0,48,482
820843913,301,46,6,5,12,1,11,382
820843914,147,44,15,4,8,1,15,234
820843915,218,62,14,0,3,0,25,322
820843916,157,9,5,1,11,1,36,220
820843917,182,23,7,1,5,0,12,230
820843918,332,41,26,3,2,2,14,420
820843919,198,5,14,0,9,2,32,260
820843920,193,35,9,1,4,2,16,260
820844001,317,9,71,5,31,1,34,468
820844002,321,29,54,3,13,14,25,459
820844003,370,37,52,9,9,4,23,504
820844004,304,14,41,2,0,1,10,372
820844005,280,0,0,0,0,0,10,290
820844006,261,53,28,1,4,29,37,413
820844007,263,56,27,1,6,0,20,373
820844008,186,14,21,1,1,3,15,241
820844009,200,5,85,1,2,1,12,306
820844010,288,37,25,1,6,1,20,378
820844011,116,4,3,1,0,0,5,129
820844012,74,12,0,0,0,0,3,89
820844013,202,22,14,0,2,0,6,246
820844014,335,39,23,5,5,2,19,428
820844015,221,22,14,4,10,2,9,282
820844101,288,22,15,6,4,1,18,354
820844102,254,7,7,2,5,2,10,287
820844103,156,19,18,2,3,1,3,202
820844104,173,29,3,0,6,0,11,222
820844105,0,0,0,0,0,0,1,1
820844106,258,17,5,6,5,0,8,299
820844107,340,27,13,3,8,2,21,414
820844108,323,19,7,5,8,0,23,385
820844109,313,4,3,0,1,0,12,333
820844110,378,5,1,1,0,0,16,401
820844111,231,6,3,2,3,0,6,251
820844112,272,26,4,1,3,0,4,310
820844201,137,26,7,1,3,0,30,204
820844202,101,2,1,0,1,0,13,118
820844203,85,5,0,0,0,0,8,98
820844204,221,2,0,2,0,0,20,245
820844205,172,8,0,0,1,0,9,190
820844206,104,0,1,0,0,0,0,105
820844207,227,15,0,2,3,1,6,254
820844208,170,2,4,3,0,1,15,195
820844209,253,9,3,0,0,0,17,282
820844210,342,23,13,2,2,2,7,391
820844211,180,3,2,2,4,0,6,197
820844212,252,3,1,0,0,1,8,265
820844213,294,7,11,0,0,0,10,322
820844214,85,2,0,0,2,0,2,91
820844301,248,25,10,7,0,1,13,304
820844302,196,11,5,2,7,2,4,227
820844303,243,34,6,2,8,0,5,298
820844304,271,30,10,5,5,1,22,344
820844305,227,32,6,1,2,3,22,293
820844306,241,12,6,5,3,0,11,278
820844307,320,35,16,4,26,2,19,422
820844308,165,25,5,2,3,1,7,208
820844309,243,19,14,3,7,0,15,301
820844310,234,14,11,6,19,0,23,307
820844311,267,16,12,2,5,0,9,311
820844312,346,33,11,2,1,0,5,398
820844313,283,13,6,1,14,0,8,325
820844314,367,32,10,6,4,2,8,429
820844401,359,21,16,3,3,0,16,418
820844402,160,2,12,1,0,0,20,195
820844403,328,16,9,6,5,0,6,370
820844404,251,10,3,1,10,0,6,281
820844405,194,14,7,0,7,2,9,233
820844406,226,35,17,2,2,0,25,307
820844407,271,8,4,9,4,2,16,314
820844408,208,13,0,1,3,0,2,227
820844409,273,28,11,5,7,0,17,341
820844410,268,8,1,1,5,0,31,314
820844411,224,12,9,2,5,2,21,275
820844412,249,18,22,3,8,0,26,326
820844413,311,14,16,3,10,3,13,370
820844414,228,12,4,5,3,0,29,281
820844415,254,20,8,7,1,1,11,302
820844416,306,19,11,4,5,1,7,353
820844417,271,12,12,2,4,2,33,336
820844418,274,0,10,2,6,1,36,329
820844501,243,0,9,0,2,0,6,260
820844502,163,9,1,0,2,0,6,181
820844503,360,1,1,2,0,0,12,376
820844504,278,1,2,3,14,0,18,316
820844505,185,0,1,1,9,0,11,207
820844506,176,5,3,1,4,0,14,203
820844507,233,4,3,4,1,0,15,260
820844508,231,4,0,2,3,0,5,245
820844509,334,3,8,3,2,1,13,364
820844510,264,11,5,4,6,2,21,313
820844511,360,4,7,4,4,0,10,389
820844512,315,0,9,4,3,2,28,361
820844513,121,9,0,3,0,0,1,134
820844514,330,8,6,2,1,0,14,361
820844515,235,8,1,0,0,0,16,260
820844516,233,3,1,0,0,0,3,240
820844517,307,12,1,2,1,0,8,331
820844518,343,21,6,2,6,0,10,388
820844519,306,25,4,1,8,1,20,365
820844520,252,13,3,2,1,0,12,283
820844521,176,11,4,0,5,0,8,204
820844522,240,5,9,2,1,2,7,266
820844523,351,23,6,3,1,1,18,403
820844524,287,23,3,2,1,1,8,325
820844601,300,31,4,2,3,0,13,353
820844602,271,12,6,3,5,0,27,324
820844603,297,10,4,6,9,1,10,337
820844604,302,22,5,4,6,0,20,359
820844605,144,10,3,0,1,0,3,161
820844606,347,30,1,1,2,0,12,393
820844607,382,19,5,6,2,1,16,431
820844608,294,27,19,6,12,2,7,367
820844609,364,4,0,1,0,0,9,378
820844610,299,1,0,1,5,0,11,317
820844611,351,0,1,0,0,0,10,362
820844612,200,5,4,8,0,0,4,221
820844613,375,15,10,0,0,0,6,406
820844614,371,22,2,0,1,0,9,405
820844615,211,7,3,0,0,0,9,230
820844701,181,7,2,2,1,0,15,208
820844702,221,6,0,3,1,0,3,234
820844703,243,4,0,2,0,0,2,251
820844704,292,5,1,2,0,0,5,305
820844705,309,13,0,1,0,0,14,337
820844706,259,6,3,0,7,0,8,283
820844707,212,5,5,1,0,0,8,231
820844708,221,4,2,0,8,0,7,242
820844709,226,7,8,6,8,0,44,299
820844710,274,4,1,2,0,3,8,292
820844711,137,3,3,2,14,0,5,164
820844712,208,3,3,1,0,0,1,216
820844713,203,0,5,0,3,0,7,218
820844714,126,5,3,4,1,0,6,145
820844715,205,7,0,0,0,0,13,225
820844716,339,11,0,5,0,0,5,360
820844801,524,26,2,0,0,0,6,558
820844802,279,7,0,1,1,0,4,292
820844803,347,1,5,4,0,0,16,373
820844804,213,3,0,1,0,0,3,220
820844805,180,0,1,0,6,0,6,193
820844806,235,2,1,1,0,1,3,243
820844807,326,6,0,1,0,1,24,358
820844808,213,7,0,2,1,0,15,238
820844809,175,9,7,0,0,0,6,197
820844810,291,0,4,1,11,0,14,321
820844811,434,27,5,2,4,1,11,484
820844812,298,8,16,2,3,1,9,337
820844813,307,0,4,2,0,0,9,322
820844814,287,4,2,3,0,0,6,302
820844815,253,2,3,2,0,0,7,267
820844816,298,17,1,0,0,1,12,329
820844817,406,4,1,2,0,0,8,421
820844818,257,0,0,0,0,0,0,257
820844819,275,0,1,2,0,2,2,282
820844820,315,5,3,2,0,0,0,325
820844821,430,6,0,2,0,0,22,460
820844822,391,6,2,1,0,0,5,405
820844901,127,2,1,1,0,0,4,135
820844902,288,1,4,1,0,1,11,306
820844903,262,0,0,0,0,0,3,265
820844904,322,1,3,1,8,0,10,345
820844905,241,0,1,1,4,0,14,261
820844906,145,0,0,0,0,0,35,180
820844907,334,0,2,3,3,0,9,351
820844908,538,0,2,2,0,0,16,558
820844909,367,3,2,0,2,0,12,386
820844910,186,2,0,0,0,0,10,198
820844911,426,3,5,11,0,1,34,480
820844912,208,0,0,0,0,0,7,215
820844913,348,0,2,2,1,0,9,362
820844914,138,0,1,0,1,0,17,157
820844915,272,3,3,1,0,0,1,280
820845001,281,11,9,1,18,0,31,351
820845002,325,9,7,5,4,0,9,359
820845003,310,19,6,1,6,0,5,347
820845004,372,12,2,1,2,0,11,400
820845005,333,28,4,1,3,0,8,377
820845006,324,15,2,1,2,0,6,350
820845007,362,19,3,7,1,0,11,403
820845008,337,10,0,1,2,0,4,354
820845009,189,13,0,0,0,1,5,208
820845010,188,5,5,1,3,0,5,207
820845011,317,15,2,1,2,0,11,348
820845012,409,15,7,1,5,0,20,457
820845013,321,42,3,2,2,1,3,374
820845101,358,27,5,2,4,0,7,403
820845102,292,33,4,0,1,0,9,339
820845103,298,9,12,4,7,0,36,366
820845104,287,16,2,3,4,0,20,332
820845105,294,17,16,4,1,1,7,340
820845106,385,14,0,2,0,0,14,415
820845107,282,6,0,3,0,0,2,293
820845108,345,6,1,1,0,0,2,355
820845109,272,27,8,0,0,0,5,312
820845110,265,15,7,1,2,2,12,304
820845111,305,19,10,5,2,0,16,357
820845112,250,15,5,1,7,1,22,301
820845113,172,9,0,1,6,0,6,194
820845114,124,5,1,1,3,0,6,140
820845201,456,5,2,0,0,0,9,472
820845202,288,0,0,3,0,0,8,299
820845203,374,2,0,0,1,0,3,380
820845204,360,3,2,2,0,0,18,385
820845205,277,0,0,0,0,0,4,281
820845206,345,1,3,5,0,0,14,368
820845207,436,1,2,2,0,0,15,456
820845208,247,1,1,1,0,0,10,260
820845209,162,0,0,0,0,0,17,179
820845210,223,2,0,0,0,0,3,228
820845211,366,5,0,0,0,0,6,377
820845212,267,0,0,1,0,0,13,281
820845213,310,0,0,3,0,0,1,314
820845214,372,1,5,6,1,0,21,406
820845301,241,19,4,1,3,0,14,282
820845302,306,29,14,4,3,0,12,368
820845303,305,27,4,4,1,0,11,352
820845304,323,32,13,16,1,1,19,405
820845305,148,14,0,1,1,0,4,168
820845306,368,21,2,0,2,2,11,406
820845307,380,15,5,1,1,0,12,414
820845308,415,13,11,1,4,1,6,451
820845309,341,3,0,2,2,0,10,358
820845310,387,15,4,4,4,0,16,430
820845311,201,11,2,1,4,0,26,245
820845312,291,18,4,5,1,0,8,327
820845313,162,15,0,0,2,0,5,184
820845314,221,9,4,0,0,1,21,256
820845315,294,29,0,0,3,0,11,337
820845316,249,26,1,3,0,0,13,292
820845317,196,16,0,0,1,1,12,226
820845318,517,25,5,0,0,1,9,557
820845319,196,19,0,0,0,3,9,227
820845320,206,14,0,0,0,0,3,223
820845321,192,12,0,1,0,0,5,210
820845322,59,0,1,0,0,0,2,62
820845323,458,23,1,0,3,0,10,495
820845401,130,12,5,2,3,0,7,159
820845402,234,12,6,2,1,0,6,261
820845403,203,12,3,0,1,1,3,223
820845404,285,22,2,2,9,0,23,343
820845405,224,8,1,1,5,0,7,246
820845406,71,3,0,4,0,0,1,79
820845407,183,4,3,3,4,0,7,204
820845408,281,7,0,4,3,0,18,313
820845409,262,14,9,1,1,0,10,297
820845410,139,6,3,0,0,1,4,153
820845411,346,13,4,1,9,0,11,384
820845412,322,20,7,3,9,0,19,380
820845413,195,6,4,6,0,0,9,220
820845414,322,9,6,4,3,3,34,381
820845415,328,12,8,8,4,0,9,369
820845416,277,13,6,5,1,1,13,316
820845417,247,16,1,3,3,1,16,287
820845418,277,20,7,3,4,1,16,328
820845419,168,12,7,0,1,0,2,190
820845501,325,11,7,2,1,0,9,355
820845502,347,16,1,2,2,0,8,376
820845503,261,10,4,2,3,0,10,290
820845504,306,10,2,1,1,1,18,339
820845505,404,6,4,11,5,0,19,449
820845506,237,13,7,4,5,0,8,274
820845507,320,7,3,1,3,0,11,345
820845508,387,13,2,5,1,0,10,418
820845509,262,13,8,3,2,0,11,299
820845510,341,14,4,1,1,0,7,368
820845511,245,14,1,0,1,0,5,266
820845512,258,3,2,2,2,0,11,278
820845513,412,3,5,2,0,0,4,426
820845514,402,10,4,0,1,0,9,426
820845515,194,8,4,0,0,0,0,206
820845516,224,4,3,8,1,0,20,260
820845517,222,5,0,0,0,0,11,238
820845518,262,0,0,2,0,0,2,266
820845519,172,14,2,3,4,0,11,206
820845520,316,6,4,1,0,0,10,337
820845521,249,5,2,0,0,0,2,258
820845522,382,9,3,1,0,0,13,408
820845523,232,5,1,2,13,1,3,257
820845601,15,11,0,0,0,1,3,30
820845602,8,0,0,0,0,0,0,8
820845603,8,1,0,0,0,0,0,9
820845701,64,2,7,2,0,17,1,93
820845702,265,4,12,10,3,140,15,449
820845703,293,4,7,9,0,87,56,456
820845704,229,5,8,5,1,47,8,303
820845705,314,20,11,6,25,18,15,409
820845706,111,24,2,1,10,27,6,181
820845707,217,28,12,4,2,129,31,423
820845708,406,1,8,30,0,187,55,687
820845709,135,3,6,6,2,100,5,257
820845710,385,34,13,22,0,172,72,698
820845711,308,1,2,34,0,66,28,439
820845712,257,12,7,9,0,79,23,387
820845713,268,0,4,7,8,10,7,304
820845714,27,0,0,3,2,4,4,40
820845715,16,1,0,0,0,2,2,21
820845801,26,1,0,1,0,5,14,47
820845802,418,72,6,17,0,5,35,553
820845803,368,38,4,6,1,15,18,450
820845804,20,7,0,0,0,0,0,27
820845805,439,61,6,29,1,5,8,549
820845806,7,2,0,0,0,1,5,15
820845807,368,87,10,7,2,1,20,495
820845901,18,2,0,1,0,1,2,24
820845902,25,10,0,0,1,1,4,41
820845903,19,0,0,0,0,2,2,23
820845904,443,17,1,2,2,0,10,475
820845905,371,18,5,4,1,0,8,407
820845906,200,6,1,5,0,3,6,221
820845907,481,9,6,4,2,4,23,529
820845908,251,17,5,2,0,1,5,281
820845909,351,7,1,9,3,3,16,390
820845910,556,17,3,13,2,5,24,620
820845911,322,5,7,2,2,3,13,354
820845912,376,18,12,8,13,0,17,444
820845913,257,21,6,8,13,2,16,323
820845914,291,19,4,5,12,0,22,353
820845915,176,7,5,1,3,6,10,208
820845916,179,18,6,3,14,2,6,228
820845917,516,28,4,3,5,2,17,575
820845918,421,14,9,8,4,1,10,467
820845919,4,0,0,0,0,0,2,6
820845920,274,14,0,4,2,0,8,302
820845921,347,8,1,3,0,0,5,364
820845922,351,11,0,1,0,0,1,364
820845923,372,13,2,7,0,0,24,418
820845924,272,9,2,6,3,0,57,349
820846001,50,0,1,1,3,2,7,64
820846002,144,6,0,13,0,6,29,198
820846003,11,0,0,0,0,0,5,16
820846004,375,7,13,31,8,11,14,459
820846005,352,1,10,13,5,7,13,401
820846101,198,15,4,1,0,0,3,221
820846102,242,15,5,2,3,1,5,273
820846103,240,7,3,4,2,0,2,258
820846104,288,11,0,1,4,0,4,308
820846105,236,12,4,3,3,0,8,266
820846106,227,14,1,6,5,0,10,263
820846107,342,12,2,0,0,0,5,361
820846108,342,3,0,0,0,0,2,347
820846109,402,13,3,3,2,1,18,442
820846110,390,7,5,1,5,0,16,424
820846111,396,17,13,0,7,1,10,444
820846112,298,14,0,2,0,0,2,316
820846113,274,16,7,2,6,3,12,320
820846114,243,4,1,0,0,0,5,253
820846115,532,18,1,10,0,2,15,578
820846201,192,11,2,3,0,0,11,219
820846202,143,2,0,0,0,0,6,151
820846203,169,3,1,2,1,1,9,186
820846204,227,8,4,1,0,0,3,243
820846205,266,11,4,1,1,0,5,288
820846206,354,12,1,2,6,0,10,385
820846207,369,13,3,5,2,0,5,397
820846208,348,2,4,3,4,2,10,373
820846209,369,15,0,0,0,5,2,391
820846210,343,4,0,2,0,0,8,357
820846211,239,3,0,0,3,0,8,253
820846212,257,6,0,1,0,0,7,271
820846213,390,14,2,5,1,1,13,426
820846214,234,3,0,0,2,0,3,242
820846215,239,12,5,6,2,1,8,273
820846216,337,5,4,1,3,0,8,358
820846217,395,7,4,1,0,0,2,409
820846218,436,8,9,0,1,0,7,461
820846219,278,8,8,6,7,1,11,319
820846220,219,10,0,0,2,0,2,233
820846221,273,8,2,1,2,1,6,293
820846301,208,14,19,26,2,2,17,288
820846302,386,8,1,5,0,0,5,405
820846303,306,6,3,4,1,0,5,325
820846304,265,0,5,16,1,2,26,315
820846305,221,0,1,0,0,0,9,231
820846306,367,1,0,0,1,1,8,378
820846307,320,4,1,0,0,0,9,334
820846308,356,6,2,3,0,0,7,374
820846309,266,0,3,0,0,1,4,274
820846310,375,7,1,0,0,0,9,392
820846311,482,10,6,1,0,0,9,508
820846312,185,1,0,5,0,0,14,205
820846313,399,0,4,2,0,0,24,429
820846401,138,4,0,5,0,55,5,207
820846402,299,8,3,8,0,47,12,377
820846403,181,8,2,7,0,6,11,215
820846404,365,20,5,6,2,6,8,412
820846405,82,6,0,1,1,22,3,115
820846406,183,6,2,4,1,4,3,203
820846501,430,49,4,18,3,67,99,670
820846502,295,28,4,4,1,24,6,362
820846503,510,25,4,8,4,11,19,581
820846504,201,61,13,30,5,200,42,552
820846505,619,106,28,58,2,208,72,1093
820846601,286,17,0,11,1,66,29,410
820846602,774,29,10,29,13,15,24,894
820846701,128,35,7,11,6,63,13,263
820846702,17,2,0,0,0,1,3,23
820846703,19,3,0,0,0,1,2,25
820846704,266,10,1,9,1,11,21,319
820846801,173,30,1,3,2,20,21,250
820846802,178,10,3,13,1,8,3,216
820846901,59,13,0,2,0,2,10,86
820846902,334,15,1,6,1,2,9,368
820846903,349,10,5,6,4,0,5,379
820846904,564,24,8,15,1,1,25,638
820846905,185,27,4,23,0,124,25,388
820846906,339,15,6,8,1,0,9,378
820847001,15,23,18,0,0,0,10,66
820847002,184,10,1,7,5,9,22,238
820847101,7,0,0,3,0,4,15,29
820847102,94,6,0,1,0,0,17,118
820847201,47,4,1,2,0,2,6,62
820847202,366,26,6,7,0,4,18,427
820847203,343,10,1,21,4,4,54,437
820847204,198,8,5,2,2,1,10,226
820847205,73,1,0,2,0,3,23,102
820847206,243,15,4,2,3,0,8,275
820847207,316,18,11,11,0,3,45,404
820847301,143,4,2,3,2,10,11,175
820847302,107,2,2,2,2,6,28,149
820847401,76,0,0,3,0,24,2,105
820847402,262,0,3,8,1,4,7,285
820847501,7,1,0,0,0,8,2,18
820847502,12,3,0,0,1,2,3,21
820847503,128,9,7,3,0,2,3,152
820847504,137,10,1,7,0,1,6,162
820847601,27,3,0,0,0,5,11,46
820847602,79,15,3,5,4,11,14,131
820847701,51,4,0,1,4,2,11,73
820847702,68,2,1,2,0,14,18,105
820847703,97,5,0,7,0,43,22,174
820847704,172,8,1,24,0,112,21,338
820847705,307,20,2,39,1,3,10,382
820847706,18,0,0,0,0,6,8,32
820847707,4,0,0,0,0,0,20,24
820847708,330,6,3,6,2,13,4,364
820847709,304,11,2,9,4,16,9,355
820847710,323,7,8,11,3,6,11,369
820847711,357,16,3,6,1,0,9,392
820847712,322,6,3,2,0,0,5,338
820847713,371,10,4,1,1,0,3,390
820847714,223,4,4,0,5,0,10,246
820847715,180,12,1,3,6,1,1,204
820847716,272,12,2,1,0,0,5,292
820847717,230,12,6,4,0,0,8,260
820847718,277,16,2,2,0,0,5,302
820847719,321,8,3,0,3,0,14,349
820847720,358,10,3,1,4,2,6,384
820847721,367,28,3,10,4,3,29,444
820847722,283,34,4,9,19,2,14,365
820847723,434,12,10,9,12,3,20,500
820847724,213,9,4,5,1,0,12,244
820847725,278,11,5,0,0,1,11,306
820847801,11,0,0,0,0,2,9,22
820847802,100,5,2,15,1,7,9,139
820847803,277,9,1,2,4,0,14,307
820847804,329,14,5,8,3,0,9,368
820847805,161,20,0,0,1,21,4,207
820847806,294,20,3,7,6,0,15,345
820847807,312,9,1,9,4,1,7,343
820847901,8,3,0,0,0,0,5,16
820847902,42,6,0,0,0,1,10,59
820847903,28,24,0,0,0,1,0,53
820847904,4,0,0,0,0,1,14,19
820847905,310,30,3,1,0,0,12,356
820847906,331,26,9,4,2,2,13,387
820848001,365,32,16,1,8,3,20,445
820848002,351,44,24,5,22,10,48,504
820848003,343,64,33,4,13,12,14,483
820848004,337,123,47,3,7,8,14,539
820848005,264,27,6,4,3,1,15,320
820848006,209,27,6,2,1,0,27,272
820848007,235,59,15,4,6,4,7,330
820848008,415,122,45,4,4,1,35,626
820848009,347,66,22,2,2,2,48,489
820848010,162,8,26,2,7,4,45,254
820848011,174,24,17,0,3,0,7,225
820848012,180,18,8,2,6,1,16,231
820848013,311,22,12,1,8,3,30,387
820848014,242,18,46,6,5,3,21,341
820848015,247,20,18,1,9,0,15,310
820848016,283,21,42,11,15,1,33,406
820848017,290,37,21,3,6,1,14,372
820848018,220,33,2,11,4,0,22,292
820848019,253,29,12,6,14,0,9,323
820848020,311,33,11,5,6,1,12,379
820848021,230,22,2,1,7,0,14,276
820848022,298,119,13,3,24,6,55,518
820848101,314,11,9,2,7,0,24,367
820848102,243,6,10,4,9,4,17,293
820848103,223,6,17,2,7,0,18,273
820848104,228,29,9,2,5,0,16,289
820848105,212,5,10,5,8,1,10,251
820848106,226,40,8,1,6,0,13,294
820848107,246,14,12,6,11,1,4,294
820848108,223,8,11,7,5,0,10,264
820848109,325,13,1,2,9,1,12,363
820848110,279,19,13,3,9,0,16,339
820848111,192,7,11,6,9,2,23,250
820848112,283,25,14,4,7,1,5,339
820848113,214,17,6,2,11,1,9,260
820848114,199,24,10,1,0,0,2,236
820848115,99,4,7,2,9,0,7,128
820848116,322,11,10,5,4,2,30,384
820848117,264,13,6,3,16,3,4,309
820848118,265,45,7,5,2,0,9,333
820848119,294,12,4,4,0,0,6,320
820848120,259,2,3,2,4,0,11,281
820848121,212,17,5,1,2,1,6,244
820848201,444,26,9,19,5,5,15,523
820848202,367,14,0,2,0,0,7,390
820848203,338,18,2,4,4,0,10,376
820848204,349,11,1,1,2,1,2,367
820848205,295,11,2,0,2,0,9,319
820848206,314,5,0,0,0,0,1,320
820848207,342,14,1,0,0,0,7,364
820848208,422,10,3,0,6,0,13,454
820848209,459,7,1,4,0,0,8,479
820848210,440,14,2,9,1,0,14,480
820848211,376,8,7,2,0,1,9,403
820848212,281,20,5,4,0,0,0,310
820848213,406,22,9,3,1,0,8,449
820848214,378,21,10,4,7,13,9,442
820848215,251,4,2,1,1,1,8,268
820848216,349,18,8,11,3,16,16,421
820848301,346,15,3,4,3,1,21,393
820848302,346,27,0,3,2,0,14,392
820848303,269,12,4,8,4,0,27,324
820848304,350,12,4,2,10,0,20,398
820848305,304,30,3,4,14,2,13,370
820848306,282,12,6,2,11,2,16,331
820848307,287,7,1,5,4,2,11,317
820848308,344,24,7,6,3,0,12,396
820848309,200,5,4,3,3,1,10,226
820848310,196,6,7,3,6,1,8,227
820848311,317,12,7,3,0,0,10,349
820848312,231,13,2,0,6,0,11,263
820848313,226,13,4,5,0,1,11,260
820848314,351,10,10,7,1,2,14,395
820848315,284,10,2,5,6,0,14,321
820848401,283,10,2,0,0,1,7,303
820848402,321,10,6,2,1,1,9,350
820848403,472,26,3,7,0,0,13,521
820848404,494,28,0,20,3,0,6,551
820848405,253,14,10,2,2,0,3,284
820848406,274,8,5,4,1,0,14,306
820848407,140,8,1,1,0,0,4,154
820848408,303,6,3,0,0,0,4,316
820848409,537,21,0,0,0,0,11,569
820848410,490,24,3,3,0,0,4,524
820848411,469,17,9,5,4,0,8,512
820848412,559,15,3,16,3,2,13,611
820848413,340,5,1,0,0,0,43,389
820848414,290,5,0,0,0,0,21,316
820848415,240,3,5,18,0,16,11,293
820848416,76,2,0,0,0,0,0,78
820848501,494,5,0,4,0,0,4,507
820848502,389,1,0,0,3,0,4,397
820848503,250,7,2,1,0,0,7,267
820848504,227,8,2,2,3,0,1,243
820848505,234,9,7,4,3,0,10,267
820848506,212,10,2,3,3,0,6,236
820848507,262,4,2,2,5,0,6,281
820848508,258,7,4,2,6,1,16,294
820848509,256,5,3,1,1,0,5,271
820848510,411,6,7,7,11,2,12,456
820848511,258,14,5,1,18,0,6,302
820848512,385,11,5,6,3,0,15,425
820848513,227,7,0,3,8,0,6,251
820848514,344,5,0,3,0,0,9,361
820848515,252,7,1,1,2,0,3,266
820848516,232,20,1,3,3,1,1,261
820848601,228,11,5,1,0,1,9,255
820848602,432,5,12,6,3,1,25,484
820848603,317,9,11,1,3,2,15,358
820848604,319,12,3,5,2,0,15,356
820848605,383,6,13,4,5,1,12,424
820848606,462,25,8,1,3,0,5,504
820848607,433,17,1,0,0,0,6,457
820848608,248,13,3,1,2,0,13,280
820848609,228,4,1,1,1,0,0,235
820848610,410,9,0,0,0,0,9,428
820848611,181,2,0,0,0,0,4,187
820848701,105,9,2,1,1,1,0,119
820848702,266,11,4,6,9,0,10,306
820848703,240,11,5,1,1,1,12,271
820848704,392,32,16,0,1,1,30,472
820848705,276,14,0,1,3,1,10,305
820848706,532,26,4,0,0,0,18,580
820848707,442,36,4,0,0,0,13,495
820848708,412,15,3,2,1,1,8,442
820848709,312,9,4,3,10,0,24,362
820848710,369,10,4,2,5,0,10,400
820848711,209,6,1,2,0,0,11,229
820848712,231,10,0,2,0,0,11,254
820848713,270,5,5,2,4,0,10,296
820848714,223,9,4,1,0,0,7,244
820848715,195,11,4,1,1,0,2,214
820848801,203,14,3,8,0,1,2,231
820848802,234,9,1,5,0,1,2,252
820848803,257,9,6,2,1,6,10,291
820848804,293,16,6,1,22,0,20,358
820848805,285,9,2,1,0,0,13,310
820848806,253,17,4,1,1,0,2,278
820848807,414,19,1,4,1,1,4,444
820848808,332,18,16,3,32,3,12,416
820848809,257,10,2,4,5,6,13,297
820848810,346,24,7,2,2,4,12,397
820848811,444,19,5,14,7,3,18,510
820848812,301,8,0,2,0,0,15,326
820848813,271,17,3,13,2,1,8,315
820848814,253,30,2,14,3,22,2,326
820848815,240,6,5,6,4,0,7,268
820848816,355,10,2,3,6,4,9,389
820848817,125,11,2,3,0,1,8,150
820848901,235,7,10,2,14,0,10,278
820848902,338,8,0,0,0,0,3,349
820848903,491,10,1,6,1,4,10,523
820848904,316,6,2,4,1,8,9,346
820848905,363,15,4,2,0,1,13,398
820848906,222,7,4,1,4,0,11,249
820848907,256,10,2,0,0,0,2,270
820848908,139,7,0,0,0,2,9,157
820848909,356,31,1,0,0,1,1,390
820848910,497,7,2,0,0,0,6,512
820848911,720,15,5,2,1,0,6,749
820848912,629,31,1,7,0,6,8,682
820849001,188,11,0,0,1,10,20,230
820849002,468,47,4,10,0,18,9,556
820849003,440,17,5,13,3,11,15,504
820849004,277,12,9,6,2,13,15,334
820849005,192,9,2,3,1,6,11,224
820849006,97,9,2,8,0,14,14,144
820849007,496,41,7,23,0,37,18,622
820849008,254,6,7,18,7,105,20,417
820849009,139,8,5,3,3,3,8,169
820849010,300,27,12,5,2,92,14,452
820849011,353,45,10,27,3,58,42,538
820849012,309,18,19,50,1,68,3,468
820849013,211,12,9,16,2,42,4,296
820849501,3,1,0,0,0,2,1,7
820910101,189,12,1,3,2,0,5,212
820910102,366,34,3,3,2,2,26,436
820910103,294,25,5,1,5,1,13,344
820910104,128,7,1,0,0,4,84,224
820910105,126,28,0,1,0,7,49,211
820910106,107,2,3,1,5,2,20,140
820910107,246,18,3,3,0,1,9,280
820910108,124,0,0,0,0,1,107,232
820910109,70,11,0,0,0,0,0,81
820910110,43,37,0,0,0,1,13,94
820910111,88,33,0,3,0,4,8,136
820910112,254,2,1,2,0,4,14,277
820910113,297,12,2,1,4,2,8,326
820910201,65,10,0,1,0,6,27,109
820910202,75,19,6,1,0,30,63,194
820910203,140,15,0,0,0,12,32,199
820910204,58,16,0,0,0,5,41,120
820910205,10,0,0,0,0,0,6,16
820910206,130,8,0,0,1,6,32,177
820910207,105,1,1,0,0,0,9,116
820910208,19,3,0,6,0,0,6,34
820910209,89,20,2,5,0,4,6,126
820910210,53,10,0,0,0,3,10,76
820910211,198,16,0,2,1,1,11,229
820910212,35,16,0,0,0,12,3,66
820910213,50,5,0,0,0,1,7,63
820910214,311,15,9,12,1,6,18,372
820910216,27,0,1,0,0,13,14,55
820910217,120,42,0,0,1,6,32,201
820910218,38,4,1,0,0,2,19,64
820910301,72,8,0,0,0,0,34,114
820910302,298,14,2,13,2,0,18,347
820910303,148,4,3,9,2,1,13,180
820910304,370,43,6,40,0,3,29,491
820910305,183,1,0,0,0,1,32,217
820910306,332,16,2,13,1,8,63,435
820910307,82,1,0,1,0,0,16,100
820910308,278,8,3,2,1,0,4,296
820910309,200,11,6,1,6,0,10,234
820910310,367,21,10,30,1,4,5,438
820910311,174,7,5,0,7,3,8,204
820910312,452,16,3,2,8,3,14,498
820910313,284,7,2,14,0,1,8,316
820910314,321,14,0,7,0,0,54,396
820910315,137,1,0,0,0,0,51,189
820910316,4,0,0,0,0,0,1,5
820910317,475,23,3,8,0,0,4,513
820910318,323,15,1,8,0,2,8,357
820910319,264,9,3,7,12,0,7,302
820910320,223,5,2,3,1,0,5,239
820910321,328,19,8,13,4,1,9,382
820910322,425,19,8,13,1,0,24,490
820910323,211,4,8,0,3,0,8,234
820910401,126,4,0,0,0,1,6,137
820910402,80,7,4,0,2,0,10,103
820910403,157,9,2,11,0,4,24,207
820910404,102,4,0,0,0,0,2,108
820910405,24,0,0,1,0,0,0,25
820910406,38,7,0,0,0,0,12,57
820910407,37,13,0,0,0,1,31,82
820910408,318,24,3,7,5,2,24,383
820910409,146,15,6,0,9,1,21,198
820910410,293,34,5,5,0,2,17,356
820910411,75,5,0,0,0,1,23,104
820910412,34,2,0,0,0,1,30,67
820910413,30,9,0,2,0,1,38,80
820910414,43,1,0,1,0,7,60,112
820910415,80,15,0,0,0,0,35,130
820910501,287,15,10,6,2,2,11,333
820910502,352,16,7,6,4,0,20,405
820910503,260,15,6,8,0,2,10,301
820910504,356,21,7,2,1,2,20,409
820910505,624,27,6,16,3,2,23,701
820910506,335,11,10,6,2,1,32,397
820910507,704,34,12,24,4,2,24,804
820910508,494,26,4,9,2,1,19,555
820910509,454,37,3,11,2,3,8,518
820910510,87,11,0,1,0,1,47,147
820910511,135,16,2,9,2,30,49,243
820910512,189,13,1,2,0,1,14,220
820910513,319,4,2,1,2,2,30,360
820910601,448,13,7,5,0,2,11,486
820910602,307,30,5,2,2,3,18,367
820910603,327,23,7,4,1,1,29,392
820910604,218,17,8,1,1,3,11,259
820910605,264,22,12,1,3,1,13,316
820910606,247,22,6,3,0,1,9,288
820910607,189,16,4,6,2,0,7,224
820910608,431,31,1,2,0,1,17,483
820910609,304,17,3,4,0,0,15,343
820910610,422,22,8,11,1,6,13,483
820910611,358,21,6,6,5,4,9,409
820910612,503,36,3,2,2,0,9,555
820910613,192,20,1,2,0,0,4,219
820910614,236,9,3,1,2,0,7,258
820910615,165,7,1,0,0,1,44,218
820910616,175,11,3,4,2,2,10,207
820980101,23,0,0,0,0,4,6,33
820980102,18,0,0,0,0,2,3,23
820980103,7,0,0,0,0,1,3,11
820980104,19,6,0,0,0,2,0,27
820980105,41,0,0,0,0,11,13,65
820980106,18,5,0,0,0,0,2,25
820980107,14,0,0,0,0,7,4,25
820980108,106,15,1,0,1,13,20,156
820980109,11,1,0,0,0,1,5,18
820980110,30,9,0,1,0,0,4,44
820980111,38,7,0,0,0,0,6,51
820980112,43,7,0,0,0,0,4,54
820980113,278,11,2,7,5,1,12,316
820980114,387,14,4,7,4,4,13,433
820980115,32,6,1,0,0,2,4,45
820980116,40,19,0,0,0,0,6,65
820980117,54,8,0,9,3,0,4,78
820980118,391,28,1,2,7,6,15,450
820980119,265,18,1,2,0,4,9,299
820980120,246,14,4,2,5,2,13,286
820980121,383,13,8,10,1,2,16,433
820980122,317,16,1,4,1,6,8,353
820980201,77,5,2,0,0,21,56,161
820980202,40,9,0,0,0,3,3,55
820980203,223,28,0,2,1,9,6,269
820980204,22,15,0,0,0,1,5,43
820980205,163,28,5,3,1,19,8,227
820980206,275,32,1,5,0,24,10,347
820980207,410,38,2,7,0,12,18,487
820980301,17,0,0,0,0,6,16,39
820980302,159,28,0,3,1,18,13,222
820980303,15,2,0,0,0,9,22,48
820980304,120,19,1,1,0,41,15,197
820980305,73,1,0,2,0,4,19,99
820980306,50,7,0,1,0,29,10,97
820980307,14,2,0,0,0,1,12,29
820980308,42,2,0,1,0,6,12,63
820980309,40,0,0,1,0,3,17,61
820980310,180,17,5,3,0,35,8,248
820980311,490,35,1,16,0,16,15,573
820980312,109,9,0,2,0,18,14,152
820980313,43,7,0,0,0,1,1,52
820980314,46,5,1,0,1,2,8,63
820980315,99,2,0,8,0,9,6,124
820980316,735,22,3,15,3,2,17,797
820980401,309,9,3,5,0,4,19,349
820980402,319,17,8,6,2,1,8,361
820980403,215,11,4,7,5,6,14,262
820980404,202,15,0,2,3,1,11,234
820980405,246,18,2,2,2,1,6,277
820980406,242,9,4,4,4,0,6,269
820980407,290,3,0,1,0,3,6,303
820980408,230,17,4,3,3,0,6,263
820980409,202,16,4,4,2,5,16,249
820980410,279,13,3,5,1,3,4,308
821050101,106,12,0,0,0,8,24,150
821050102,187,17,1,6,1,64,12,288
821050103,237,0,3,5,1,15,19,280
821050104,46,1,0,0,0,0,42,89
821050105,274,4,3,18,2,4,15,320
821050106,23,2,0,0,0,0,34,59
821050107,88,8,1,0,2,1,8,108
821050108,183,66,0,4,0,24,44,321
821050109,195,14,0,1,0,2,38,250
821050110,220,34,2,1,0,75,35,367
821050111,218,12,7,5,5,1,7,255
821050112,275,13,3,4,0,2,20,317
821050113,38,15,0,0,0,3,23,79
821050114,257,12,2,4,3,5,16,299
821050115,293,5,9,5,1,133,67,513
821050116,264,10,6,2,0,3,4,289
821050117,296,24,4,2,0,1,15,342
821050118,240,9,1,5,2,2,16,275
821050119,284,11,4,6,1,1,18,325
821050120,328,10,3,9,1,1,16,368
821050121,173,7,2,5,0,41,58,286
821050201,55,1,0,0,0,0,22,78
821050202,27,7,0,3,0,1,25,63
821050203,31,0,0,0,0,0,26,57
821050204,69,11,0,1,0,27,68,176
821050205,49,2,2,0,0,2,23,78
821050206,58,37,0,0,0,27,36,158
821050207,20,1,0,0,2,2,33,58
821050208,31,5,0,0,0,4,30,70
821050209,73,10,0,0,1,3,62,149
821050210,71,4,0,4,0,8,43,130
821050211,90,63,0,4,1,0,22,180
821050212,282,15,10,1,1,2,11,322
821050213,479,31,5,7,3,2,12,539
821050214,408,14,2,11,4,2,32,473
821050215,54,0,1,2,2,5,3,67
821050216,28,0,1,1,0,0,5,35
821050217,285,10,3,3,3,7,17,328
821050218,290,21,4,4,1,4,20,344
821050219,56,0,0,0,0,1,22,79
821050220,224,3,0,3,5,2,13,250
821050221,378,11,7,5,1,0,16,418
821050222,371,16,2,4,6,2,15,416
821050223,211,10,3,13,1,0,5,243
821050224,312,23,3,6,0,0,9,353
821050225,140,6,1,3,0,0,5,155
821050226,208,13,7,1,3,0,14,246
821050227,248,11,5,2,3,1,28,298
821050228,374,13,0,1,0,2,5,395
821050229,218,17,9,3,10,3,11,271
821050230,236,8,4,5,1,4,11,269
821050231,265,11,2,19,1,1,7,306
821050301,416,35,3,12,0,18,38,522
821050302,315,7,5,2,1,2,7,339
821050303,340,22,17,13,0,11,10,413
821050304,244,9,2,1,0,2,3,261
821050305,286,18,15,4,13,8,19,363
821050306,401,30,6,3,0,3,7,450
821050307,247,5,6,5,3,0,6,272
821050308,380,28,7,5,1,10,24,455
821050309,17,1,0,0,0,0,0,18
821050310,419,21,3,7,1,6,17,474
821050311,223,12,4,2,0,6,1,248
821050312,252,11,12,3,6,2,15,301
821050313,204,7,8,1,0,2,4,226
821050314,221,10,6,5,3,1,14,260
821050315,134,31,5,5,1,29,109,314
821050316,302,8,4,7,0,1,12,334
821050401,335,9,5,13,1,1,5,369
821050402,272,9,4,7,5,3,9,309
821050403,291,10,16,5,0,0,17,339
821050404,252,8,10,4,0,2,18,294
821050405,226,10,3,3,0,0,4,246
821050406,259,33,9,3,18,1,19,342
821050407,373,13,15,9,5,2,16,433
821050408,240,15,6,2,27,6,14,310
821050409,344,21,14,16,20,2,16,433
821050410,381,21,2,4,1,5,19,433
821050411,262,15,7,3,5,3,8,303
821050412,391,18,5,11,1,1,17,444
821050413,339,6,6,16,1,2,13,383
821050414,419,18,6,12,0,1,20,476
821050415,251,7,5,14,0,0,6,283
821050416,296,6,1,12,0,1,13,329
821050417,235,12,3,5,1,1,4,261
821050418,252,17,6,21,4,3,14,317
821050419,470,26,13,12,2,11,7,541
821050420,259,13,3,1,0,0,9,285
821050501,46,3,0,0,0,6,19,74
821050502,344,28,7,6,0,3,19,407
821050503,183,5,2,2,1,2,15,210
821050504,168,21,30,14,5,229,90,557
821050505,293,15,7,5,4,3,18,345
821050506,329,15,9,4,2,0,24,383
821050507,123,11,4,5,1,6,32,182
821050508,298,29,13,14,0,33,8,395
821050509,208,9,4,6,0,40,4,271
821050510,30,3,1,0,0,3,8,45
821050511,279,8,4,3,1,3,13,311
821050512,243,6,8,3,3,3,24,290
821050513,406,16,5,6,1,3,18,455
821050514,359,23,7,8,1,0,15,413
821050515,217,5,1,6,1,1,7,238
821050516,226,13,3,4,0,0,9,255
821050517,190,19,19,19,4,50,25,326
821120101,158,20,1,0,0,1,3,183
821120102,62,6,0,0,0,3,25,96
821120103,321,35,5,5,1,5,14,386
821120104,172,30,9,1,0,4,57,273
821120105,286,7,3,12,1,1,20,330
821120106,49,2,0,0,0,13,85,149
821120107,56,71,0,0,0,1,43,171
821120108,260,17,0,2,0,0,14,293
821120201,20,18,0,0,1,2,6,47
821120202,41,0,0,2,1,0,6,50
821120203,242,15,3,18,1,15,38,332
821120204,104,4,0,2,0,7,17,134
821120205,108,19,0,4,0,4,12,147
821120206,110,9,0,1,0,4,5,129
821120207,186,5,3,1,1,5,21,222
821120208,223,22,5,6,1,2,23,282
821120209,437,23,7,5,0,6,7,485
821120210,339,20,4,3,0,0,12,378
821120211,50,12,0,0,0,1,11,74
821120212,38,8,0,0,0,3,38,87
821120213,56,30,0,0,0,2,5,93
821120214,18,20,0,0,0,1,3,42
821120215,20,6,0,0,0,0,2,28
821120216,96,13,0,0,1,9,43,162
821120217,268,16,0,7,0,0,14,305
821120218,354,19,5,13,1,1,19,412
821120219,289,12,6,3,0,1,6,317
821120301,51,19,0,0,0,9,22,101
821120302,42,6,2,2,2,6,20,80
821120303,92,0,3,3,0,8,57,163
821120304,16,0,0,1,0,0,3,20
821120305,31,15,0,0,0,1,9,56
821120306,45,31,0,0,0,1,5,82
821120307,77,32,0,0,0,1,15,125
821120308,15,0,0,0,0,2,7,24
821120309,28,28,0,0,0,1,4,61
821120310,93,11,2,0,0,1,2,109
821120311,287,25,4,8,0,2,14,340
821120312,101,9,6,5,1,9,12,143
821120313,76,5,0,1,0,32,40,154
821120314,381,35,5,19,0,1,13,454
821120315,15,0,0,4,0,0,17,36
821120316,296,15,5,4,1,1,2,324
821120401,431,10,0,0,0,0,8,449
821120402,246,14,2,3,1,2,9,277
821120403,205,19,5,2,5,0,11,247
821120404,375,35,13,5,6,0,19,453
821120405,432,20,2,6,0,0,8,468
821120406,356,18,1,9,0,0,1,385
821120407,324,8,1,2,2,0,6,343
821120408,328,23,16,3,5,0,19,394
821120409,270,35,26,3,9,4,28,375
821120410,395,33,4,5,4,2,31,474
821120411,243,17,7,1,1,0,9,278
821120412,442,20,5,8,0,3,15,493
821120413,547,17,0,9,0,1,7,581
821120414,302,23,8,3,1,1,6,344
821120415,472,40,8,6,4,1,28,559
821120416,293,33,8,3,0,1,5,343
821120417,214,18,8,2,1,0,11,254
821120418,223,23,0,4,0,4,4,258
821120419,380,9,3,9,0,6,17,424
821190101,182,21,8,17,2,140,22,392
821190102,570,31,11,15,1,15,10,653
821190103,38,2,0,0,4,16,9,69
821190104,234,6,3,2,1,2,5,253
821190105,421,12,7,1,3,0,9,453
821190106,356,14,7,0,6,0,9,392
821190107,163,17,3,0,3,0,6,192
821190108,275,15,15,1,13,0,11,330
821190109,183,21,7,12,1,10,10,244
821190110,426,19,13,41,3,79,18,599
821190111,264,19,3,11,1,28,18,344
821190112,46,20,0,1,0,12,19,98
821190113,11,8,0,0,0,3,4,26
821190114,2,0,0,0,0,0,4,6
821190115,40,8,0,1,0,7,9,65
821190116,40,2,0,1,0,9,5,57
821190117,415,30,9,8,0,1,9,472
821190118,238,4,6,4,3,0,2,257
821190119,256,10,1,0,0,1,4,272
821190120,846,42,2,19,1,0,35,945
821190121,504,15,2,3,1,11,7,543
821190122,282,9,0,9,0,0,10,310
821190201,369,16,5,10,5,4,15,424
821190202,438,17,1,0,0,0,7,463
821190203,399,15,1,4,1,1,9,430
821190204,313,24,7,3,4,0,11,362
821190205,370,18,9,7,13,1,15,433
821190206,352,22,4,7,1,0,9,395
821190207,202,18,9,2,3,0,16,250
821190208,223,10,7,9,8,1,4,262
821190209,230,14,5,2,0,0,9,260
821190301,34,12,0,0,0,1,1,48
821190302,452,13,5,7,2,1,19,499
821190303,258,17,3,4,5,0,6,293
821190304,472,27,6,1,8,1,4,519
821190305,228,8,6,6,8,2,5,263
821190306,290,11,3,2,1,0,4,311
821190307,135,4,0,2,1,0,5,147
821190308,611,11,2,7,0,1,10,642
821190309,259,6,5,5,3,1,7,286
821190310,158,0,7,0,1,9,9,184
821190311,251,14,6,4,0,0,8,283
821190312,233,4,0,2,1,0,3,243
821190313,225,3,4,0,0,0,3,235
821190314,288,18,2,2,1,1,5,317
821190315,27,1,0,0,0,0,0,28
821190401,42,0,0,1,0,0,2,45
821190402,214,18,0,5,2,0,5,244
821190403,334,17,6,4,2,1,9,373
821190404,305,18,4,2,2,0,7,338
821190405,69,12,0,0,0,0,0,81
821190406,230,5,0,2,0,0,5,242
821190407,316,12,1,3,0,0,2,334
821190408,329,20,13,3,4,0,11,380
821190409,468,27,3,7,0,0,4,509
821190410,328,14,3,8,1,1,15,370
821190411,91,0,0,0,0,0,4,95
821190412,270,12,7,4,2,0,16,311
821190413,341,16,0,3,0,0,2,362
821190414,509,22,3,4,1,1,9,549
821190415,385,13,3,4,3,0,13,421
821190416,284,12,4,1,0,0,4,305
821190417,482,12,6,4,2,0,12,518
821190418,222,7,3,8,5,1,15,261
821190419,331,28,9,5,4,2,18,397
821190420,279,9,3,4,0,0,4,299
821190422,310,13,3,3,1,0,8,338
821190423,203,9,2,0,1,0,8,223
821190424,270,15,12,7,1,3,7,315
821190425,270,22,10,5,7,2,7,323
821190426,94,29,0,4,0,0,11,138
821190501,44,3,0,0,0,1,26,74
821190502,389,29,6,17,6,9,13,469
821190503,441,23,7,9,6,3,18,507
821190504,80,38,1,17,1,61,19,217
821190505,1,0,0,0,0,0,1,2
821190506,54,34,0,24,1,42,9,164
821190507,431,15,3,7,0,3,13,472
821190508,286,14,3,14,1,3,10,331
821190509,261,13,8,2,19,0,15,318
821190510,394,21,2,13,4,2,12,448
821190511,344,24,4,9,3,6,22,412
821190512,199,12,7,8,24,2,20,272
821190513,257,9,4,5,6,3,8,292
821190514,351,7,16,6,5,6,14,405
821190515,526,33,8,28,3,9,15,622
821190516,118,5,8,11,0,169,63,374
821190517,199,21,1,9,1,13,10,254
821190518,210,63,11,29,1,199,40,553
821190519,394,36,14,45,1,174,41,705
821190601,94,5,0,2,0,5,17,123
821190602,268,9,6,9,9,3,7,311
821190603,468,20,4,15,2,1,16,526
821190604,293,7,3,3,0,4,16,326
821190605,18,0,0,0,4,2,45,69
821190606,212,8,3,3,1,1,36,264
821190607,16,1,0,0,0,0,17,34
821190608,505,38,9,4,0,7,14,577
821190609,404,18,4,10,2,1,8,447
821190610,53,39,3,0,0,5,37,137
821190611,325,27,5,3,7,4,12,383
821190612,368,34,1,3,2,2,18,428
821190613,21,6,0,1,1,8,8,45
821190614,316,7,1,10,1,2,20,357
821190701,373,10,7,7,4,1,10,412
821190702,392,15,4,9,0,0,6,426
821190703,364,20,1,8,0,0,10,403
821190704,321,16,3,6,3,3,9,361
821190705,405,7,2,11,0,3,19,447
821190706,320,16,7,12,19,2,17,393
821190707,183,13,1,0,3,1,13,214
821190708,285,6,5,6,1,1,6,310
821190709,281,8,2,7,1,0,11,310
821190710,260,12,5,2,1,0,3,283
821190711,204,15,7,3,6,2,4,241
821190712,278,17,2,1,5,0,17,320
821190713,87,22,0,1,1,22,5,138
821190714,263,16,3,5,1,1,6,295
821190715,470,21,1,21,2,3,13,531
821190716,339,12,4,5,1,5,13,379
821190801,304,0,2,9,0,7,5,327
821190802,438,10,2,10,2,5,9,476
821190803,354,7,4,11,1,0,8,385
821190804,313,2,5,2,6,0,11,339
821190805,314,5,2,12,0,0,11,344
821190806,189,1,0,10,1,0,16,217
821190807,323,3,2,6,1,0,10,345
821190808,354,2,2,9,1,0,9,377
821190809,269,13,4,2,12,0,12,312
821190810,320,13,4,2,6,4,8,357
821190811,207,9,3,2,0,0,4,225
821190812,177,17,4,1,4,1,12,216
821190813,280,6,5,2,2,0,15,310
821190814,356,10,3,6,0,5,7,387
821190815,317,10,3,3,3,0,5,341
821190816,289,23,5,2,3,0,19,341
821190817,35,0,0,2,1,3,7,48
821190818,241,9,5,2,9,1,3,270
821190901,30,0,0,0,0,0,0,30
821190902,140,3,2,3,0,0,4,152
821190903,274,14,2,0,3,0,4,297
821190904,260,21,3,3,7,3,13,310
821190905,135,8,8,3,0,1,13,168
821190906,479,22,5,11,3,1,14,535
821190907,269,11,2,1,2,1,11,297
821190908,232,26,11,3,1,0,9,282
821190909,241,9,2,2,3,0,10,267
821190910,174,8,4,1,1,2,9,199
821190911,186,21,8,2,11,1,4,233
821190912,221,9,7,2,3,0,8,250
821190913,393,19,8,13,2,2,14,451
821190914,41,3,0,1,1,4,2,52
821191001,231,18,8,1,3,0,6,267
821191002,210,6,19,4,5,1,4,249
821191003,219,12,14,3,9,1,15,273
821191004,269,12,2,2,1,0,10,296
821191005,266,18,2,6,0,1,2,295
821191006,197,9,2,4,0,0,13,225
821191007,357,18,3,7,0,1,9,395
821191008,279,19,10,4,11,0,9,332
821191009,239,22,20,4,19,2,4,310
821191010,155,14,6,2,12,1,4,194
821191011,293,27,10,4,11,0,15,360
821191012,360,27,15,5,17,0,9,433
821191013,272,12,2,3,11,1,12,313
821191014,213,30,27,2,7,1,14,294
821199301,20,9,0,3,0,0,19,51
821199401,4,1,0,0,0,1,14,20
821199402,5,0,0,0,0,0,7,12
821199403,5,0,0,0,0,2,5,12
821199601,1,0,0,0,0,1,2,4
821199701,2,0,0,0,0,0,2,4
821260101,209,8,1,6,1,1,11,237
821260102,76,7,0,0,0,0,3,86
821260103,118,31,0,1,0,0,54,204
821260104,319,16,6,4,1,4,14,364
821260105,125,7,0,0,0,8,66,206
821260106,404,19,3,7,4,1,19,457
821260107,323,18,5,5,0,0,2,353
821260108,379,22,8,1,1,0,24,435
821260109,246,22,3,0,3,2,7,283
821260110,268,12,4,3,0,0,5,292
821260111,52,2,0,0,0,2,70,126
821260112,89,4,0,0,0,2,73,168
821260113,60,13,0,1,1,1,21,97
821260114,225,9,2,7,2,0,13,258
821260201,384,12,8,13,2,0,13,432
821260202,326,22,2,1,5,4,17,377
821260203,23,2,0,0,0,1,6,32
821260204,76,10,0,1,0,3,8,98
821260205,50,8,0,0,0,0,4,62
821260206,212,9,7,5,0,2,2,237
821260207,383,13,1,5,0,0,11,413
821260208,486,12,5,24,8,3,11,549
821260209,338,15,1,4,3,5,26,392
821260210,450,25,4,7,2,1,14,503
821260211,34,3,0,0,0,2,24,63
821260212,52,6,0,0,0,5,38,101
821260213,63,10,0,0,0,1,26,100
821260214,36,6,0,0,0,2,18,62
821260215,98,9,0,0,0,5,39,151
821260216,42,3,0,0,0,0,13,58
821260217,372,17,4,15,6,1,13,428
821260301,83,0,0,12,0,1,92,188
821260302,360,9,6,7,2,0,27,411
821260303,346,12,8,6,7,4,31,414
821260304,350,30,4,4,0,0,15,403
821260305,120,5,0,0,0,2,60,187
821260306,90,7,1,0,0,3,43,144
821260307,381,1,7,5,5,11,24,434
821260308,176,8,3,1,0,0,4,192
821260309,338,9,5,6,1,2,10,371
821260310,251,19,8,4,1,1,9,293
821260311,375,26,9,3,1,0,11,425
821260312,254,18,6,6,4,1,3,292
821260313,450,16,4,18,0,1,17,506
821260314,338,22,8,21,2,0,11,402
821260315,273,15,8,7,2,2,7,314
821260316,188,6,4,1,2,0,7,208
821260317,453,16,7,16,2,2,5,501
821260318,233,11,6,5,1,0,6,262
821260319,328,11,5,15,1,1,6,367
821260401,439,24,7,11,3,2,21,507
821260402,73,5,0,0,0,1,65,144
821260403,61,6,0,0,0,1,53,121
821260404,421,25,7,8,4,2,26,493
821260405,342,17,7,6,2,2,13,389
821260406,393,17,5,12,10,0,36,473
821260407,197,9,1,7,0,5,100,319
821260408,288,17,1,6,1,0,14,327
821260409,508,9,8,12,0,4,13,554
821260410,268,25,3,2,2,0,21,321
821260411,486,18,9,27,6,4,18,568
821260501,215,16,10,5,1,0,15,262
821260502,292,23,7,4,1,0,4,331
821260503,372,16,6,9,3,2,18,426
821260504,306,10,10,4,2,1,22,355
821260505,308,20,15,1,6,1,12,363
821260506,525,24,9,7,1,3,9,578
821260507,305,25,18,7,12,2,12,381
821260508,292,15,12,4,9,1,23,356
821260509,308,8,0,4,1,1,1,323
821260510,324,8,9,19,4,2,16,382
821260511,396,21,4,8,5,8,13,455
821260512,384,12,9,12,7,2,15,441
821260513,262,9,0,51,1,1,7,331
821260514,270,11,1,0,1,0,10,293
821260515,308,9,1,1,1,1,1,322
821260516,349,11,5,3,2,0,4,374
821260517,390,9,2,3,0,2,8,414
821330101,19,3,0,0,0,0,1,23
821330102,39,5,0,0,0,2,19,65
821330103,11,1,1,0,0,0,3,16
821330104,24,8,0,0,0,0,2,34
821330105,17,2,0,0,0,0,0,19
821330106,3,0,0,0,0,0,2,5
821330107,64,2,0,0,0,3,0,69
821330108,23,1,0,0,0,0,3,27
821330109,3,1,0,0,0,0,0,4
821330110,0,1,0,0,0,0,0,1
821330201,286,31,0,10,0,1,38,366
821330202,26,2,0,0,0,0,0,28
821330203,6,6,0,0,0,0,0,12
821330204,87,19,0,1,1,4,19,131
821330205,4,2,0,0,0,0,4,10
821330206,83,11,2,1,3,2,11,113
821330207,36,0,0,0,0,1,4,41
821330208,5,2,0,0,0,2,0,9
821330209,92,8,0,0,0,0,10,110
821330210,5,0,0,0,0,0,4,9
821330211,50,14,0,0,0,6,16,86
821330212,413,32,0,5,6,4,32,492
821330213,264,31,1,9,1,1,14,321
821330214,36,7,0,0,0,1,1,45
821330215,50,2,0,0,0,0,3,55
821330216,24,5,0,0,0,0,5,34
821330217,18,1,0,0,0,2,13,34
821330218,27,5,0,0,0,0,8,40
821330219,260,13,2,8,2,2,29,316
821330220,3,1,0,0,0,3,5,12
821330301,8,0,0,0,0,0,5,13
821330302,0,0,0,0,0,0,3,3
821330303,53,3,0,3,0,1,6,66
821330304,13,4,0,0,0,0,0,17
821330305,12,0,0,0,0,3,11,26
821330306,1,1,0,0,0,1,1,4
821330307,39,15,0,0,0,0,26,80
821330308,61,14,0,0,0,0,5,80
821330309,15,9,0,0,0,3,11,38
821330310,43,5,0,0,0,1,13,62
821330311,87,17,0,0,0,3,20,127
821330312,74,4,0,0,1,1,9,89
821330313,488,42,6,20,3,2,19,580
821330314,66,11,0,1,0,0,10,88
821330315,20,4,0,0,0,0,7,31
821330316,17,3,0,0,0,2,5,27
821330317,20,4,0,0,0,0,10,34
821330318,43,10,0,0,0,3,4,60
821330401,355,17,5,4,2,3,12,398
821330402,327,9,8,4,0,1,6,355
821330403,229,21,2,1,2,0,7,262
821330404,358,32,4,8,7,1,17,427
821330405,342,45,11,5,5,0,17,425
821330406,288,18,1,9,1,0,10,327
821330407,232,8,5,2,0,3,17,267
821330408,156,36,4,3,20,0,11,230
821330409,272,24,5,5,0,0,12,318
821330410,362,29,6,11,7,0,13,428
821330411,237,19,3,1,5,3,13,281
821330412,344,24,1,20,6,0,14,409
821330413,302,17,2,2,6,1,6,336
821330414,259,16,8,6,2,2,10,303
821330415,478,19,1,16,1,0,11,526
821330416,257,16,1,6,0,3,7,290
821330417,371,35,3,6,0,0,6,421
821330501,39,6,0,0,0,2,1,48
821330502,21,2,0,1,0,2,3,29
821330503,8,0,0,0,0,1,3,12
821330504,107,16,0,0,0,2,6,131
821330505,60,5,0,1,2,3,0,71
821330506,2,0,0,0,0,6,4,12
821330507,4,8,0,0,0,0,8,20
821330508,7,3,0,0,0,2,0,12
821330509,58,6,0,0,0,3,9,76
821330510,16,3,0,1,0,7,14,41
821330511,73,10,1,0,0,0,14,98
821330512,21,1,0,0,0,1,10,33
821330513,8,0,0,0,0,0,4,12
821330514,39,8,0,0,0,1,0,48
821330515,19,6,0,0,0,0,3,28
821330516,12,2,0,0,0,2,2,18
821330517,118,15,0,0,0,0,21,154
821330518,52,0,0,0,0,0,36,88
821330519,0,9,0,0,0,0,1,10
821330520,15,7,0,0,0,0,0,22
821330521,0,0,0,0,0,1,6,7
821330522,41,2,0,0,0,13,5,61
821330523,26,1,0,0,0,0,10,37
821330524,34,1,0,0,0,13,4,52
821330525,41,0,0,0,0,0,0,41
821330526,13,0,0,0,1,0,0,14
821330527,17,2,0,0,0,0,12,31
821330528,54,0,1,5,0,1,5,66
821330529,10,0,0,0,0,8,0,18
821330530,15,0,0,0,0,1,6,22
821330531,13,1,0,0,0,2,9,25
821330532,12,1,0,0,0,0,4,17
821330533,339,35,0,1,4,2,20,401
821330534,233,17,0,2,0,2,23,277
821330601,11,0,0,0,0,0,0,11
821330602,74,14,0,0,0,0,10,98
821330603,107,21,0,7,0,5,13,153
821330604,527,38,5,12,4,0,22,608
821330605,407,25,3,16,3,0,23,477
821330606,10,1,0,0,0,0,0,11
821330607,5,0,0,0,0,0,9,14
821330608,97,13,0,0,1,2,18,131
821330609,9,1,0,0,0,0,9,19
821330610,19,8,0,0,0,0,4,31
821330611,8,0,7,0,0,0,7,22
821330612,10,3,0,0,0,0,8,21
821330613,16,2,0,0,0,0,1,19
821330614,40,5,0,0,0,0,10,55
821330615,8,4,0,0,0,0,2,14
821330616,6,2,0,0,0,0,2,10
821330617,286,26,0,3,1,3,38,357
821330618,286,21,0,2,0,1,8,318
821330619,482,41,7,14,2,3,19,568
821330620,444,28,2,4,1,2,22,503
821330621,277,25,1,2,3,0,4,312
821330622,19,1,0,0,0,3,2,25
821330623,23,13,0,0,0,2,3,41
821330624,16,2,0,0,0,0,6,24
821330625,9,0,0,0,0,8,2,19
821330626,18,1,0,0,0,1,29,49
821330627,14,4,0,0,0,1,15,34
821330628,8,3,0,0,0,0,0,11
821330629,459,18,1,16,2,7,11,514
821330630,263,16,4,1,16,2,6,308
821330631,264,9,3,7,5,4,13,305
860070101,38,0,0,0,0,0,0,38
860070102,84,14,0,0,0,0,6,104
860070103,128,31,1,5,0,10,13,188
860070104,106,2,0,5,0,0,0,113
860070105,195,14,0,20,1,4,24,258
860070106,360,42,6,36,4,11,44,503
860070107,346,58,4,18,1,6,16,449
860070108,280,39,2,48,2,9,16,396
860070201,8,3,0,0,0,0,0,11
860070202,27,2,0,1,0,0,3,33
860070203,44,15,1,0,0,0,5,65
860070204,6,4,0,0,0,0,0,10
860070205,7,10,0,0,0,0,1,18
860070206,302,37,2,0,1,1,10,353
860070301,8,7,1,0,0,0,0,16
860070302,23,1,0,0,0,0,3,27
860070303,27,7,0,0,0,2,2,38
860070304,34,0,0,0,0,0,1,35
860140101,242,17,0,0,0,0,8,267
860140102,44,0,0,0,0,0,0,44
860140103,78,0,0,0,0,0,0,78
860140201,48,0,0,0,0,0,0,48
860140202,87,12,0,0,0,0,6,105
860140203,43,1,0,0,0,0,0,44
860140301,58,1,0,0,0,0,12,71
860140302,10,0,0,0,0,0,0,10
860140401,20,0,0,0,0,0,3,23
860140402,39,4,0,0,0,0,0,43
860140501,38,7,0,0,0,0,3,48
860140502,274,33,0,4,0,4,18,333
860140503,239,38,1,6,2,1,27,314
860140504,244,40,2,3,1,4,6,300
860140601,22,0,0,0,0,0,0,22
860140602,47,6,0,0,0,0,1,54
860140603,127,16,0,1,0,0,32,176
860140701,2,2,0,0,0,0,0,4
860140702,259,16,0,1,0,0,3,279
860140703,315,22,0,1,4,1,24,367
860140704,345,27,0,7,1,1,13,394
860140705,298,17,2,6,0,2,19,344
860140706,308,27,1,4,1,2,20,363
860140801,65,2,0,0,0,0,2,69
860140802,42,1,0,0,0,0,0,43
860140901,91,2,5,0,0,3,16,117
860140902,43,10,0,0,0,0,1,54
860140903,33,1,0,0,0,0,0,34
860210101,30,0,0,0,0,0,0,30
860210102,57,5,0,0,0,2,1,65
860210103,145,15,1,4,1,3,20,189
860210104,125,2,0,0,0,7,13,147
860210105,37,5,0,1,0,4,2,49
860210201,373,19,0,1,1,2,25,421
860210202,273,16,0,0,0,0,17,306
860210203,38,3,0,0,0,0,14,55
860210204,183,21,0,4,2,1,13,224
860210205,76,6,0,2,0,0,4,88
860210206,154,40,0,10,1,3,24,232
860210207,242,39,3,10,2,13,26,335
860210208,261,38,5,11,6,10,33,364
860210209,256,35,1,10,0,14,43,359
860210301,52,5,0,0,0,0,7,64
860210302,55,1,0,0,0,0,11,67
860210303,18,0,0,0,0,2,6,26
860210304,43,12,0,0,0,1,2,58
860210305,10,0,0,0,0,0,0,10
860210306,26,1,0,2,0,1,3,33
860280101,94,4,0,0,0,0,0,98
860280102,105,5,0,0,0,0,12,122
860280103,20,3,0,0,0,0,0,23
860280104,41,14,0,1,1,0,3,60
860280201,52,2,0,0,0,0,9,63
860280202,32,6,0,0,0,0,2,40
860280203,101,11,0,0,0,0,12,124
860280204,57,7,0,0,0,0,2,66
860280205,73,14,0,0,1,0,9,97
860280206,182,30,0,4,0,50,104,370
860280207,238,77,2,20,24,16,22,399
860280301,85,3,0,0,0,0,7,95
860280302,69,12,0,3,0,2,10,96
860280303,52,10,0,1,2,1,17,83
860280304,235,45,0,0,0,0,21,301
860280305,179,24,6,4,0,18,19,250
860280401,48,10,0,0,0,4,12,74
860280402,29,4,0,0,0,0,21,54
860280403,158,28,0,0,0,0,9,195
860280404,97,13,1,1,1,1,11,125
860280405,80,4,0,0,0,0,3,87
860280406,126,2,0,0,0,0,1,129
860280407,191,27,2,5,4,7,19,255
860280408,392,46,4,58,0,2,20,522
860280409,368,47,0,4,8,2,17,446
860280410,215,25,2,0,1,1,3,247
860280501,64,7,0,0,0,0,13,84
860280502,100,23,0,0,0,0,2,125
860280503,76,7,0,0,0,0,3,86
860280504,338,55,1,10,2,4,51,461
860350101,59,0,0,0,0,0,4,63
860350102,75,0,0,0,0,7,6,88
860350201,45,1,0,2,0,0,1,49
860350202,28,0,0,0,0,0,0,28
860350203,137,4,0,1,0,2,11,155
860350301,40,0,0,0,0,0,8,48
860350302,23,2,0,0,0,0,0,25
860350303,48,4,0,0,0,0,3,55
860350401,142,0,0,0,0,0,2,144
860350402,128,2,0,0,0,1,4,135
860350501,156,13,0,0,0,0,0,169
860350502,123,12,0,1,0,3,12,151
860350503,67,14,0,0,0,0,3,84
860350601,294,28,0,3,0,0,11,336
860350602,185,9,0,1,0,0,31,226
860350701,95,7,0,6,0,1,2,111
860350702,118,8,0,0,0,0,6,132
860350703,86,6,1,0,0,4,12,109
860350704,294,2,0,6,0,2,35,339
860350705,71,6,0,0,0,1,4,82
860350706,93,3,0,0,0,2,10,108
860350707,248,14,0,6,1,1,2,272
860350801,86,4,0,2,0,0,17,109
860350802,71,20,0,7,0,0,4,102
860350803,168,14,0,2,0,1,4,189
860350804,285,20,0,2,0,1,14,322
860350805,374,44,1,4,0,2,8,433
860350806,259,15,3,4,4,1,9,295
860350807,426,29,4,11,1,2,44,517
860350808,260,19,2,2,3,0,5,291
860350809,283,31,0,4,0,0,10,328
860350810,445,52,2,2,0,4,44,549
860350901,151,8,1,0,0,0,4,164
860350902,91,0,0,1,0,0,1,93
860351001,394,39,0,5,0,1,19,458
860351002,193,4,0,0,0,0,10,207
860351003,52,10,0,0,0,0,1,63
860351004,151,0,0,0,0,0,15,166
860351005,111,6,0,0,0,0,10,127
860351101,278,27,1,0,0,0,13,319
860351102,188,10,0,0,0,0,1,199
860351103,57,2,0,0,0,2,6,67
860351104,67,3,1,0,0,0,4,75
860351105,37,6,0,0,0,4,5,52
860351106,173,53,0,1,0,0,291,518
860351107,509,4,1,16,3,8,44,585
860351108,467,33,1,4,1,0,11,517
860351109,475,29,0,1,1,9,21,536
860351110,1,0,0,0,0,0,525,526
860351111,95,75,0,0,0,0,340,510
860351112,316,41,0,0,0,0,3,360
860351113,349,56,1,0,1,0,16,423
860351114,300,31,2,1,0,7,11,352
860351201,94,17,0,5,0,1,0,117
860351202,165,13,0,4,0,2,8,192
860351203,142,18,0,2,0,3,11,176
860351204,126,10,0,0,0,0,10,146
860351205,379,12,2,18,0,12,13,436
860351206,226,27,0,11,2,1,10,277
860351207,401,2,2,12,0,11,9,437
860351208,266,10,1,0,0,0,2,279
860351209,276,26,5,1,1,0,16,325
860351210,278,14,7,0,1,2,25,327
860351211,266,21,0,0,0,0,8,295
860351213,260,17,2,25,0,1,13,318
860351214,380,10,1,0,1,3,2,397
860351215,269,11,8,7,1,18,9,323
860351216,215,25,0,2,0,0,4,246
860351217,254,17,0,0,0,1,10,282
860351218,170,15,1,4,0,0,1,191
860351219,442,28,1,18,0,8,16,513
860351220,274,19,4,2,1,4,3,307
860351221,35,0,4,3,2,49,2,95
860351301,367,33,0,0,0,0,14,414
860351302,325,8,2,11,0,1,8,355
860351303,417,33,4,3,0,1,4,462
860351304,214,11,3,2,2,1,3,236
860351305,180,9,2,2,9,1,10,213
860351306,225,16,1,5,0,0,5,252
860351307,402,17,3,5,0,0,6,433
860351308,419,9,2,1,0,0,10,441
860351309,248,5,1,1,0,1,6,262
860351310,149,5,2,5,0,0,7,168
860351311,281,15,1,6,0,0,9,312
860351312,265,17,1,0,1,2,8,294
860351313,296,23,0,3,0,0,3,325
860351314,296,20,3,7,1,1,2,330
860351315,318,28,4,9,2,1,6,368
860351316,308,19,2,2,0,0,13,344
860351317,232,15,0,0,0,0,27,274
860351318,263,6,0,4,1,0,10,284
860351319,382,28,0,0,1,6,9,426
860351401,465,19,5,7,0,1,13,510
860351402,238,6,1,2,1,0,16,264
860351403,420,27,2,0,1,0,3,453
860351404,302,10,3,1,0,0,5,321
860351405,347,4,1,3,0,1,8,364
860351406,259,7,2,4,0,0,8,280
860351407,190,6,0,1,1,0,7,205
860351408,291,5,3,3,0,1,20,323
860351409,275,19,3,4,1,3,21,326
860351410,257,29,2,5,7,0,6,306
860351411,237,17,3,3,8,2,23,293
860351412,299,14,4,14,4,1,14,350
860351413,242,12,1,3,1,0,10,269
860351414,373,12,1,7,2,2,15,412
860351415,220,10,2,8,2,2,10,254
860351416,228,5,1,4,0,0,8,246
860351501,246,13,10,4,7,1,11,292
860351502,265,18,3,1,3,0,25,315
860351503,223,7,1,3,2,0,5,241
860351504,370,12,2,6,0,1,28,419
860351505,249,14,0,8,2,1,12,286
860351506,337,15,4,1,0,0,10,367
860351507,272,15,5,2,2,1,17,314
860351508,160,29,13,4,10,0,14,230
860351509,250,14,12,2,3,0,11,292
860351510,329,13,8,5,6,4,28,393
860351511,328,6,0,3,8,3,7,355
860351512,150,10,0,0,2,0,3,165
860351513,285,15,0,3,0,2,7,312
860351514,278,8,2,10,2,1,15,316
860351515,314,5,0,3,1,4,30,357
860351516,326,34,3,5,0,4,22,394
860351517,249,9,1,1,0,0,9,269
860351601,183,10,2,1,5,2,11,214
860351602,227,11,12,5,9,1,8,273
860351603,274,14,3,2,1,2,17,313
860351604,379,35,11,8,7,1,14,455
860351605,248,12,0,6,4,1,4,275
860351606,179,7,4,1,0,1,6,198
860351607,326,2,0,0,1,1,37,367
860351608,245,2,3,1,3,2,19,275
860351609,360,14,3,8,0,2,27,414
860351610,351,36,3,6,0,5,21,422
860351611,250,9,1,2,4,3,8,277
860351612,397,26,3,13,0,7,13,459
860351613,267,26,3,15,1,1,1,314
860420101,78,13,1,2,0,1,5,100
860420102,15,9,0,0,0,0,0,24
860420103,19,10,0,0,0,0,2,31
860420201,11,1,0,0,0,0,0,12
860420202,182,26,1,4,0,1,5,219
860420203,15,6,0,0,0,0,22,43
860420204,11,0,0,0,0,0,1,12
860420205,189,32,1,4,0,0,3,229
860420206,344,33,3,9,0,0,6,395
860420207,372,41,8,10,1,0,7,439
860420208,319,34,10,3,4,2,9,381
860420209,303,33,3,3,0,0,10,352
860420301,114,22,0,0,2,0,8,146
860420302,14,7,0,0,0,0,0,21
860420303,27,6,0,0,1,0,0,34
860420304,17,5,0,0,0,0,0,22
860420305,127,19,0,0,2,0,9,157
860490101,197,0,0,1,0,2,6,206
860490102,130,1,0,3,0,2,8,144
860490103,64,3,0,3,0,0,1,71
860490201,259,3,0,5,0,3,30,300
860490202,308,9,0,10,0,3,24,354
860490301,11,0,0,0,0,0,1,12
860490302,9,1,0,0,0,0,3,13
860490303,350,16,7,7,5,4,14,403
860490304,240,23,4,6,1,1,5,280
860490305,303,23,3,7,6,1,9,352
860490306,279,37,3,2,4,5,8,338
860490307,256,29,2,12,8,3,9,319
860490308,242,26,3,9,5,4,15,304
860490309,244,21,3,7,7,1,4,287
860490310,207,29,2,7,9,0,14,268
860490311,276,46,1,2,2,1,11,339
860490312,175,16,4,235,6,0,27,463
860490313,122,39,4,1,5,1,186,358
860490314,345,53,2,39,9,2,13,463
860490401,66,2,0,0,0,0,19,87
860490402,135,10,0,0,0,0,1,146
860490403,33,10,0,2,0,0,5,50
860490404,35,1,0,1,0,1,3,41
860490501,642,35,0,9,1,42,63,792
860490502,518,25,0,18,0,53,26,640
860490503,264,36,0,4,0,0,5,309
860490504,296,18,0,9,1,2,17,343
860490505,192,11,1,13,2,17,9,245
860490506,298,43,4,42,0,5,5,397
860490507,224,31,0,0,0,0,37,292
860490508,309,45,0,1,0,0,14,369
860490509,337,38,0,1,0,0,4,380
860490510,111,3,0,0,0,0,4,118
860490511,212,10,0,0,0,1,15,238
860490512,225,21,0,1,0,1,5,253
860490513,213,14,0,0,0,0,2,229
860490514,379,29,1,1,0,0,6,416
860490515,300,8,0,1,0,1,20,330
860490516,364,19,2,1,0,1,7,394
860490517,201,29,1,0,0,6,20,257
860490518,306,51,5,7,0,3,21,393
860490519,363,62,0,1,0,2,12,440
860490520,267,14,3,10,3,62,35,394
860490521,186,22,0,2,0,5,7,222
860490522,285,16,1,0,0,0,7,309
860490523,120,45,0,63,0,7,18,253
860490601,94,5,0,0,0,0,11,110
860490602,63,2,0,0,0,0,2,67
860490801,278,18,2,4,5,0,5,312
860490802,229,9,1,1,2,2,3,247
860490803,160,8,0,0,0,0,3,171
860490804,160,2,3,6,0,0,14,185
860490805,197,13,15,11,5,1,18,260
860490806,149,18,6,4,26,1,19,223
860490807,191,17,2,2,2,2,10,226
860490808,160,18,3,5,4,0,7,197
860490809,229,12,5,5,1,2,5,259
860490810,316,11,3,0,2,1,22,355
860490811,186,17,5,0,0,0,13,221
860490812,377,32,9,12,8,2,49,489
860490813,222,15,1,3,1,0,10,252
860490814,184,10,1,0,0,0,6,201
860490815,226,22,0,0,0,0,1,249
860490816,201,9,1,0,0,0,0,211
860490817,363,52,13,14,12,0,23,477
860490818,196,10,3,2,3,0,7,221
860490819,227,15,4,0,1,3,14,264
860490901,271,11,2,0,1,0,10,295
860490902,199,22,0,1,0,0,14,236
860490903,223,30,5,5,2,1,6,272
860490904,252,26,0,5,2,0,14,299
860490905,222,39,11,7,2,0,15,296
860490906,223,69,4,3,6,2,8,315
860490907,153,18,3,0,3,0,5,182
860490908,197,64,31,5,7,0,4,308
860490909,273,46,27,9,46,3,26,430
860490910,113,19,28,1,15,0,16,192
860490911,137,26,15,0,7,0,17,202
860490912,162,44,6,0,0,0,6,218
860490913,202,23,14,2,18,1,23,283
860490914,203,24,33,7,21,0,6,294
860490915,255,34,4,5,12,1,18,329
860490916,227,28,9,7,8,0,5,284
860490917,244,36,5,4,0,1,15,305
860490918,291,35,14,1,3,0,18,362
860490919,249,21,0,0,0,1,4,275
860490920,136,70,10,2,1,0,5,224
860490921,184,25,3,1,17,1,5,236
860490922,152,19,13,4,27,4,17,236
860491001,343,12,2,2,0,2,10,371
860491002,234,7,0,2,0,1,13,257
860491003,468,9,1,9,0,1,29,517
860491004,271,6,1,2,0,3,4,287
860491005,270,20,1,2,0,0,4,297
860491006,369,18,0,4,0,1,3,395
860491007,322,17,1,4,0,0,6,350
860491008,265,25,1,17,1,1,9,319
860491009,286,38,6,5,0,0,13,348
860491010,195,21,7,4,0,3,6,236
860491011,184,29,4,1,6,2,19,245
860491012,280,30,26,0,1,1,39,377
860491013,170,23,1,3,12,0,5,214
860491014,200,38,8,2,4,0,7,259
860491015,247,20,18,3,8,1,6,303
860491016,255,26,4,5,2,0,12,304
860491017,352,7,0,0,1,2,5,367
860491018,292,7,1,2,4,1,3,310
860491019,286,13,1,3,0,0,10,313
860491020,252,8,0,1,4,0,3,268
860491101,326,16,2,6,1,1,15,367
860491102,283,40,2,9,5,0,12,351
860491103,327,34,2,14,0,0,8,385
860491104,208,7,5,7,15,5,3,250
860491105,231,9,0,0,0,0,8,248
860491106,333,18,3,9,1,1,12,377
860491107,227,29,3,2,1,4,8,274
860491108,240,56,13,0,5,6,8,328
860491109,329,49,0,24,6,3,21,432
860491110,246,16,3,2,0,0,9,276
860491111,287,23,1,4,3,0,17,335
860491112,362,44,7,23,7,2,35,480
860491113,349,16,7,2,10,2,16,402
860491114,337,30,6,11,4,2,6,396
860491115,313,20,6,12,1,1,30,383
860491201,215,42,5,0,1,3,9,275
860491202,229,35,5,5,10,0,6,290
860491203,255,9,1,0,3,1,1,270
860491204,248,19,11,22,6,1,15,322
860491205,204,17,3,2,2,1,8,237
860491206,291,30,3,2,1,0,3,330
860491207,229,21,4,1,1,0,8,264
860491208,278,22,0,0,1,0,8,309
860491209,221,24,6,0,0,1,5,257
860491210,311,13,3,0,0,0,3,330
860491211,171,7,0,0,0,0,3,181
860491212,175,19,4,0,1,0,2,201
860491213,253,9,1,1,1,2,4,271
860491214,218,14,3,5,3,2,9,254
860491215,240,13,5,7,4,0,13,282
860491216,266,14,0,2,0,0,3,285
860491217,243,13,0,2,0,0,6,264
860491218,202,20,0,3,5,0,3,233
860491219,214,16,3,3,0,0,8,244
860491220,205,10,2,1,1,2,4,225
860491301,274,52,13,8,22,0,15,384
860491302,208,72,17,2,21,0,9,329
860491303,241,40,4,4,8,1,10,308
860491304,287,32,4,4,9,0,27,363
860491305,300,32,8,2,0,1,12,355
860491306,284,46,1,1,3,0,13,348
860491307,226,11,4,0,4,0,11,256
860491308,222,6,2,4,0,0,5,239
860491309,350,37,18,4,5,2,25,441
860491310,268,19,5,1,9,0,8,310
860491311,274,29,3,3,7,2,51,369
860491312,194,35,11,4,18,0,27,289
860491313,131,17,6,2,1,0,17,174
860491314,170,22,7,1,1,0,6,207
860491401,178,22,3,1,1,0,8,213
860491402,236,23,2,2,1,1,10,275
860491403,321,37,4,5,6,0,18,391
860491404,222,27,2,3,2,0,4,260
860491405,253,12,7,3,8,0,10,293
860491406,249,22,4,3,2,0,8,288
860491407,174,22,1,0,0,0,6,203
860491408,186,9,3,1,0,0,5,204
860491409,156,12,6,2,2,0,3,181
860491410,273,10,9,8,8,0,37,345
860491411,235,15,3,1,1,0,11,266
860491412,330,19,3,8,0,1,8,369
860491413,245,26,5,7,6,4,8,301
860491414,186,9,1,8,0,0,5,209
860491415,263,17,0,3,7,1,6,297
860491501,277,15,3,2,7,0,11,315
860491502,214,5,0,4,0,3,7,233
860491503,323,15,1,6,5,5,9,364
860491504,249,17,11,9,4,1,6,297
860491505,195,23,4,0,0,0,3,225
860491506,316,32,1,3,9,1,14,376
860491507,223,26,3,4,1,2,4,263
860491508,434,29,7,12,2,1,8,493
860491509,297,22,2,0,1,1,5,328
860491510,249,15,1,9,0,0,6,280
860491511,241,9,1,6,1,1,8,267
860491512,268,13,2,8,4,1,10,306
860491513,183,7,3,3,0,5,10,211
860491514,376,26,0,7,1,3,4,417
860491515,202,16,1,6,4,0,1,230
860491601,346,5,1,4,2,1,7,366
860491602,349,16,8,1,2,1,6,383
860491603,275,18,4,3,1,0,9,310
860491604,339,27,5,8,1,0,14,394
860491605,327,13,1,7,0,1,25,374
860491606,261,6,0,4,0,2,15,288
860491607,310,18,0,4,1,0,9,342
860491608,255,14,4,5,0,3,13,294
860491609,265,15,3,1,0,0,4,288
860491610,294,20,1,3,1,0,3,322
860491611,243,27,20,1,2,0,20,313
860491612,273,14,7,4,2,0,16,316
860491613,314,20,3,0,0,1,9,347
860491614,224,17,0,10,0,0,0,251
860491615,325,8,0,4,0,4,7,348
860491616,231,16,3,5,0,1,5,261
860491701,155,5,2,1,0,1,9,173
860491702,209,17,1,3,2,1,9,242
860491703,240,9,1,0,0,1,8,259
860491704,282,16,3,3,0,0,2,306
860491705,265,24,4,8,0,0,8,309
860491706,246,14,2,2,1,0,7,272
860491707,285,8,0,1,2,0,7,303
860491708,212,20,0,7,0,0,8,247
860491709,317,20,3,10,1,3,7,361
860491710,294,18,1,9,0,0,10,332
860491711,287,25,1,4,0,2,9,328
860491712,415,36,3,10,0,0,14,478
860491713,281,12,0,0,1,0,2,296
860491714,283,9,1,4,1,1,2,301
860491715,283,24,2,0,0,0,4,313
860491716,272,19,0,34,1,2,3,331
860491717,287,26,3,50,0,1,6,373
860491718,260,31,0,1,1,1,4,298
860491801,244,4,1,1,0,0,3,253
860491802,360,28,0,3,0,4,4,399
860491803,289,26,0,4,1,0,16,336
860491804,336,29,0,8,0,1,10,384
860491805,307,38,2,0,0,0,9,356
860491806,236,23,0,0,1,1,8,269
860491807,290,13,7,9,0,10,11,340
860491808,273,19,0,1,1,3,7,304
860491809,332,37,0,0,0,3,9,381
860491810,288,26,1,2,3,3,12,335
860491811,207,14,0,1,0,1,44,267
860491812,83,4,0,145,0,0,11,243
860491813,228,12,0,2,0,4,6,252
860491814,206,36,2,1,0,0,5,250
860491815,294,19,0,0,1,0,11,325
860491816,266,25,1,0,0,4,5,301
860491817,284,19,1,0,0,4,9,317
860491901,250,28,2,5,0,4,129,418
860491902,409,47,0,0,1,1,10,468
860491903,430,37,0,1,0,3,15,486
860491904,360,47,1,0,1,0,97,506
860491905,361,56,0,0,0,7,76,500
860491906,398,59,0,0,0,0,6,463
860491907,298,45,11,13,0,6,263,636
860491908,375,47,0,0,0,3,10,435
860491909,286,46,0,72,1,0,94,499
860491910,75,15,0,0,0,0,289,379
860491911,299,27,0,0,0,4,12,342
860491912,322,45,0,0,0,0,3,370
860491913,185,34,0,197,1,0,2,419
860491914,328,38,0,0,0,3,82,451
860491915,194,17,2,117,1,0,46,377
860491916,287,32,1,32,4,86,76,518
860560101,181,8,0,0,0,0,0,189
860560102,200,25,0,0,0,0,1,226
860560103,156,7,0,0,0,0,5,168
860560104,206,65,0,2,6,2,22,303
860560201,52,0,0,0,0,0,0,52
860560202,120,58,0,0,0,0,13,191
860560203,133,1,0,0,0,0,2,136
860560204,90,1,0,1,0,0,1,93
860560205,111,1,0,0,0,0,0,112
860560206,60,4,0,0,0,0,1,65
860560301,26,0,0,0,0,0,0,26
860560302,63,1,0,0,0,0,1,65
860560303,120,10,0,0,0,2,11,143
860560304,114,23,0,0,1,0,7,145
860560305,71,12,1,7,0,0,13,104
860560306,390,79,0,12,3,1,10,495
860560307,341,30,5,55,1,0,17,449
860560308,295,76,2,6,1,1,19,400
860560309,227,43,0,1,0,3,16,290
860560310,202,45,0,6,3,0,15,271
860560311,226,58,1,1,2,1,8,297
860560312,486,95,2,15,5,2,40,645
860560313,196,19,3,3,4,0,12,237
860560314,214,46,0,0,0,0,8,268
860560315,269,65,2,10,4,0,14,364
860560401,63,0,0,0,2,1,2,68
860560402,112,11,0,0,0,0,9,132
860560403,83,13,0,0,0,0,2,98
860560404,144,12,1,2,3,1,15,178
860560405,341,34,2,17,7,3,12,416
860560501,333,80,1,6,0,3,1,424
860560502,257,42,1,25,3,1,19,348
860560503,251,34,5,9,5,1,23,328
860560504,247,58,2,4,1,1,29,342
860560505,279,39,3,17,0,2,27,367
860630101,12,0,0,1,0,1,0,14
860630102,148,24,0,3,1,3,17,196
860630103,136,13,0,0,0,5,12,166
860630104,99,2,0,1,0,5,7,114
860630105,31,15,0,0,0,0,1,47
860630106,200,91,1,5,0,0,12,309
860630201,95,7,0,3,0,0,10,115
860630202,50,2,0,0,0,2,7,61
860630203,49,8,0,0,0,0,7,64
860630204,27,4,0,0,0,0,0,31
860630205,293,31,1,5,0,0,36,366
860630301,100,11,0,0,1,1,11,124
860630302,40,5,0,0,0,6,10,61
860630303,269,44,5,6,7,9,25,365
860630401,29,2,0,0,0,1,2,34
860630402,40,15,0,1,0,0,9,65
860630403,145,29,2,5,1,0,7,189
860630501,69,4,0,1,0,0,5,79
860630502,34,3,0,0,0,0,0,37
860630601,190,18,0,11,0,1,7,227
860630602,280,41,1,2,0,1,3,328
860630603,154,62,3,119,1,0,4,343
860630604,200,13,1,3,1,0,13,231
860630605,329,30,1,0,0,1,7,368
860630606,224,27,0,4,0,0,7,262
860630607,206,15,2,0,0,0,4,227
860630608,229,13,5,1,1,0,7,256
860630609,277,22,1,7,0,0,12,319
860630610,293,41,4,12,0,2,17,369
860630611,262,23,13,2,0,3,10,313
860630612,246,21,1,2,0,0,7,277
860630613,239,16,1,1,0,3,7,267
860630614,264,31,2,5,2,0,5,309
860630615,219,21,8,11,9,2,11,281
860630701,0,1,0,0,0,0,0,1
860630702,0,1,0,0,0,0,0,1
860630703,0,1,0,0,0,0,0,1
860630801,322,17,0,2,0,1,8,350
860630802,246,23,2,1,16,0,8,296
860630803,169,30,1,3,3,0,14,220
860630804,208,28,4,8,0,2,16,266
860630805,200,18,1,2,0,2,4,227
860630806,250,23,1,4,0,1,11,290
860630807,252,39,2,0,0,1,6,300
860630808,208,21,3,8,3,3,9,255
860630809,151,10,11,2,0,1,10,185
860630810,303,29,7,6,3,1,14,363
860630811,277,20,7,4,1,3,14,326
860630812,174,14,0,0,0,0,0,188
860630813,294,29,5,9,3,1,6,347
860630814,181,20,6,4,9,1,11,232
860630815,317,31,2,10,0,1,11,372
860700101,116,13,0,0,0,0,8,137
860700102,89,16,0,0,0,0,5,110
860700103,153,13,0,3,0,1,6,176
860700104,158,14,0,4,0,0,9,185
860700201,269,31,0,1,0,0,15,316
860700202,432,21,0,2,1,2,26,484
860700203,193,39,0,2,0,3,3,240
860700301,43,1,0,0,0,0,0,44
860700302,150,10,0,0,0,0,1,161
860700401,585,31,2,4,3,3,30,658
860700402,286,14,0,4,0,1,19,324
860700403,181,11,0,3,0,0,9,204
860700501,125,6,0,0,0,1,6,138
860700502,138,7,0,0,0,4,3,152
860700503,146,22,0,2,0,2,10,182
860700504,39,3,0,0,0,0,6,48
860700505,90,10,1,4,1,1,5,112
860700601,88,2,0,0,0,4,10,104
860700602,85,13,0,0,0,1,3,102
860700603,343,52,1,3,1,0,13,413
860770101,278,21,3,2,0,1,3,308
860770102,202,6,0,0,0,0,2,210
860770103,166,33,0,1,0,0,11,211
860770201,112,8,0,0,0,1,2,123
860770202,414,47,1,5,0,0,10,477
860770203,106,31,1,0,0,1,6,145
860770204,79,7,0,0,0,0,4,90
860770205,366,42,1,19,3,1,21,453
860770206,244,21,0,6,0,0,0,271
860770207,223,34,1,1,2,0,8,269
860770301,217,15,0,2,0,0,15,249
860770302,201,25,0,1,1,0,16,244
860770303,59,2,0,0,0,7,10,78
860770401,41,0,0,0,0,0,0,41
860770402,149,16,0,0,0,0,1,166
860770403,54,13,0,0,0,0,0,67
860770404,37,12,0,0,0,0,3,52
860770405,205,20,1,4,0,0,3,233
860770501,174,17,0,8,0,1,14,214
860770502,305,25,0,1,0,0,13,344
860770503,181,23,3,2,1,2,9,221
860770504,194,17,0,4,0,1,6,222
860770505,293,30,4,97,0,0,7,431
860770506,231,22,6,5,0,4,14,282
860770507,181,13,2,0,0,1,3,200
860770508,301,50,3,11,1,1,9,376
860770509,182,26,7,2,3,0,13,233
860770510,168,30,2,2,3,0,8,213
860770511,200,33,0,1,0,0,9,243
860770512,212,13,2,1,0,1,5,234
860770601,171,32,1,12,0,2,7,225
860770602,207,23,2,1,0,0,4,237
860770603,200,24,2,3,0,2,12,243
860770604,209,28,10,2,15,0,24,288
860770605,193,11,2,2,2,1,11,222
860770606,163,6,5,1,1,2,13,191
860770607,152,23,1,10,3,0,5,194
860770608,345,32,2,10,1,0,19,409
860770609,208,14,1,3,0,3,6,235
860770610,237,28,0,6,0,0,6,277
860770611,228,27,7,0,1,0,2,265
860770612,231,33,1,0,1,0,5,271
860840101,26,10,0,0,0,0,1,37
860840102,124,15,2,3,1,4,16,165
860840103,26,1,0,0,0,0,5,32
860840201,89,12,0,0,0,2,5,108
860840202,47,5,0,0,0,0,6,58
860840301,141,23,1,0,0,1,6,172
860840302,49,8,0,0,3,0,3,63
860840303,86,3,0,1,0,3,3,96
860840304,81,8,0,0,0,0,1,90
860840305,86,8,0,1,1,2,8,106
860840401,42,10,0,0,0,0,0,52
860840402,22,1,0,0,0,6,1,30
860840403,26,7,0,0,0,3,6,42
860840404,23,15,0,0,0,0,0,38
860840405,69,26,0,0,0,4,2,101
860840406,192,31,4,9,10,13,28,287
860840407,249,32,4,6,4,10,16,321
860840408,218,18,2,1,0,0,32,271
860840409,199,32,8,5,5,4,16,269
860910101,117,10,1,0,0,0,13,141
860910102,26,4,0,0,0,0,5,35
860910103,24,10,0,6,0,0,6,46
860910104,41,8,0,0,0,0,8,57
860910105,87,28,1,1,0,0,7,124
860910106,64,28,0,0,0,0,27,119
860910107,38,18,1,1,0,1,9,68
860910108,12,1,0,2,0,0,4,19
860910109,260,53,3,13,5,3,33,370
860910201,29,6,0,1,0,0,28,64
860910202,14,0,0,0,0,0,2,16
860910203,12,2,0,2,0,0,7,23
860910204,7,1,0,0,0,0,3,11
860910301,30,1,0,0,0,0,0,31
860910302,27,0,0,0,0,0,0,27
860910401,21,11,0,3,0,0,15,50
860910402,58,14,0,0,0,2,6,80
860910403,96,23,0,8,0,1,4,132
860910404,75,32,0,4,1,7,21,140
860910405,94,20,0,3,0,6,8,131
860910406,176,63,3,4,1,10,22,279
860910407,96,20,0,9,0,8,15,148
860910408,34,2,0,0,0,0,1,37
860910409,32,7,0,2,0,0,0,41
860910410,275,43,1,8,0,9,15,351
860910411,274,50,2,4,1,3,12,346
860980101,71,18,0,0,0,1,0,90
860980102,17,0,0,0,0,0,4,21
860980103,93,2,0,0,0,0,4,99
860980104,34,0,0,0,0,0,4,38
860980105,32,3,0,0,0,0,4,39
860980106,30,4,0,2,0,4,0,40
860980107,11,0,0,0,0,2,0,13
860980108,365,54,2,4,1,5,5,436
860980109,459,17,0,0,17,0,0,493
860980110,322,33,5,3,4,5,19,391
860980111,262,86,3,3,0,1,9,364
860980112,184,30,1,8,0,1,0,224
860980201,126,7,0,4,0,1,2,140
860980202,12,4,0,0,0,0,0,16
860980203,40,3,0,1,0,0,7,51
860980204,40,8,0,0,0,0,2,50
860980205,234,43,1,4,0,4,3,289
860980301,60,3,0,0,3,2,3,71
860980302,27,8,0,0,0,0,0,35
860980303,12,3,0,0,0,0,1,16
860980304,19,1,0,0,0,0,0,20
860980305,380,29,2,4,5,6,16,442
860980401,219,21,0,3,0,3,10,256
860980402,144,1,1,0,0,0,27,173
860980403,155,16,0,0,0,0,0,171
860980501,26,0,0,0,0,0,2,28
860980502,117,8,0,0,0,0,3,128
860980503,143,8,0,0,0,0,1,152
860980601,28,0,0,0,0,1,1,30
860980602,52,0,0,0,0,0,0,52
860980603,14,0,0,0,0,0,0,14
860980701,33,0,0,0,0,0,0,33
860980702,18,3,0,0,0,0,0,21
860980703,8,0,0,0,0,0,0,8
861050101,494,42,0,8,0,3,22,569
861050102,57,7,0,0,0,1,0,65
861050201,285,63,0,1,0,5,5,359
861050202,41,3,0,2,0,1,5,52
861050203,370,25,0,1,0,2,15,413
861050204,401,36,1,0,0,3,19,460
861050205,283,45,5,0,3,2,9,347
861050206,278,34,1,7,0,1,7,328
861050207,341,38,1,6,0,2,12,400
861050208,288,22,6,5,0,4,13,338
861050209,314,29,1,6,2,2,16,370
861050210,334,30,2,9,1,3,19,398
861050211,261,54,2,3,0,6,7,333
861050212,278,25,0,22,0,5,16,346
861050301,161,35,0,0,0,1,14,211
861050302,161,8,0,1,0,0,5,175
861050303,71,12,0,1,0,0,0,84
861120101,27,0,0,0,0,1,2,30
861120102,67,4,0,0,0,1,14,86
861120103,44,5,0,0,0,1,0,50
861120104,36,2,0,0,0,0,5,43
861120105,47,0,0,0,0,0,7,54
861120201,73,12,0,0,0,0,1,86
861120202,25,3,0,0,0,2,3,33
861120203,160,34,0,5,2,3,16,220
861120302,42,0,0,0,0,0,0,42
861190101,390,20,1,0,0,1,10,422
861190102,380,39,1,5,0,3,8,436
861190103,335,33,0,6,2,3,4,383
861190104,426,39,1,7,14,1,8,496
861190201,53,8,0,3,0,0,6,70
861190202,23,11,0,0,0,0,3,37
861190203,17,7,0,0,0,0,7,31
861190301,99,12,0,0,0,0,1,112
861190302,66,17,0,0,0,1,1,85
861190303,89,17,0,0,0,0,7,113
861190304,32,0,0,0,0,0,0,32
861190401,127,17,0,0,0,1,3,148
861190402,20,5,0,0,0,1,0,26
861190403,32,12,0,0,0,0,0,44
861190404,214,36,0,0,0,3,14,267
861190405,121,17,0,2,1,2,7,150
861190406,289,49,2,15,1,0,18,374
861190407,282,38,1,104,2,0,14,441
861190408,373,48,7,11,0,1,23,463
861190409,364,30,4,8,0,1,15,422
861190410,243,37,4,4,1,2,6,297
861190411,129,21,2,5,2,1,4,164
861190412,338,42,3,5,1,0,5,394
861190413,487,37,1,1,2,2,27,557
861190414,373,33,0,6,2,1,17,432
861190415,218,13,0,2,0,2,0,235
861190501,178,10,0,0,0,0,6,194
861190502,156,28,0,0,0,0,5,189
861190503,159,0,0,0,0,0,1,160
861260101,46,3,0,0,0,1,5,55
861260102,7,2,0,0,1,0,3,13
861260201,165,14,1,1,0,7,4,192
861260202,36,1,0,0,0,7,9,53
861260203,120,14,1,3,0,2,8,148
861260204,91,4,0,1,0,15,6,117
861260301,208,24,3,2,0,4,13,254
861260302,86,16,1,1,0,8,21,133
861260303,76,9,0,0,0,5,22,112
861260304,32,11,0,0,0,0,2,45
861260305,58,8,0,0,0,1,10,77
861260306,30,3,0,0,0,0,0,33
861260307,293,35,4,6,2,4,9,353
861260308,289,44,5,10,3,3,11,365
861260309,265,56,4,11,3,3,16,358
861260310,482,63,6,19,0,6,22,598
861260311,279,52,2,6,5,1,10,355
861260312,322,58,3,6,0,6,13,408
861260313,265,22,1,7,1,0,12,308
861260401,86,15,2,0,0,0,2,105
861260402,80,1,0,0,0,1,13,95
861260403,126,4,0,0,0,9,20,159
861260404,29,3,0,1,0,1,1,35
861330101,68,14,0,0,0,0,0,82
861330102,82,6,0,0,0,0,7,95
861330103,86,43,1,1,0,2,18,151
861330201,107,8,0,1,0,3,4,123
861330202,66,3,0,0,0,0,11,80
861330203,246,55,0,8,0,6,38,353
861330204,191,31,0,3,0,0,6,231
861330205,326,52,2,22,0,5,10,417
861330301,153,11,0,3,0,0,17,184
861330302,84,18,0,0,0,0,1,103
861330303,137,39,1,3,0,0,5,185
861330304,30,7,0,1,0,4,3,45
861330305,46,15,1,5,0,2,6,75
861330401,57,2,0,0,0,0,2,61
861330402,43,9,0,1,0,0,8,61
861330403,174,74,0,5,1,9,38,301
861330404,313,41,1,4,3,0,17,379
861330405,46,3,0,0,0,2,11,62
861330406,108,24,1,3,1,5,29,171
861330407,190,18,10,6,4,7,19,254
861330408,178,35,10,5,9,4,31,272
861330409,175,38,0,9,0,2,7,231
861330410,504,111,4,15,3,20,40,697
861330501,14,1,0,0,1,0,2,18
861330502,16,2,0,0,0,0,10,28
861330503,21,1,0,0,0,0,7,29
861330504,113,12,0,1,1,1,9,137
861330505,291,52,2,25,7,7,31,415
861330601,75,5,1,0,0,2,12,95
861330602,56,5,0,0,0,1,4,66
861330603,73,2,0,0,0,2,10,87
861330701,227,32,3,3,0,2,14,281
861330702,139,26,0,0,0,0,22,187
861330801,31,1,0,0,0,0,3,35
861330802,237,40,1,1,0,2,14,295
861400101,89,5,0,0,0,1,13,108
861400102,47,3,0,0,0,2,5,57
861400103,193,39,0,1,1,5,10,249
861400104,60,1,0,0,0,3,4,68
861400105,128,28,0,0,0,2,16,174
861400201,90,18,1,0,0,11,14,134
861400202,47,28,0,0,0,3,4,82
861400203,43,6,1,0,0,1,8,59
861400204,125,8,0,0,0,0,0,133
861400205,196,22,1,2,2,0,6,229
861400206,329,33,3,0,0,5,15,385
861400207,231,21,3,48,0,2,8,313
861400208,201,24,2,8,0,9,8,252
861400209,267,55,1,4,0,4,2,333
861400210,239,36,1,2,1,1,11,291
861400301,118,8,0,0,0,1,1,128
861400302,70,0,0,0,0,0,2,72
861400303,126,7,0,0,0,1,5,139
861470101,140,0,0,0,0,1,11,152
861470102,203,56,1,0,0,7,25,292
861470103,275,44,1,5,1,0,27,353
861470104,141,11,0,1,0,0,15,168
861470201,122,15,2,3,0,7,11,160
861470202,278,17,0,5,0,0,36,336
861470301,239,77,1,131,0,3,79,530
861470302,164,16,8,12,1,10,29,240
861470401,259,22,1,9,2,2,29,324
861470402,119,101,7,7,0,65,99,398
861470403,116,9,1,13,0,0,17,156
861470501,183,14,0,1,0,0,21,219
861470502,252,43,1,10,1,0,19,326
861470503,119,7,0,0,0,0,2,128
861470504,121,17,2,2,1,1,11,155
861470601,146,9,0,3,0,1,41,200
861470602,86,21,0,2,0,0,4,113
861470603,79,6,0,0,2,1,14,102
861470701,42,7,0,1,0,0,12,62
861470702,76,17,0,2,1,0,3,99
861470703,189,16,1,5,0,49,15,275
861470704,212,47,0,2,0,6,12,279
861470705,110,8,1,0,0,3,14,136
861470706,163,60,0,2,1,8,26,260
861470801,319,36,1,4,0,0,5,365
861470802,296,30,2,7,5,3,7,350
861470803,272,37,4,4,0,9,12,338
861470804,176,15,4,9,3,9,14,230
861470805,187,31,9,14,3,5,10,259
861470806,246,26,3,3,1,7,16,302
861470807,321,30,1,2,0,3,18,375
861470808,311,4,0,5,1,2,46,369
861470809,219,20,1,8,5,3,17,273
861470810,190,34,0,4,0,3,17,248
861470811,277,25,2,16,3,2,30,355
861470812,243,18,2,8,0,3,10,284
861470813,223,18,1,6,1,5,21,275
861470814,299,32,1,1,0,0,6,339
861470815,115,42,7,2,1,5,25,197
861470816,171,50,3,8,0,8,18,258
861470817,163,6,1,6,0,0,35,211
861470901,226,23,6,25,0,5,8,293
861470902,333,33,4,4,0,3,14,391
861470903,226,39,1,8,0,6,9,289
861470904,204,42,2,5,0,1,6,260
861470905,248,20,4,10,2,1,16,301
861470906,174,20,5,0,3,31,23,256
861470907,64,20,4,0,4,0,13,105
861470908,153,23,33,0,1,4,26,240
861470909,192,19,2,2,1,1,16,233
861470910,135,29,2,1,0,0,4,171
861470911,78,80,82,0,0,1,7,248
861470912,199,11,6,2,9,17,22,266
861470913,162,5,6,9,1,0,4,187
861470914,219,17,1,7,0,0,12,256
861470915,197,29,3,4,1,2,24,260
861470916,214,30,2,2,0,1,5,254
861470917,197,41,0,19,0,6,9,272
861470918,154,10,1,2,2,0,16,185
861470919,195,22,1,3,0,0,2,223
861540101,30,2,0,0,0,2,12,46
861540102,76,1,1,0,0,0,14,92
861540103,14,2,0,0,0,0,4,20
861540104,45,2,0,0,0,0,5,52
861540105,31,1,0,0,0,1,12,45
861540106,280,29,0,1,0,3,5,318
861540107,335,29,4,50,2,3,16,439
861540108,221,19,2,0,0,1,6,249
861540201,27,10,0,0,0,0,4,41
861540202,59,10,0,0,0,1,2,72
861540203,108,33,3,1,0,3,11,159
861540204,10,0,0,0,0,0,2,12
861540301,26,0,0,0,0,0,5,31
861540302,54,8,0,0,0,2,10,74
861540303,63,3,5,0,0,1,11,83
861610101,153,3,0,3,0,2,10,171
861610102,109,13,0,0,0,2,6,130
861610103,83,14,0,1,2,4,20,124
861610104,116,10,0,1,0,3,3,133
861610105,306,24,0,8,0,12,28,378
861610106,195,7,0,6,0,10,12,230
861610107,225,22,6,6,6,8,31,304
861610108,261,13,2,59,0,12,18,365
861610109,324,46,2,14,13,10,45,454
861610110,323,19,7,6,1,2,31,389
861610111,269,28,6,6,2,0,12,323
861610112,276,22,3,6,1,1,12,321
861610201,45,44,0,4,0,0,19,112
861610202,41,0,0,0,0,1,3,45
861610203,174,26,2,0,0,0,7,209
861610204,209,10,1,2,6,0,7,235
861610205,160,14,0,0,0,2,8,184
861610206,193,30,0,2,3,1,9,238
861610301,261,18,0,0,0,0,7,286
861610302,173,22,1,4,0,0,15,215
861610303,45,4,0,0,0,1,5,55
861610304,51,11,0,2,1,0,11,76
861610305,99,25,0,0,0,0,5,129
861610306,54,15,0,0,0,0,16,85
861610307,39,5,0,0,0,0,0,44
861610308,450,31,1,13,2,3,13,513
861610309,250,17,3,5,0,1,9,285
861610310,209,9,1,12,0,1,16,248
861610311,197,33,2,10,0,1,7,250
861610312,255,26,6,9,0,0,11,307
861610313,185,19,3,8,6,0,14,235
861610314,224,21,0,18,0,0,9,272
861610315,228,16,2,8,0,1,5,260
861610316,273,19,0,6,0,1,18,317
861610317,211,37,0,8,0,4,5,265
861610318,290,25,2,3,2,0,9,331
861610319,221,4,0,14,0,1,6,246
861610401,57,3,1,0,0,0,2,63
861610402,69,11,0,1,0,0,4,85
861610403,119,11,0,0,0,1,12,143
861610404,202,10,1,3,0,3,12,231
861610405,118,7,1,3,0,2,7,138
861610406,121,10,0,2,0,1,12,146
861610407,44,3,0,0,0,0,5,52
861610408,20,3,0,0,0,0,4,27
861610409,293,13,0,8,1,1,18,334
861610410,301,37,1,3,0,0,15,357
861610411,196,8,1,2,1,6,5,219
861610412,299,13,1,8,0,6,8,335
861610413,185,9,2,5,1,6,10,218
861680101,110,23,0,2,0,11,4,150
861680102,107,10,0,0,0,1,0,118
861680103,146,16,0,2,0,0,29,193
861680104,86,12,0,0,0,0,0,98
861680105,144,14,3,1,3,3,23,191
861680201,159,30,0,2,0,0,7,198
861680202,202,14,2,5,3,5,19,250
861680203,126,10,0,0,0,0,5,141
861680204,130,10,0,0,0,0,1,141
861680205,191,66,0,4,0,0,11,272
861680206,371,75,9,20,3,5,23,506
861680207,294,57,1,10,1,6,30,399
861680301,223,22,0,0,0,4,3,252
861680302,180,12,0,0,0,0,1,193
861680303,64,1,0,0,0,0,3,68
861680304,119,9,0,0,0,1,8,137
861750101,315,35,1,2,0,1,10,364
861750102,62,2,0,0,0,3,5,72
861750103,118,0,0,0,0,1,9,128
861750201,59,7,0,0,0,0,3,69
861750202,72,8,0,0,0,0,2,82
861750203,126,3,0,0,0,1,6,136
861750204,254,15,1,6,2,2,5,285
861750301,141,22,0,0,0,10,7,180
861750302,54,1,0,0,1,2,13,71
861750303,147,7,0,0,0,0,6,160
861750304,169,29,0,2,0,3,18,221
861750305,160,15,0,1,0,5,9,190
861750306,171,24,0,1,1,1,13,211
861750307,218,13,0,0,0,8,17,256
861820101,14,0,0,0,0,0,1,15
861820102,34,1,0,0,0,0,0,35
861820103,83,2,0,0,0,0,1,86
861820201,56,19,0,0,0,0,0,75
861820202,8,0,0,0,0,3,4,15
861820203,74,14,0,0,0,0,0,88
861820204,41,8,0,0,0,1,13,63
861820205,258,38,2,12,4,8,14,336
861820206,339,38,1,7,7,5,44,441
861820301,72,12,0,0,0,2,4,90
861820302,62,4,0,0,0,2,3,71
861890101,285,12,2,2,0,3,15,319
861890102,83,8,0,2,0,0,11,104
861890103,241,4,0,3,0,0,15,263
861890201,249,13,0,3,3,0,21,289
861890202,157,7,0,0,2,3,12,181
861890203,9,0,0,1,0,0,1,11
861890301,108,9,0,0,0,0,4,121
861890302,251,23,1,3,0,0,3,281
861890303,237,33,0,2,1,1,8,282
900070101,14,1,0,0,0,5,0,20
900070102,19,11,0,0,0,0,0,30
900070103,40,1,0,0,0,0,17,58
900070104,84,4,0,5,0,67,11,171
900070105,76,13,0,1,0,33,56,179
900070201,30,0,0,2,0,7,15,54
900070202,25,1,0,0,0,0,3,29
900070203,20,0,0,2,0,2,1,25
900070204,132,14,0,2,0,0,5,153
900070205,146,3,0,4,0,13,13,179
900070206,77,3,0,1,0,4,4,89
900070301,26,3,0,0,0,1,0,30
900070302,17,0,0,0,0,3,3,23
900070303,18,1,0,0,0,3,0,22
900070304,18,1,0,0,0,0,0,19
900070305,30,10,0,0,0,2,6,48
900070306,118,7,1,0,0,1,14,141
900070401,70,2,0,0,0,0,1,73
900070402,54,4,0,0,0,0,1,59
900070403,125,21,0,0,0,0,1,147
900070404,76,9,0,0,0,3,0,88
900070405,230,41,2,50,4,2,14,343
900070406,13,0,0,0,0,0,6,19
900070407,93,4,0,0,0,0,4,101
900070408,332,27,3,3,1,9,19,394
900070409,292,9,4,22,7,3,9,346
900070410,276,16,2,7,2,1,13,317
900070501,70,5,0,0,0,0,5,80
900070502,51,3,0,1,0,3,1,59
900070503,85,8,0,0,0,1,6,100
900070504,65,4,0,1,0,0,1,71
900070505,96,3,0,2,0,0,8,109
900070506,85,1,0,0,0,1,4,91
900070507,64,14,0,1,0,0,11,90
900070508,80,1,4,2,3,11,5,106
900070509,110,8,0,0,1,4,15,138
900070601,121,1,0,4,1,8,11,146
900070602,89,6,0,5,0,6,6,112
900070603,40,0,0,0,0,1,1,42
900070604,132,1,0,0,0,4,7,144
900070605,47,3,0,1,0,1,5,57
900070606,119,2,0,2,0,0,2,125
900070607,173,10,0,1,0,6,15,205
900070608,69,7,0,1,0,2,7,86
900070609,125,7,1,4,0,5,14,156
900070610,108,1,0,0,2,1,10,122
900070611,249,23,1,1,5,1,10,290
900070701,104,0,0,0,0,0,1,105
900070702,100,10,0,1,0,0,8,119
900070703,134,14,1,5,0,3,10,167
900070704,141,5,0,1,1,3,12,163
900070705,57,4,0,1,0,2,1,65
900070706,16,2,0,0,0,0,0,18
900070707,58,6,0,3,0,0,14,81
900070708,69,2,0,0,0,0,12,83
900070709,60,0,0,2,0,1,4,67
900070710,339,7,0,2,0,2,24,374
900070711,128,4,0,2,3,4,5,146
900070712,372,11,1,8,4,2,13,411
900070801,107,16,1,2,1,14,2,143
900070802,27,4,0,0,0,1,3,35
900070803,83,7,1,4,2,19,21,137
900070804,36,10,0,0,0,2,1,49
900070805,179,11,0,6,1,9,16,222
900070806,69,17,0,3,0,20,5,114
900070807,274,15,0,4,0,11,7,311
900070808,179,7,0,0,0,12,15,213
900070809,62,3,0,0,0,9,2,76
900070901,21,2,0,0,0,4,3,30
900070902,78,2,0,1,0,10,9,100
900070903,149,28,6,16,0,28,12,239
900070904,202,4,1,4,0,4,15,230
900070905,52,14,0,1,0,6,13,86
900071001,160,6,0,1,0,2,22,191
900071002,54,6,0,0,0,5,20,85
900071003,61,9,0,0,0,7,7,84
900071004,50,12,0,3,0,0,2,67
900071005,209,21,4,0,0,4,12,250
900071006,43,2,0,1,0,4,3,53
900071007,292,23,0,9,1,4,6,335
900140101,121,4,0,0,0,0,2,127
900140102,258,4,0,1,0,1,8,272
900140103,390,8,3,6,2,2,5,416
900140104,160,5,1,7,0,0,0,173
900140105,170,12,4,1,0,0,0,187
900140106,151,8,3,5,0,0,5,172
900140107,259,10,2,9,1,1,10,292
900140108,188,8,0,0,0,0,0,196
900140109,438,32,0,9,2,1,13,495
900140110,327,14,4,11,0,0,15,371
900140111,164,10,0,20,0,0,7,201
900140112,587,26,3,37,1,2,12,668
900140113,389,20,5,0,3,0,14,431
900140114,410,26,1,3,1,0,6,447
900140115,409,15,0,12,2,0,5,443
900140116,447,42,2,9,0,1,7,508
900140117,210,17,0,0,0,0,4,231
900140118,286,17,0,4,1,2,8,318
900140119,250,22,1,1,0,0,2,276
900140120,219,13,2,1,1,0,1,237
900140121,357,13,0,1,0,0,3,374
900140122,418,28,0,7,0,1,31,485
900140123,309,6,2,3,0,0,6,326
900140124,268,12,4,5,3,2,2,296
900140125,234,21,1,7,0,0,12,275
900140126,497,17,7,24,1,2,14,562
900140127,397,25,4,14,4,2,5,451
900140128,228,6,3,18,1,0,4,260
900140129,287,8,1,3,0,0,3,302
900140130,405,17,0,5,1,3,13,444
900140131,405,23,1,0,0,0,2,431
900140201,59,0,0,0,0,0,13,72
900140202,117,1,0,0,0,0,1,119
900140203,32,0,0,0,0,0,2,34
900140204,143,3,0,3,0,0,11,160
900140205,156,0,0,3,0,0,3,162
900140206,40,0,0,0,0,0,4,44
900140207,320,4,0,4,5,1,4,338
900140208,342,6,2,8,1,1,8,368
900140209,207,2,0,1,0,0,11,221
900140210,229,2,0,0,0,0,3,234
900140211,219,6,0,6,0,0,5,236
900140301,222,10,1,9,1,1,10,254
900140302,43,0,0,2,0,4,2,51
900140303,26,0,0,0,1,1,4,32
900140304,60,5,0,3,0,0,4,72
900140401,36,5,0,0,0,3,6,50
900140402,57,14,0,0,0,1,0,72
900140403,197,20,4,1,0,4,19,245
900140404,230,26,5,6,5,1,11,284
900140501,29,5,0,1,0,0,3,38
900140502,93,2,0,2,0,2,4,103
900140503,128,31,0,19,0,2,10,190
900140504,73,3,0,0,0,0,5,81
900140505,68,1,2,1,0,5,2,79
900140506,90,9,0,0,0,0,5,104
900140601,125,1,1,1,0,0,1,129
900140602,14,0,0,0,0,0,2,16
900140603,6,0,0,0,0,0,4,10
900140604,20,0,0,0,0,0,2,22
900140605,6,0,0,0,0,0,0,6
900140606,133,12,0,1,0,1,6,153
900140607,47,2,0,0,0,0,4,53
900140608,158,10,0,3,0,1,2,174
900140609,240,15,1,4,1,0,13,274
900140610,341,8,0,7,1,0,6,363
900140611,263,15,0,8,0,0,8,294
900140612,277,7,0,0,0,0,1,285
900140613,285,4,1,4,0,0,7,301
900140614,219,4,5,1,4,0,4,237
900140701,111,10,0,1,0,0,2,124
900140702,8,0,0,0,0,0,1,9
900140703,181,7,1,5,1,2,25,222
900140704,204,14,0,8,0,0,4,230
900140705,44,1,0,0,0,1,2,48
900140706,138,9,4,2,0,0,4,157
900140707,31,0,0,2,0,0,2,35
900140708,213,9,0,13,1,2,15,253
900140709,63,2,0,1,0,0,1,67
900140710,311,12,1,50,0,1,15,390
900140711,267,3,0,5,0,0,4,279
900140712,248,15,0,1,0,0,3,267
900140713,396,14,0,42,2,2,9,465
900140714,257,7,0,1,0,1,4,270
900140801,77,1,0,0,0,0,9,87
900140802,62,4,0,6,0,0,10,82
900140803,98,4,0,7,0,1,6,116
900140804,53,12,0,2,0,1,3,71
900140805,163,2,0,8,0,0,12,185
900140806,67,4,1,2,0,1,19,94
900140901,231,11,14,37,1,9,9,312
900140902,120,13,0,1,3,2,14,153
900140903,148,4,0,17,4,0,20,193
900140904,73,4,0,1,0,0,4,82
900140905,139,14,0,4,0,0,12,169
900140906,124,13,1,11,0,6,10,165
900141001,147,11,0,1,1,6,6,172
900141002,113,13,0,0,0,3,4,133
900141003,161,13,0,10,0,9,21,214
900141101,64,2,0,0,0,3,11,80
900141102,268,24,1,5,0,3,7,308
900141103,45,4,1,0,0,0,24,74
900141104,163,12,0,10,2,11,4,202
900141105,321,29,0,1,1,2,6,360
900141106,358,25,0,7,0,1,5,396
900141201,251,18,0,4,0,1,4,278
900141202,136,4,0,1,3,1,5,150
900141203,64,1,0,3,0,0,2,70
900141204,313,23,0,6,0,0,18,360
900141205,310,10,1,13,0,0,3,337
900141206,186,15,0,5,0,0,0,206
900141207,293,7,0,13,1,3,4,321
900141208,238,7,0,10,0,0,3,258
900141209,288,9,3,15,2,1,2,320
900141210,387,15,2,6,1,1,8,420
900141211,275,15,1,1,0,0,3,295
900141212,221,8,0,2,6,0,7,244
900141213,289,9,2,2,1,0,12,315
900141214,308,5,2,14,2,0,6,337
900141215,186,8,0,5,0,0,1,200
900141216,216,3,0,3,1,0,9,232
900141217,309,1,1,1,1,0,4,317
900141218,237,8,0,5,0,0,2,252
900141219,304,10,1,7,0,1,13,336
900141220,25,2,0,0,0,0,0,27
900141221,150,0,1,3,0,1,5,160
900141222,368,16,2,18,1,2,14,421
900141223,317,10,1,12,0,0,16,356
900141224,200,5,0,1,0,0,7,213
900141225,198,5,3,193,0,1,9,409
900141301,329,8,0,0,0,1,2,340
900141302,216,6,3,0,0,0,4,229
900141303,306,11,0,1,1,0,11,330
900141304,178,3,0,1,2,0,1,185
900141305,224,3,1,0,0,0,5,233
900141306,415,13,0,2,0,0,7,437
900141307,270,18,1,1,2,1,5,298
900141308,221,8,1,1,1,1,3,236
900141309,214,10,2,0,0,0,0,226
900141310,437,13,1,1,0,0,4,456
900141311,331,1,0,1,0,0,9,342
900141312,357,9,4,0,0,0,7,377
900141313,234,5,1,1,0,0,8,249
900141314,165,3,0,0,0,0,0,168
900141401,6,0,0,0,0,0,0,6
900141402,8,0,0,0,0,0,0,8
900141403,29,3,0,0,0,0,7,39
900141404,46,1,0,0,0,0,2,49
900141405,274,13,5,6,0,2,10,310
900141406,237,4,0,2,1,0,1,245
900141407,310,6,0,4,5,0,5,330
900141408,460,7,3,5,2,1,3,481
900141409,330,7,1,1,1,0,14,354
900141410,232,6,1,2,0,1,2,244
900141501,245,15,0,8,0,0,23,291
900141502,239,3,0,1,0,0,1,244
900141503,26,5,0,1,0,0,9,41
900141504,415,10,1,0,0,2,7,435
900141505,66,6,0,0,0,0,0,72
900141506,347,13,0,11,0,2,8,381
900141507,415,11,2,3,4,0,18,453
900141601,141,2,0,0,1,0,3,147
900141602,346,8,4,1,0,3,5,367
900141603,212,20,3,2,0,0,4,241
900141604,171,11,1,3,0,1,7,194
900141605,264,11,1,1,0,0,3,280
900141606,184,7,2,2,2,0,2,199
900141607,246,16,0,3,0,0,4,269
900141608,241,7,1,0,2,1,1,253
900141609,215,9,0,2,6,1,7,240
900141610,181,15,1,3,2,3,11,216
900141611,213,15,6,4,3,1,4,246
900141612,188,0,1,4,2,1,3,199
900141613,365,6,3,3,2,0,6,385
900141614,259,11,0,0,0,0,2,272
900141615,294,15,0,0,0,0,6,315
900141616,481,30,1,9,1,0,5,527
900141617,230,7,1,3,0,0,5,246
900141618,313,0,1,16,0,0,11,341
900210101,2,0,0,0,0,0,8,10
900210102,99,6,3,0,0,2,19,129
900210103,0,0,0,0,0,0,2,2
900210104,291,6,1,8,0,3,13,322
900210105,133,0,0,1,1,6,20,161
900210106,127,1,0,0,0,1,2,131
900210107,61,0,0,0,0,0,2,63
900210108,172,11,0,1,0,0,1,185
900210109,202,19,0,8,1,2,5,237
900210110,161,18,1,9,1,2,11,203
900210111,110,4,0,0,0,1,3,118
900210201,62,16,0,0,0,0,11,89
900210202,71,11,0,0,0,0,6,88
900210203,107,6,0,4,0,0,8,125
900210204,179,10,1,5,0,0,13,208
900210205,444,20,3,25,3,2,35,532
900210206,177,14,0,7,1,0,16,215
900210207,161,15,2,6,0,0,10,194
900210208,125,8,1,3,0,3,11,151
900210209,140,7,0,0,0,0,7,154
900210301,116,2,1,1,0,6,9,135
900210302,124,4,0,0,0,0,9,137
900210303,138,4,0,3,0,2,10,157
900210304,120,0,0,0,0,0,16,136
900210401,107,0,1,2,0,1,13,124
900210402,48,2,0,0,0,0,1,51
900210403,126,2,0,0,0,0,12,140
900210404,63,3,1,4,0,0,3,74
900210405,22,2,0,0,0,2,2,28
900210406,170,8,0,1,0,0,7,186
900210407,265,18,2,4,1,1,6,297
900210408,197,2,1,4,0,7,33,244
900210409,313,10,4,1,0,0,15,343
900210410,230,21,1,2,0,0,6,260
900210411,261,19,0,5,0,2,11,298
900210501,139,1,2,0,0,0,3,145
900210502,283,25,0,3,0,1,6,318
900210503,187,1,0,5,1,9,30,233
900210504,145,10,0,0,0,0,7,162
900210505,21,0,0,0,0,0,7,28
900210506,198,10,0,6,1,0,5,220
900210507,327,18,1,3,0,0,3,352
900210601,26,1,0,0,0,0,0,27
900210602,426,2,1,13,1,2,6,451
900210603,296,7,1,10,1,0,1,316
900210604,353,14,11,4,0,0,10,392
900210605,318,10,0,0,0,0,5,333
900210606,275,12,0,0,0,0,2,289
900210607,283,0,0,0,0,0,16,299
900210608,365,12,9,6,5,1,13,411
900210609,161,5,1,1,0,1,3,172
900210610,357,12,5,3,0,0,11,388
900210611,305,27,7,8,12,0,13,372
900210612,280,22,7,2,0,0,4,315
900210613,204,23,0,0,0,0,2,229
900210614,341,18,1,7,0,2,7,376
900210615,226,16,3,1,1,1,3,251
900210616,259,20,1,1,0,0,2,283
900210617,149,5,0,12,0,0,10,176
900210618,245,7,2,4,2,1,5,266
900210619,197,3,1,2,1,0,7,211
900210620,165,0,4,24,0,8,15,216
900210701,416,28,1,7,0,3,17,472
900210702,312,24,2,5,0,0,5,348
900210703,194,4,5,1,1,0,5,210
900210704,171,9,3,2,0,0,6,191
900210705,177,11,0,4,1,0,7,200
900210706,352,20,5,5,2,0,22,406
900210707,276,26,3,2,7,0,12,326
900210708,180,17,1,3,7,1,11,220
900210709,247,6,3,1,0,0,5,262
900210710,332,17,1,5,1,1,5,362
900210711,143,13,4,4,4,0,10,178
900210712,197,23,8,5,10,0,10,253
900210713,170,12,5,3,0,1,6,197
900210714,226,10,3,0,0,0,5,244
900210715,252,10,1,3,0,0,2,268
900210716,253,3,2,4,0,0,1,263
900210717,271,7,1,0,0,0,7,286
900210718,210,7,0,2,0,1,19,239
900210719,402,8,2,4,0,0,3,419
900210720,280,7,1,4,1,0,3,296
900210721,215,4,0,0,0,0,3,222
900210722,269,14,4,4,0,0,5,296
900210723,214,7,0,3,0,0,5,229
900210724,282,20,4,17,0,0,13,336
900210725,379,34,1,16,0,1,14,445
900210726,273,3,0,0,0,0,3,279
900280101,328,14,0,7,2,1,8,360
900280102,321,21,0,1,0,1,8,352
900280103,336,28,3,7,3,0,4,381
900280104,287,12,2,2,0,0,12,315
900280105,268,19,4,2,1,1,3,298
900280106,216,18,2,11,12,5,1,265
900280107,233,14,2,3,1,1,4,258
900280108,309,14,2,1,0,0,9,335
900280109,196,12,1,1,10,0,5,225
900280110,194,8,2,1,4,0,5,214
900280111,313,18,3,5,5,0,2,346
900280112,378,3,0,4,0,3,12,400
900280113,249,8,2,11,1,0,4,275
900280201,10,0,0,0,0,0,0,10
900280202,44,8,0,0,0,0,0,52
900280203,58,3,0,0,0,0,5,66
900280204,43,19,0,0,0,0,2,64
900280205,108,4,2,3,0,1,3,121
900280206,488,30,1,12,0,0,9,540
900280207,231,6,1,1,0,0,3,242
900280208,195,0,1,3,0,0,0,199
900280301,5,0,0,0,0,0,0,5
900280302,72,39,0,1,3,4,3,122
900280303,26,1,0,0,0,0,5,32
900280304,101,3,0,0,1,0,10,115
900280305,219,12,4,7,0,0,4,246
900280306,146,12,0,1,0,0,9,168
900280307,236,17,0,3,0,0,7,263
900280308,8,0,0,0,0,0,16,24
900280309,70,7,0,0,0,1,10,88
900280310,90,8,0,1,1,1,12,113
900280311,54,1,0,0,0,0,0,55
900280312,106,6,0,0,0,0,1,113
900280313,2,0,0,0,1,0,2,5
900280314,20,0,0,0,0,2,1,23
900280315,3,0,0,0,0,25,15,43
900280316,207,3,0,6,0,4,11,231
900280317,264,11,1,1,0,0,5,282
900280318,339,5,0,5,0,5,14,368
900280319,288,14,0,0,1,0,5,308
900280320,190,10,0,0,0,0,2,202
900350101,226,5,1,9,1,1,4,247
900350102,33,3,0,0,0,0,1,37
900350103,32,1,0,0,0,0,4,37
900350104,8,4,0,0,0,1,5,18
900350105,21,0,0,0,0,0,10,31
900350106,39,1,0,0,0,0,3,43
900350107,23,4,0,0,0,0,3,30
900350108,11,2,0,0,0,0,0,13
900350109,40,8,0,0,0,0,2,50
900350110,64,1,0,0,0,1,1,67
900350111,144,1,0,1,0,2,5,153
900350112,149,16,0,4,0,2,5,176
900350113,319,11,2,9,1,9,31,382
900350114,276,42,3,14,2,4,50,391
900350201,24,0,0,0,0,0,0,24
900350202,20,2,0,0,0,0,0,22
900350203,10,0,0,1,0,1,1,13
900350204,40,1,0,0,0,0,0,41
900350205,78,9,0,0,0,10,4,101
900350206,78,6,2,0,0,2,7,95
900350207,71,4,0,2,0,0,0,77
900350208,47,2,0,0,0,0,4,53
900350209,37,4,2,0,0,0,6,49
900350210,5,0,0,0,0,0,0,5
900350211,6,0,0,0,0,1,4,11
900350212,223,9,7,3,0,5,26,273
900350213,343,48,3,8,3,3,21,429
900350214,182,3,1,5,3,1,28,223
900350301,79,6,0,0,0,0,6,91
900350302,39,2,0,0,0,0,0,41
900350303,31,2,0,0,0,1,8,42
900350304,40,9,0,0,0,0,0,49
900350305,52,1,0,0,0,0,2,55
900350306,12,2,0,1,0,0,0,15
900350307,49,2,0,0,0,0,9,60
900350308,12,1,0,0,0,0,5,18
900350309,22,0,0,0,0,0,4,26
900350310,94,23,1,2,0,1,3,124
900350311,46,7,0,1,0,0,2,56
900350312,342,58,5,6,1,8,55,475
900420101,296,14,1,2,7,1,14,335
900420102,332,12,2,9,0,0,13,368
900420103,165,4,0,2,0,1,7,179
900420104,169,22,2,1,12,0,21,227
900420105,229,11,0,5,1,0,2,248
900420106,230,16,1,1,0,1,2,251
900420107,311,29,7,3,3,2,8,363
900420108,320,19,1,6,0,1,8,355
900420109,131,19,5,1,1,0,3,160
900420110,180,11,2,1,0,2,1,197
900420111,134,5,0,13,1,1,6,160
900420112,206,21,1,4,0,0,4,236
900420113,263,25,1,3,0,0,7,299
900420114,283,13,3,2,0,1,2,304
900420115,265,0,9,0,0,0,2,276
900420116,210,7,0,10,0,0,10,237
900420201,140,0,0,0,0,2,17,159
900420202,56,0,0,0,0,0,8,64
900420203,46,0,0,0,0,0,0,46
900420204,48,5,0,0,0,0,2,55
900420205,60,5,0,3,0,0,0,68
900420206,44,1,0,0,1,0,7,53
900420207,56,0,0,0,0,0,8,64
900420208,166,6,0,6,1,7,26,212
900420209,270,10,0,3,1,5,11,300
900420210,133,2,0,3,0,2,1,141
900420211,287,30,0,4,1,3,10,335
900420212,486,47,2,11,1,3,42,592
900420213,107,11,0,1,0,0,11,130
900420214,231,7,0,0,1,0,27,266
900420215,135,21,0,45,0,1,4,206
900420216,146,7,0,1,0,0,3,157
900420217,147,4,0,0,0,0,1,152
900420301,47,1,0,0,0,0,8,56
900420302,198,5,0,7,0,3,14,227
900420303,72,8,0,0,0,0,18,98
900420304,67,1,0,1,0,0,4,73
900420305,91,4,0,7,0,0,3,105
900420306,274,14,1,7,0,0,13,309
900420401,20,3,0,0,0,0,9,32
900420402,97,56,0,0,0,4,9,166
900490101,134,11,0,2,1,0,20,168
900490102,158,6,2,13,1,1,12,193
900490201,146,4,0,0,0,2,15,167
900490202,17,0,0,0,0,0,1,18
900490203,278,7,0,3,2,1,21,312
900490204,352,18,0,4,0,1,29,404
900490205,66,5,0,0,0,0,25,96
900490301,208,18,1,3,1,0,22,253
900490302,79,6,0,2,0,0,12,99
900490401,117,8,1,9,0,3,29,167
900490402,153,11,0,3,0,4,17,188
900490403,129,14,1,7,0,1,11,163
900490404,26,5,0,2,0,0,0,33
900490501,217,29,1,6,0,0,5,258
900490502,107,6,0,8,1,0,5,127
900490503,10,9,0,0,0,0,7,26
900490504,30,2,0,0,0,2,3,37
900490505,8,0,0,0,0,0,2,10
900490506,72,6,0,2,0,0,4,84
900490507,40,2,0,2,0,0,1,45
900490508,196,5,1,4,0,1,7,214
900490509,365,13,1,12,3,3,10,407
900490510,301,18,2,8,8,1,10,348
900490511,312,25,8,10,4,2,5,366
900490512,202,11,2,14,2,0,7,238
900490601,2,0,0,0,0,0,3,5
900490602,146,14,0,1,0,7,13,181
900490603,54,1,0,0,1,1,2,59
900490701,1,0,0,0,0,0,0,1
900490702,121,15,0,21,3,0,18,178
900490703,142,27,0,2,2,6,19,198
900560101,27,2,0,0,0,1,9,39
900560102,32,10,0,0,0,0,0,42
900560103,252,12,0,2,0,2,9,277
900560201,47,0,0,1,0,1,11,60
900560202,1,0,0,0,0,0,2,3
900560203,173,41,0,3,0,3,11,231
900560301,235,15,2,0,0,1,6,259
900560302,298,15,3,0,1,0,7,324
900560303,207,13,1,3,0,0,4,228
900560304,155,7,0,3,0,1,0,166
900560305,354,10,0,4,1,0,8,377
900560306,330,15,1,4,1,1,8,360
900560307,204,16,0,1,0,0,1,222
900560308,296,12,2,6,0,1,8,325
900560309,270,28,0,5,4,0,8,315
900560310,296,15,1,4,1,1,2,320
900560311,405,16,5,5,2,2,11,446
900560312,355,15,0,12,0,0,14,396
900560401,98,4,3,2,1,0,7,115
900560402,217,16,12,15,2,1,41,304
900560403,108,2,2,3,0,0,6,121
900560404,34,10,0,0,0,0,2,46
900560405,27,3,2,3,0,0,15,50
900560406,68,1,0,7,0,1,21,98
900560407,23,2,0,4,0,0,4,33
900560408,150,5,1,5,1,1,5,168
900560501,72,0,0,4,0,3,22,101
900560502,236,15,1,8,2,4,16,282
900560503,114,1,0,3,0,1,2,121
900560504,195,4,0,10,2,1,6,218
900560505,80,7,0,1,1,1,2,92
900560601,43,5,0,0,0,1,2,51
900560602,137,18,1,5,0,1,11,173
900560603,180,24,0,2,0,0,4,210
900560604,35,2,0,0,0,0,44,81
900560605,45,4,0,0,0,1,4,54
900560606,100,1,0,2,0,3,10,116
900560607,62,1,0,4,0,3,20,90
900560701,100,2,0,2,1,2,0,107
900560702,306,19,1,9,5,3,11,354
900560703,36,0,0,2,0,3,8,49
900560704,141,4,0,0,0,2,6,153
900560705,87,5,0,1,0,1,5,99
900560706,102,1,0,3,0,2,16,124
900560801,56,1,0,6,0,2,3,68
900560802,33,0,0,3,0,0,3,39
900560803,117,13,0,1,0,1,6,138
900560804,100,5,0,2,0,0,9,116
900560805,198,17,0,3,0,0,10,228
900560901,70,18,0,1,0,1,1,91
900560902,4,0,0,0,0,5,0,9
900560903,124,22,0,2,0,4,18,170
900560904,140,3,1,1,0,4,6,155
900560905,23,2,0,0,0,0,1,26
900560906,56,4,0,0,0,0,0,60
900560907,108,4,0,3,0,3,17,135
900560908,105,1,0,0,0,0,1,107
900560909,48,1,0,1,0,1,4,55
900560910,25,0,0,0,0,0,5,30
900560911,42,5,0,0,0,0,3,50
900561001,143,7,0,1,0,0,6,157
900561002,16,0,0,0,0,0,7,23
900561003,181,27,0,7,0,0,5,220
900561004,106,11,0,10,0,2,5,134
900561005,107,1,2,4,0,1,13,128
900561101,5,0,0,0,1,12,1,19
900561102,9,0,0,0,0,0,13,22
900561103,33,0,0,0,0,4,16,53
900561104,95,1,0,0,0,1,4,101
900561105,88,11,0,2,0,0,9,110
900561106,67,0,0,0,0,0,6,73
900561107,211,10,0,0,0,1,4,226
900561108,283,15,0,7,6,4,12,327
900561201,83,13,0,0,0,0,3,99
900561202,80,5,0,2,0,2,14,103
900561203,184,13,1,3,2,0,11,214
900561204,165,10,0,7,0,1,14,197
900561205,123,10,0,1,0,1,4,139
900561206,124,9,0,0,0,0,4,137
900561207,149,7,0,5,0,0,17,178
900561208,33,2,0,2,0,0,0,37
900561209,87,0,1,1,0,0,3,92
900561210,29,1,0,0,0,0,16,46
900561211,116,7,1,9,2,4,5,144
900561212,92,12,0,0,0,1,3,108
900561213,284,17,0,1,1,0,3,306
900561301,136,5,0,3,0,0,12,156
900561302,87,7,0,0,0,0,8,102
900561303,41,10,0,1,0,0,2,54
900561304,201,4,0,4,0,0,12,221
900561305,277,13,2,4,0,0,8,304
900561306,30,0,1,0,0,0,4,35
900561401,72,0,0,3,0,1,3,79
900561402,82,5,0,1,0,0,7,95
900561403,149,10,1,4,4,0,13,181
900561404,335,15,3,14,2,1,26,396
900561405,107,4,0,0,0,0,4,115
900561406,218,10,0,3,1,1,6,239
900561407,286,13,1,4,1,0,3,308
900561408,231,12,1,0,0,1,9,254
900630101,216,13,0,7,3,8,10,257
900630102,302,21,3,74,0,2,29,431
900630103,223,10,1,27,0,4,7,272
900630104,321,11,4,9,0,1,4,350
900630105,360,8,0,8,0,1,25,402
900630106,258,14,1,0,2,1,3,279
900630107,152,3,0,0,0,0,4,159
900630108,355,14,0,8,2,2,5,386
900630109,245,19,0,0,1,0,13,278
900630110,347,18,6,4,6,0,9,390
900630111,365,23,3,2,1,45,9,448
900630112,255,12,1,3,5,1,4,281
900630113,272,16,0,6,0,0,9,303
900630114,301,18,0,1,0,1,16,337
900630201,37,15,0,0,0,5,11,68
900630202,56,14,0,0,0,10,7,87
900630203,14,1,0,0,0,0,0,15
900630204,29,5,0,2,0,49,6,91
900630205,17,1,0,2,0,1,0,21
900630206,194,5,0,9,4,2,17,231
900630207,97,7,0,2,0,1,1,108
900630208,5,3,0,0,0,0,0,8
900630209,15,0,0,0,0,0,0,15
900630210,26,2,0,4,0,4,12,48
900630211,27,1,0,0,0,0,0,28
900630212,320,8,3,8,0,0,13,352
900630213,243,10,0,0,0,0,9,262
900630214,169,14,2,209,0,2,5,401
900630215,291,5,0,7,2,0,4,309
900630216,250,7,2,4,0,1,2,266
900630217,261,6,0,1,0,1,3,272
900630218,265,14,2,5,0,0,5,291
900630219,229,9,0,4,0,0,1,243
900630301,288,101,0,24,0,7,20,440
900630302,430,27,0,12,0,4,22,495
900630303,134,3,1,5,1,2,1,147
900630304,35,0,0,0,0,0,3,38
900630305,483,15,3,5,3,0,5,514
900630401,8,5,0,0,0,1,0,14
900630402,18,0,0,0,0,0,0,18
900630403,136,4,1,2,2,2,8,155
900630404,289,4,0,0,0,1,6,300
900630405,51,4,0,0,0,0,6,61
900630406,78,2,0,1,0,2,4,87
900630407,25,1,0,0,0,1,3,30
900630408,127,9,0,2,0,1,9,148
900630409,1,0,0,0,0,0,1,2
900630410,56,3,0,1,0,0,10,70
900630411,122,4,0,0,0,1,3,130
900630412,131,5,1,2,0,2,5,146
900630413,375,17,0,7,0,4,21,424
900630414,194,2,0,6,0,2,7,211
900630415,202,8,1,3,0,0,3,217
900630416,67,1,3,2,0,1,170,244
900630417,194,7,0,1,2,0,9,213
900630418,239,11,1,1,2,3,3,260
900630419,317,11,5,5,0,0,2,340
900630420,202,1,2,7,1,0,20,233
900630501,290,8,2,1,1,1,6,309
900630502,196,12,2,0,0,0,3,213
900630503,364,6,3,5,0,0,4,382
900630504,271,15,1,3,2,0,5,297
900630505,300,18,2,3,0,0,11,334
900630506,312,27,2,3,0,0,1,345
900630507,334,21,0,2,2,0,13,372
900630508,231,15,1,2,1,0,4,254
900630509,403,16,0,3,1,0,9,432
900630510,345,27,1,7,0,1,5,386
900630511,267,18,2,5,0,1,8,301
900630512,282,23,2,0,0,3,2,312
900630513,293,0,1,0,0,0,12,306
900700101,105,1,1,1,0,1,5,114
900700102,108,6,0,4,0,1,5,124
900700201,22,0,0,0,1,0,11,34
900700202,69,2,0,2,0,0,1,74
900700203,106,11,0,4,0,1,12,134
900700204,211,8,0,0,2,0,16,237
900700205,343,4,3,8,2,2,26,388
900700206,303,13,0,0,0,0,39,355
900700207,179,11,0,0,0,1,5,196
900700208,213,3,2,0,1,2,14,235
900700301,272,14,3,8,0,0,33,330
900700302,35,0,0,0,0,0,2,37
900700303,32,0,0,1,0,0,8,41
900700304,31,3,0,0,0,0,0,34
900700305,47,1,0,0,0,0,2,50
900700306,187,23,2,1,0,1,23,237
900700307,242,6,1,7,6,2,14,278
900700401,66,4,0,5,0,0,18,93
900700402,81,8,0,1,0,0,4,94
900700403,294,40,10,24,2,4,44,418
900700404,179,15,1,7,0,0,8,210
900700405,117,13,0,0,0,0,4,134
900700406,169,6,1,4,2,1,8,191
900700407,64,1,0,0,0,0,6,71
900700408,48,8,0,1,0,0,0,57
900700409,205,9,0,3,0,1,17,235
900700410,45,0,1,0,0,6,2,54
900700411,71,1,0,0,0,0,5,77
900700412,262,16,1,5,1,0,42,327
900700413,312,13,0,6,1,1,8,341
900700414,213,11,0,0,0,1,3,228
900700501,131,9,0,4,0,0,7,151
900700502,158,10,0,2,0,0,9,179
900700601,3,0,0,0,0,0,0,3
900700602,278,10,0,0,0,0,13,301
900700603,201,25,2,7,6,1,15,257
900700604,229,12,1,5,0,0,0,247
900700605,186,6,1,7,1,2,10,213
900700606,233,10,1,9,3,2,9,267
900700607,245,6,0,0,0,3,4,258
900700701,85,5,0,2,0,0,6,98
900700702,46,0,0,2,0,8,3,59
900700703,3,0,0,0,0,0,0,3
900700801,34,2,0,0,0,1,22,59
900700802,9,0,0,0,0,0,1,10
900700803,59,3,0,1,0,0,11,74
900700804,146,9,0,20,0,0,19,194
900700805,165,15,3,1,4,1,6,195
900700806,215,7,0,5,1,0,7,235
900700807,427,21,1,9,3,1,12,474
900700808,163,2,0,0,0,0,4,169
900700901,0,1,0,0,0,1,3,5
900700902,64,1,0,1,0,0,8,74
900700903,280,11,0,15,0,3,13,322
900700904,62,0,0,0,0,1,3,66
900701001,3,0,0,0,0,1,22,26
900701002,84,0,1,6,0,8,5,104
900701003,69,0,0,0,0,0,2,71
900701101,73,3,1,0,1,0,0,78
900701102,105,4,0,2,0,2,7,120
900701201,3,1,0,0,0,1,1,6
900701202,65,13,0,0,0,1,1,80
900701203,112,5,0,2,1,2,9,131
900701204,178,14,0,1,0,0,11,204
900701301,332,27,2,1,0,1,6,369
900701302,126,11,0,8,0,0,16,161
900701303,208,18,0,0,0,1,3,230
900701304,328,26,0,3,1,8,12,378
900701401,173,7,0,2,0,0,11,193
900701402,211,4,0,1,0,0,9,225
900701403,164,19,2,2,4,0,8,199
900701404,210,4,2,2,1,0,8,227
900701405,309,9,1,1,0,0,4,324
900701406,296,30,0,3,0,0,4,333
900701407,175,18,3,5,1,1,15,218
900701408,158,16,1,0,1,2,5,183
900701409,386,20,6,3,1,1,12,429
900701410,295,11,2,11,0,1,6,326
900701411,210,8,4,1,12,1,13,249
900701412,212,24,1,4,0,0,2,243
900701413,155,9,2,2,3,0,5,176
900701414,216,17,2,4,4,1,4,248
900701415,337,27,5,6,7,1,10,393
900701416,238,22,4,6,5,0,12,287
900701417,392,8,11,3,1,0,10,425
900701418,340,16,0,2,0,0,11,369
900701419,294,16,3,1,1,1,9,325
900701420,274,15,5,7,0,0,2,303
900701421,181,6,1,3,1,0,2,194
900770101,318,2,1,13,3,1,3,341
900770102,289,14,0,2,0,1,7,313
900770103,291,16,1,2,1,0,13,324
900770104,405,13,1,4,0,0,6,429
900770105,384,15,0,4,0,0,25,428
900770106,310,12,4,6,1,1,4,338
900770107,230,7,1,1,2,0,5,246
900770108,232,23,2,3,4,1,11,276
900770109,245,22,10,1,2,0,3,283
900770110,308,28,7,4,6,2,20,375
900770111,232,10,1,3,0,0,7,253
900770112,215,6,3,0,2,0,2,228
900770113,222,24,1,3,0,1,2,253
900770114,153,6,0,0,1,1,5,166
900770115,342,14,1,4,0,0,3,364
900770116,288,14,0,5,0,0,8,315
900770117,269,7,4,1,1,1,23,306
900770118,169,8,3,4,1,0,4,189
900770119,244,13,1,7,0,0,13,278
900770120,276,1,1,6,1,1,6,292
900770121,289,13,3,1,0,0,10,316
900770122,222,3,0,3,1,0,8,237
900770123,215,11,2,0,1,0,2,231
900770124,234,21,7,0,0,0,0,262
900770201,61,0,0,0,0,0,0,61
900770202,243,14,2,3,0,2,6,270
900770203,207,16,1,14,0,0,7,245
900770204,66,3,0,0,0,0,5,74
900770205,10,0,0,3,0,0,12,25
900770206,50,1,0,1,0,0,2,54
900770207,54,1,0,0,0,0,0,55
900770208,5,1,0,0,0,0,0,6
900770209,282,11,1,3,2,0,12,311
900770210,349,19,0,8,0,2,8,386
900770211,250,13,1,8,0,1,11,284
900770212,122,8,0,0,0,0,27,157
900770213,265,21,1,2,1,0,5,295
900770214,138,18,1,10,0,1,4,172
900770301,96,31,0,1,0,0,6,134
900770302,141,25,0,1,0,1,10,178
900770401,2,0,0,0,0,0,0,2
900770402,8,1,0,0,0,0,1,10
900770403,202,8,0,6,0,0,3,219
900770404,231,9,0,4,0,3,28,275
900770405,198,29,0,7,0,0,16,250
900770406,143,4,0,2,0,0,5,154
900770407,229,19,2,6,3,0,5,264
900770408,68,3,0,1,0,2,6,80
900770409,89,26,0,0,0,0,5,120
900770410,83,4,0,1,0,0,2,90
900770411,119,9,0,4,0,0,7,139
900770412,73,0,0,0,0,0,5,78
900770413,155,10,0,1,1,1,10,178
900770414,352,12,0,0,3,0,14,381
900770415,242,16,1,2,4,0,3,268
900770416,126,2,3,2,2,0,8,143
900770417,281,15,0,4,7,1,6,314
900770418,149,5,3,18,1,0,1,177
900770419,155,0,0,6,0,0,1,162
900770501,161,4,1,16,0,3,16,201
900770601,201,4,0,8,0,1,8,222
900770602,194,15,0,4,0,1,9,223
900770603,53,0,0,1,0,1,2,57
900770604,54,7,0,0,0,0,7,68
900770605,177,4,0,2,1,0,8,192
900770606,320,8,1,5,0,3,19,356
900770607,311,25,1,9,3,0,11,360
900840101,176,7,0,1,0,0,6,190
900840102,198,5,0,2,0,1,2,208
900840103,342,34,0,5,1,1,15,398
900840104,336,23,11,0,0,0,5,375
900840105,307,19,1,1,0,0,4,332
900840106,383,12,2,5,0,1,10,413
900840107,352,22,2,0,0,0,9,385
900840108,315,54,21,144,3,4,62,603
900840109,220,11,1,0,1,0,7,240
900840110,262,15,5,4,0,1,3,290
900840111,244,18,2,0,0,0,3,267
900840112,321,16,2,4,2,1,3,349
900840113,376,25,2,3,1,1,9,417
900840114,283,5,0,0,1,1,6,296
900840115,258,5,2,0,0,1,9,275
900840116,225,8,0,4,5,1,3,246
900840117,157,3,0,0,0,0,3,163
900840118,161,11,2,1,1,0,6,182
900840119,189,18,5,2,3,0,2,219
900840120,212,11,3,0,0,0,4,230
900840121,186,26,8,0,2,0,7,229
900840122,196,9,3,6,0,0,9,223
900840123,378,17,6,5,4,1,5,416
900840124,336,15,3,10,1,2,4,371
900840125,264,22,7,20,1,0,4,318
900840126,330,36,17,15,1,1,8,408
900840201,139,16,0,0,0,0,0,155
900840202,277,5,1,0,0,0,7,290
900840203,258,6,0,0,0,0,3,267
900840204,174,1,0,0,0,0,3,178
900840205,428,21,0,2,2,2,9,464
900840206,254,12,1,0,1,0,2,270
900840207,172,19,1,5,0,0,1,198
900840208,348,13,8,4,0,0,4,377
900840209,254,11,3,2,1,0,2,273
900840210,302,8,2,0,1,0,12,325
900840211,181,9,3,1,1,0,1,196
900840212,371,20,12,6,3,0,4,416
900840213,191,18,1,1,0,3,18,232
900840214,219,12,3,1,0,3,5,243
900840215,191,10,4,1,1,1,3,211
900840216,188,9,4,2,2,1,5,211
900840217,217,23,1,0,2,0,6,249
900840218,224,20,19,1,1,0,2,267
900840219,271,11,10,0,4,5,28,329
900840220,202,26,3,2,0,2,1,236
900840221,372,11,1,5,0,0,12,401
900840222,271,3,1,0,1,0,3,279
900840223,185,9,1,0,0,2,9,206
900840301,391,7,2,3,0,0,8,411
900840302,344,20,1,2,0,0,5,372
900840303,332,11,2,1,2,1,13,362
900840304,290,10,1,5,1,0,3,310
900840305,241,11,0,2,0,0,1,255
900840306,314,7,4,2,1,0,7,335
900840307,277,15,6,3,2,0,5,308
900840308,254,16,4,3,0,0,11,288
900840309,189,5,0,2,0,1,4,201
900840310,265,10,1,0,0,0,7,283
900840311,163,4,1,2,3,0,5,178
900840312,162,2,2,5,1,0,1,173
900840313,249,14,6,2,0,0,8,279
900840314,140,9,0,2,5,4,5,165
900840315,155,6,7,4,6,1,12,191
900840401,355,16,0,0,5,1,2,379
900840402,322,13,7,11,0,0,7,360
900840403,269,9,0,1,2,0,8,289
900840404,301,11,4,4,2,0,5,327
900840405,271,12,3,2,0,0,6,294
900840406,264,6,6,4,4,0,1,285
900840407,239,6,0,3,0,0,4,252
900840408,88,1,0,0,0,0,0,89
900840409,181,2,0,0,0,0,0,183
900840410,221,4,0,0,0,0,1,226
900840411,179,6,0,3,0,0,2,190
900840412,193,11,3,0,0,5,9,221
900840413,234,7,0,1,0,0,7,249
900840414,185,5,0,3,2,0,3,198
900840415,387,9,0,0,0,0,0,396
900840416,342,12,0,2,0,0,10,366
900840501,306,18,8,2,2,0,7,343
900840502,201,8,2,6,1,0,18,236
900840503,262,23,4,0,3,1,9,302
900840504,148,5,1,9,3,0,11,177
900840505,184,12,2,3,1,0,2,204
900840506,285,12,3,4,0,0,6,310
900840507,198,6,1,0,0,0,2,207
900840508,139,3,0,2,1,0,2,147
900840509,161,10,4,2,7,0,21,205
900840510,160,5,3,2,1,0,9,180
900840511,150,10,3,1,1,0,12,177
900840512,204,10,15,2,10,1,9,251
900840513,263,19,5,8,11,1,26,333
900840601,118,4,1,1,0,0,2,126
900840602,293,6,5,15,3,1,11,334
900840603,198,6,5,1,2,0,4,216
900840604,270,10,3,9,0,0,5,297
900840605,328,11,0,2,1,1,14,357
900840606,214,7,2,3,1,0,7,234
900840607,230,8,1,0,0,2,6,247
900840608,224,17,4,0,1,1,6,253
900840609,187,2,3,2,4,1,3,202
900840610,195,10,4,1,1,0,3,214
900840611,184,21,5,1,8,2,8,229
900840612,106,3,4,3,1,2,6,125
900840613,149,7,1,2,0,0,13,172
900840614,156,5,13,0,1,2,5,182
900840701,265,14,0,4,3,0,7,293
900840702,138,8,1,1,1,1,3,153
900840703,247,8,1,0,0,0,8,264
900840704,332,37,6,0,1,1,7,384
900840705,238,14,4,0,8,1,4,269
900840706,297,23,8,3,3,0,8,342
900840707,279,12,2,3,8,0,5,309
900840708,332,32,3,1,3,2,17,390
900840709,259,18,10,2,5,0,10,304
900840710,176,14,4,1,1,0,25,221
900840711,194,5,3,1,6,0,9,218
900840712,277,17,11,1,8,0,27,341
900840713,163,20,1,2,0,0,7,193
900840714,189,17,5,4,13,2,20,250
900840801,165,2,0,1,0,0,7,175
900840802,172,5,1,0,1,0,8,187
900840803,313,5,6,10,1,0,6,341
900840804,221,4,0,2,0,0,10,237
900840805,412,2,0,0,0,0,1,415
900840806,240,0,4,5,1,0,3,253
900840807,245,5,4,4,17,1,3,279
900840808,268,2,1,9,4,0,6,290
900840809,190,4,1,3,0,0,4,202
900840810,238,3,11,2,1,3,6,264
900840811,288,1,2,0,2,0,16,309
900840812,281,4,2,3,2,1,12,305
900840813,224,2,2,3,1,0,3,235
900840814,459,3,0,1,0,0,10,473
900840815,209,2,0,2,0,0,1,214
900840816,259,4,5,5,8,0,6,287
900840817,161,6,1,2,1,0,2,173
900840818,168,13,0,2,2,0,12,197
900840819,274,8,2,3,0,1,8,296
900840820,240,9,0,2,0,0,11,262
900840901,157,5,0,1,1,1,1,166
900840902,265,25,3,1,5,0,24,323
900840903,212,11,5,1,2,0,13,244
900840904,170,6,2,2,0,0,7,187
900840905,229,20,10,0,2,1,13,275
900840906,154,15,2,1,7,0,2,181
900840907,148,11,2,0,1,1,6,169
900840908,186,8,3,2,1,0,7,207
900840909,142,8,1,0,0,0,34,185
900840910,177,14,12,1,3,0,7,214
900840911,252,15,16,3,18,1,20,325
900840912,141,10,10,0,1,0,8,170
900840913,145,24,3,0,3,1,30,206
900840914,226,27,4,2,12,2,22,295
900840915,271,46,9,0,3,1,9,339
900841001,280,0,10,1,1,0,12,304
900841002,414,2,1,6,0,1,17,441
900841003,221,3,2,3,0,0,6,235
900841004,351,2,0,0,0,0,7,360
900841005,303,7,0,1,0,0,17,328
900841006,250,0,1,0,0,0,7,258
900841007,154,0,0,0,0,0,1,155
900841008,314,0,0,2,1,0,6,323
900841009,256,5,1,2,0,0,3,267
900841010,406,8,4,14,0,0,24,456
900841011,345,11,2,0,0,1,7,366
900841012,217,13,11,1,0,3,4,249
900841013,201,12,3,3,2,0,4,225
900841014,176,5,1,1,0,0,5,188
900841015,143,6,0,1,2,0,3,155
900841016,241,9,16,0,0,1,28,295
900841017,187,7,0,14,1,0,11,220
900841018,246,8,0,1,0,0,2,257
900841019,152,9,3,2,0,0,3,169
900841020,289,18,4,6,1,1,5,324
900841021,93,11,2,0,0,0,8,114
900841022,238,4,11,1,2,0,2,258
900841023,355,32,11,3,3,2,5,411
900841024,282,19,0,3,6,0,5,315
900841025,78,0,0,0,0,0,0,78
900841101,219,28,26,5,8,11,18,315
900841102,278,67,31,3,9,3,14,405
900841103,202,43,34,6,15,0,16,316
900841104,182,42,8,2,9,1,20,264
900841105,242,6,6,3,0,1,2,260
900841106,285,1,0,0,1,0,4,291
900841107,268,3,0,1,0,0,6,278
900841108,251,15,0,3,0,0,5,274
900841109,283,9,2,5,0,0,1,300
900841110,211,16,1,0,1,0,2,231
900841111,273,17,5,2,2,0,6,305
900841112,242,34,24,0,0,0,5,305
900841113,204,14,1,0,1,0,7,227
900841201,260,27,26,9,12,1,27,362
900841202,265,44,39,1,17,11,29,406
900841203,289,80,27,1,20,2,18,437
900841204,249,39,26,0,14,0,6,334
900841205,187,40,77,9,9,1,7,330
900841206,151,29,23,1,6,0,1,211
900841207,249,30,20,10,4,0,19,332
900841208,323,63,52,1,5,3,44,491
900841209,328,76,19,0,15,5,31,474
900841210,288,91,12,7,11,1,12,422
900841211,261,74,29,6,15,4,10,399
900841212,335,84,33,2,11,7,15,487
900841213,215,70,13,1,8,2,18,327
900841214,263,58,11,3,6,1,7,349
900841215,163,57,1,1,1,0,14,237
900841216,394,81,14,4,11,2,17,523
900841217,227,57,11,2,16,1,7,321
900841218,196,58,20,2,12,1,19,308
900841219,368,98,26,0,29,1,15,537
900841220,293,77,42,2,10,16,22,462
900841221,286,95,11,0,6,0,6,404
900841222,161,30,13,0,7,1,7,219
900841223,234,80,7,0,3,1,26,351
900841224,102,25,1,3,0,0,6,137
900841225,280,133,26,1,7,2,9,458
900841226,294,58,35,20,27,7,39,480
900841301,200,12,11,4,11,1,10,249
900841302,229,15,49,4,5,1,15,318
900841303,161,52,8,3,18,0,10,252
900841304,218,42,49,1,8,3,10,331
900841305,270,63,16,4,20,2,16,391
900841306,315,91,63,2,26,1,14,512
900841307,117,32,9,1,11,0,5,175
900841308,224,32,7,2,24,2,23,314
900841309,310,83,41,0,39,0,29,502
900841310,253,49,15,0,23,2,11,353
900841311,142,39,20,2,16,1,2,222
900841312,327,63,27,0,31,0,19,467
900841313,104,50,20,0,26,0,21,221
900841314,220,36,34,1,21,2,7,321
900841315,165,47,31,1,47,2,7,300
900841316,199,30,11,0,1,0,9,250
900841317,228,39,78,3,49,0,15,412
900841318,291,41,7,1,20,2,19,381
900841401,276,12,14,3,2,0,12,319
900841402,233,26,15,0,10,2,3,289
900841403,160,12,6,2,0,0,4,184
900841404,316,39,7,4,6,3,13,388
900841405,301,24,9,1,12,0,12,359
900841406,276,17,7,2,1,0,12,315
900841407,292,37,23,10,18,2,18,400
900841408,221,26,10,1,3,2,17,280
900841409,190,20,40,1,3,0,6,260
900841410,212,20,1,4,6,0,7,250
900841411,240,20,2,5,2,0,13,282
900841412,291,32,7,4,5,3,24,366
900841413,244,13,0,0,3,0,10,270
900841414,235,25,3,1,1,0,1,266
900841501,224,12,2,0,0,0,4,242
900841502,334,15,12,6,5,3,14,389
900841503,212,15,7,2,4,0,2,242
900841504,325,37,8,2,7,3,17,399
900841505,301,32,8,3,10,0,22,376
900841506,309,18,3,5,2,0,5,342
900841507,127,19,8,1,6,0,5,166
900841508,147,9,7,6,14,0,15,198
900841509,351,21,16,7,16,2,10,423
900841510,233,19,8,4,4,1,12,281
900841511,161,11,7,3,3,0,3,188
900841512,156,15,114,3,2,0,4,294
900841513,186,13,8,2,4,1,15,229
900841601,284,23,9,1,8,1,11,337
900841602,242,18,5,4,6,0,11,286
900841603,292,26,14,5,1,1,5,344
900841604,431,22,8,1,1,2,9,474
900841605,283,22,7,6,0,1,5,324
900841606,208,9,15,4,1,0,9,246
900841607,371,27,8,3,3,1,5,418
900841608,314,19,15,0,0,0,16,364
900841609,238,9,6,1,6,1,9,270
900841610,206,22,8,2,2,0,8,248
900841611,293,16,5,10,4,0,9,337
900841612,192,12,0,5,1,0,6,216
900841613,176,26,3,6,0,3,2,216
900841614,246,23,4,3,1,0,3,280
900841615,357,32,6,1,0,0,1,397
900841616,249,33,25,15,2,6,11,341
900841617,245,9,8,0,0,0,0,262
900841618,273,22,1,3,0,0,10,309
900841619,237,1,1,3,0,0,7,249
900841620,294,4,4,3,3,2,9,319
900841621,238,21,1,4,3,1,6,274
900841622,136,8,0,2,0,0,8,154
900841701,254,14,14,1,0,2,4,289
900841702,322,15,7,1,1,0,12,358
900841703,255,11,9,2,0,0,6,283
900841704,287,22,15,3,9,0,5,341
900841705,236,11,5,1,3,0,7,263
900841706,230,4,4,1,0,0,13,252
900841707,144,9,1,0,1,0,9,164
900841708,332,22,2,2,3,0,13,374
900841709,293,18,1,1,10,0,3,326
900841710,108,4,1,1,1,0,6,121
900841711,188,6,1,0,3,0,4,202
900841712,250,10,1,2,0,0,3,266
900841801,420,72,37,8,6,0,22,565
900841802,276,26,21,35,12,0,13,383
900841803,131,4,2,1,0,1,13,152
900841804,127,38,3,2,7,0,10,187
900841805,304,47,17,0,4,9,18,399
900841806,320,28,15,2,5,0,27,397
900841807,277,29,27,2,3,0,10,348
900841808,363,51,23,2,12,0,17,468
900841809,272,31,8,3,13,0,16,343
900841810,167,6,4,2,0,0,12,191
900841811,253,11,6,0,0,0,21,291
900841812,257,61,28,2,3,3,9,363
900841901,227,65,16,4,31,0,14,357
900841902,280,48,15,4,21,1,23,392
900841903,273,122,29,3,9,0,11,447
900841904,157,31,22,3,6,5,14,238
900841905,171,42,16,3,0,1,13,246
900841906,142,8,2,2,0,0,19,173
900841907,261,53,10,2,19,3,11,359
900841908,183,30,7,2,3,0,12,237
900841909,341,106,31,0,4,2,10,494
900841910,237,85,25,6,2,0,18,373
900841911,348,95,20,1,9,0,16,489
900841912,195,39,21,5,6,0,7,273
900841913,179,36,18,2,4,1,5,245
900841914,184,27,4,3,7,1,15,241
900841915,154,13,2,1,3,0,4,177
900841916,277,76,27,0,5,0,7,392
900841917,159,39,10,1,5,4,4,222
900841918,171,13,2,0,13,6,15,220
900841919,334,54,19,0,12,0,16,435
900842001,183,42,24,0,8,0,8,265
900842002,205,43,18,0,42,6,13,327
900842003,177,21,68,0,17,3,15,301
900842004,134,46,30,0,49,0,7,266
900842005,196,47,13,1,13,6,5,281
900842006,174,36,11,1,49,0,35,306
900842007,321,97,49,0,24,1,18,510
900842008,203,55,6,0,18,1,11,294
900842009,232,51,27,5,25,0,7,347
900842010,236,65,11,1,6,0,12,331
900842011,160,25,18,5,12,1,21,242
900842012,265,53,30,3,35,0,19,405
900842013,197,81,7,1,61,1,5,353
900842014,181,49,7,4,59,0,34,334
900842015,282,62,47,1,9,4,26,431
900842016,231,51,27,1,31,1,13,355
900842017,225,81,36,0,85,0,8,435
900842018,357,78,60,3,13,8,19,538
900842019,270,57,26,6,16,0,14,389
900842101,156,28,8,0,2,0,15,209
900842102,317,126,24,1,14,2,28,512
900842103,156,41,16,3,17,0,5,238
900842104,211,69,9,12,13,0,28,342
900842105,130,13,14,3,22,0,12,194
900842106,255,18,4,4,4,0,19,304
900842107,333,64,51,7,11,0,17,483
900842108,206,0,5,0,1,0,108,320
900842109,211,32,23,1,5,2,10,284
900842110,256,21,3,0,1,0,12,293
900842111,165,0,0,1,0,0,0,166
900842112,209,14,3,0,0,0,10,236
900842113,295,25,0,4,0,0,1,325
900842114,412,12,1,1,2,0,8,436
900842115,195,4,4,5,1,1,7,217
900842116,118,19,0,1,0,0,0,138
900842117,142,3,0,0,0,0,0,145
900842118,158,1,0,0,3,0,0,162
900842119,334,4,0,1,0,0,7,346
900842120,232,78,18,4,10,0,20,362
900842121,191,30,37,9,10,0,32,309
900842122,153,24,6,3,8,1,8,203
900842123,0,0,0,0,0,0,0,0
900842201,337,5,1,4,0,1,5,353
900842202,299,5,0,0,0,0,5,309
900842203,188,3,2,1,3,0,7,204
900842204,193,2,0,1,0,0,2,198
900842205,209,6,0,1,1,1,7,225
900842206,280,4,3,2,1,0,4,294
900842207,411,13,2,8,2,0,4,440
900842208,244,10,0,0,0,0,3,257
900842209,209,11,2,1,3,1,9,236
900842210,228,6,0,2,0,0,11,247
900842211,193,10,0,0,0,0,9,212
900842212,164,1,0,1,0,0,2,168
900842213,255,9,2,1,0,0,3,270
900842214,328,9,0,0,1,0,3,341
900842215,338,11,1,1,0,0,12,363
900842216,307,11,2,3,1,0,8,332
900842217,351,2,3,3,0,0,1,360
900842218,157,0,0,1,0,0,3,161
900842219,317,8,0,1,0,0,2,328
900842220,308,14,0,4,0,0,1,327
900842221,297,7,1,0,0,2,5,312
900842222,116,4,0,0,0,0,2,122
900842223,214,5,1,3,0,1,5,229
900842301,202,19,10,0,3,3,4,241
900842302,162,15,5,1,6,0,14,203
900842303,142,16,6,2,3,0,3,172
900842304,269,26,5,1,4,0,16,321
900842305,271,20,6,2,5,0,7,311
900842306,326,33,2,13,3,0,8,385
900842307,206,14,2,3,4,1,5,235
900842308,222,16,3,8,2,1,16,268
900842309,293,24,7,2,3,0,16,345
900842310,277,13,0,1,4,4,10,309
900842311,281,18,1,1,1,1,16,319
900842312,249,18,3,2,4,1,5,282
900842313,169,4,3,1,0,0,4,181
900842314,173,5,4,0,1,0,2,185
900842401,209,15,4,1,1,1,10,241
900842402,251,9,0,1,2,0,8,271
900842403,301,13,2,4,4,0,12,336
900842404,305,7,17,4,1,4,9,347
900842405,191,24,1,3,0,0,1,220
900842406,309,10,4,3,3,5,13,347
900842407,143,18,2,2,1,1,13,180
900842408,349,13,0,0,0,0,5,367
900842409,300,21,7,3,1,0,7,339
900842410,294,19,17,1,1,0,10,342
900842411,184,10,0,0,0,0,13,207
900842412,246,10,1,2,0,1,2,262
900842413,236,35,13,1,2,0,26,313
900842414,224,8,8,5,3,0,21,269
900842415,421,6,0,0,1,0,5,433
900842416,423,9,3,3,0,0,7,445
900842417,190,2,1,1,0,0,2,196
900842418,265,11,0,2,0,0,2,280
900842419,177,6,0,0,0,0,6,189
900842420,238,9,18,3,1,1,4,274
900842501,370,5,0,0,0,0,0,375
900842502,156,3,0,1,0,0,2,162
900842503,303,13,2,0,0,0,1,319
900842504,265,9,0,0,1,0,6,281
900842505,347,19,6,0,6,0,5,383
900842506,142,3,1,5,4,0,2,157
900842507,364,7,0,0,0,0,8,379
900842508,308,11,1,0,0,0,6,326
900842509,241,19,2,0,6,1,6,275
900842510,245,13,1,4,1,2,3,269
900842511,405,4,0,2,0,0,10,421
900842512,309,12,0,3,3,0,7,334
900842513,357,23,8,4,3,1,11,407
900842514,284,10,3,4,0,0,8,309
900842515,224,10,3,1,1,0,1,240
900842516,187,6,0,0,0,0,3,196
900842517,216,3,3,1,0,0,2,225
900842518,216,4,3,1,1,1,5,231
900842519,241,5,1,1,2,0,1,251
900842601,324,16,0,2,0,0,7,349
900842602,187,4,1,0,0,0,1,193
900842603,181,9,0,0,1,0,1,192
900842604,292,6,0,1,0,0,24,323
900842605,287,0,0,0,1,0,4,292
900842606,252,23,7,1,2,2,4,291
900842607,271,11,8,13,0,3,3,309
900842608,238,17,26,0,1,11,2,295
900842609,188,17,5,0,0,2,3,215
900842610,210,2,0,0,1,0,7,220
900842611,222,2,0,1,0,2,12,239
900842612,188,1,0,0,0,0,2,191
900842613,166,1,0,0,0,0,7,174
900842614,300,20,2,5,1,0,5,333
900842615,370,21,1,7,0,0,3,402
900842616,284,12,0,0,1,0,1,298
900842701,241,4,2,0,2,0,12,261
900842702,375,8,0,5,1,0,14,403
900842703,236,10,2,11,2,0,23,284
900842704,274,7,3,7,3,1,17,312
900842705,301,4,4,4,1,0,21,335
900842706,348,5,0,1,0,0,10,364
900842707,341,12,0,0,0,0,0,353
900842708,283,5,1,2,1,0,3,295
900842709,345,6,0,2,0,0,7,360
900842710,320,4,0,0,1,0,7,332
900842711,247,1,0,0,0,0,1,249
900842712,187,1,7,0,0,0,1,196
900842713,240,11,7,2,0,0,9,269
900842714,364,14,8,0,1,0,21,408
900842801,403,13,1,8,1,0,11,437
900842802,283,17,6,7,3,1,9,326
900842803,412,14,0,8,2,0,12,448
900842804,248,23,2,6,0,0,20,299
900842805,285,6,1,2,0,0,5,299
900842806,261,8,1,0,0,0,10,280
900842807,238,11,4,4,0,1,8,266
900842808,242,12,0,15,0,0,26,295
900842809,225,6,0,0,0,0,6,237
900842810,227,8,2,5,7,0,8,257
900842811,295,11,3,3,2,0,4,318
900842812,341,19,1,2,0,0,4,367
900842813,241,8,3,7,0,0,5,264
900842814,186,0,1,5,1,1,8,202
900842815,324,12,3,3,1,0,5,348
900842816,277,5,1,0,1,1,1,286
900842817,264,7,0,1,1,0,13,286
900842818,270,11,5,1,1,0,9,297
900842819,272,11,9,0,1,0,9,302
900842820,226,16,1,2,1,0,5,251
900842821,212,20,0,1,1,0,1,235
900842822,308,14,1,4,1,3,14,345
900842823,258,16,2,1,1,0,6,284
900842824,406,34,0,3,0,1,15,459
900842901,329,12,1,1,0,0,2,345
900842902,350,7,0,2,0,0,5,364
900842903,229,15,1,0,1,0,5,251
900842904,230,7,0,1,0,0,0,238
900842905,204,2,1,2,0,0,0,209
900842906,229,6,0,0,0,0,1,236
900842907,238,3,0,1,0,0,1,243
900842908,421,27,0,3,0,0,12,463
900842909,306,8,0,0,0,0,6,320
900842910,226,2,0,1,0,0,1,230
900842911,336,7,2,4,0,1,8,358
900842912,180,3,0,0,0,0,1,184
900842913,301,8,0,2,0,0,3,314
900842914,582,34,1,7,0,0,10,634
900842915,254,4,0,0,0,0,0,258
900842916,159,10,0,0,1,0,0,170
900843001,272,11,1,7,1,1,6,299
900843002,298,25,0,3,0,0,2,328
900843003,323,10,4,11,1,0,13,362
900843004,217,2,1,0,0,0,6,226
900843005,221,19,0,0,0,2,10,252
900843006,198,13,1,0,2,0,7,221
900843007,283,1,0,2,0,0,3,289
900843008,239,7,1,1,0,0,3,251
900843009,282,5,2,1,0,0,6,296
900843010,250,2,0,1,0,0,5,258
900843011,334,19,1,2,3,0,4,363
900843012,353,17,1,11,0,0,19,401
900843013,377,17,0,6,4,2,5,411
900843014,276,9,0,3,1,1,10,300
900843015,426,20,0,0,2,0,2,450
900843016,328,24,2,56,0,0,16,426
900843017,190,6,8,2,0,0,3,209
900843018,447,17,0,9,0,0,6,479
900843019,112,4,1,0,1,0,2,120
900910101,392,26,3,28,2,2,7,460
900910102,342,12,0,9,0,1,6,370
900910103,349,20,2,5,1,2,13,392
900910104,366,20,3,3,2,2,20,416
900910105,278,16,4,15,0,2,12,327
900910106,239,16,3,4,0,2,7,271
900910201,156,6,0,0,0,1,12,175
900910202,82,5,0,2,0,2,3,94
900910203,133,12,0,10,0,1,5,161
900910204,211,7,0,14,0,0,8,240
900910205,110,5,0,1,0,3,19,138
900910206,88,8,0,0,0,0,10,106
900910207,165,14,0,2,0,3,11,195
900910208,151,16,0,7,0,0,16,190
900910209,125,1,0,2,0,0,27,155
900910301,76,6,0,0,0,0,2,84
900910302,165,3,0,4,1,2,4,179
900910303,138,15,0,2,0,0,10,165
900910304,164,2,0,0,0,0,3,169
900910305,149,1,0,0,0,1,2,153
900910306,155,2,0,1,0,4,12,174
900910307,99,6,0,0,0,0,8,113
900910308,45,3,0,0,0,0,4,52
900910401,39,1,0,0,0,0,2,42
900910402,96,8,0,1,0,0,5,110
900910403,83,1,0,0,0,0,1,85
900910404,76,10,1,0,0,3,4,94
900910405,113,11,0,3,1,0,13,141
900910406,47,3,0,2,0,1,8,61
900910501,154,8,0,5,0,0,7,174
900910502,109,17,0,2,0,0,9,137
900910503,120,12,1,2,0,0,5,140
900910504,35,3,0,0,0,0,5,43
900910601,25,1,0,1,0,0,2,29
900910602,131,0,1,1,0,1,19,153
900910603,70,7,0,0,0,0,0,77
900910604,42,8,0,0,0,0,0,50
900910605,25,0,0,0,0,0,0,25
900910606,30,5,0,0,0,0,7,42
900910607,115,19,0,1,1,0,9,145
900910701,194,11,0,0,0,0,3,208
900910702,171,26,0,1,0,0,2,200
900910703,56,1,0,0,0,0,2,59
900910704,77,0,0,0,1,0,0,78
900910801,33,3,0,0,0,0,3,39
900910802,23,3,0,0,0,1,7,34
900910803,45,0,0,0,0,0,4,49
900910804,94,5,0,0,0,0,14,113
900910805,54,0,0,1,0,1,11,67
900910806,47,6,0,2,0,0,0,55
900910807,17,5,0,0,0,0,0,22
900910808,127,12,0,1,0,0,11,151
900910809,216,10,0,2,1,0,35,264
900910901,59,3,0,0,0,0,7,69
900910902,75,5,0,0,0,0,3,83
900910903,75,7,1,0,1,0,1,85
900910904,24,2,0,0,0,1,0,27
900911001,67,1,0,0,0,0,2,70
900911002,45,2,0,0,0,0,1,48
900911003,116,4,0,1,0,0,16,137
900911004,34,10,0,0,0,0,0,44
900911101,53,0,0,2,0,1,6,62
900911102,25,15,0,0,0,0,2,42
900911103,53,4,0,0,0,0,2,59
900911104,54,2,0,0,0,0,5,61
900911201,101,9,2,2,0,3,13,130
900911202,54,3,0,0,0,0,4,61
900911203,11,1,0,0,0,0,4,16
900980101,128,15,0,2,1,5,8,159
900980102,56,19,0,1,0,2,5,83
900980103,20,8,0,3,0,0,6,37
900980104,73,39,0,5,0,15,6,138
900980105,62,15,1,2,0,0,11,91
900980106,164,29,5,5,2,22,26,253
900980107,12,23,0,0,0,0,1,36
900980108,0,0,0,0,0,0,5,5
900980201,11,5,0,0,0,0,0,16
900980202,4,0,0,0,0,4,2,10
900980203,14,2,0,1,0,2,5,24
900980301,11,5,0,0,0,0,5,21
900980302,7,15,0,0,0,9,2,33
900980303,12,18,0,0,0,1,12,43
900980304,89,14,0,7,0,15,16,141
900980305,30,1,0,1,0,6,15,53
900980306,0,0,0,0,0,0,1,1
900980307,5,1,0,0,0,0,1,7
900980308,221,5,1,31,1,100,15,374
900980309,105,46,1,5,0,15,11,183
900980310,187,59,6,23,1,70,27,373
900980311,176,63,0,11,5,35,46,336
900980401,177,9,0,17,2,50,29,284
900980402,221,14,3,14,2,240,23,517
900980403,10,0,0,0,0,6,3,19
900980404,4,0,0,0,0,0,4,8
900980405,140,108,3,7,0,14,9,281
900980406,161,27,0,15,3,93,20,319
900980407,78,16,0,5,0,15,50,164
900980408,193,37,1,9,1,18,19,278
900980409,110,23,0,1,0,51,5,190
900980410,89,45,0,5,1,270,5,415
900980411,73,3,0,4,0,112,105,297
900980412,145,135,4,9,1,231,62,587
900980413,91,34,0,15,2,88,10,240
900980414,148,72,1,6,1,210,62,500
900980415,243,83,1,18,0,74,73,492
900980416,181,53,8,7,3,90,12,354
900980417,84,15,0,7,0,83,18,207
900980418,105,31,2,0,0,108,53,299
900980419,23,89,1,5,0,97,76,291
900980420,130,19,1,11,1,129,67,358
901050101,22,1,0,0,0,3,0,26
901050102,18,1,0,0,0,1,1,21
901050103,31,1,0,2,0,1,7,42
901050104,13,0,0,0,0,0,0,13
901050201,30,3,0,1,0,0,3,37
901050202,11,0,0,0,0,0,1,12
901050203,34,15,0,2,0,45,5,101
901050204,144,0,0,24,0,256,10,434
901050205,177,10,1,5,1,44,29,267
901050206,77,0,0,0,0,160,15,252
901050207,46,0,0,5,0,102,27,180
901050208,177,7,0,4,0,37,23,248
901050301,12,0,0,0,0,0,8,20
901050302,123,1,0,4,1,7,11,147
901050401,101,9,0,16,0,20,6,152
901050402,190,37,3,1,1,127,20,379
901050501,139,3,0,4,0,7,2,155
901050502,25,5,0,4,0,0,1,35
901050503,215,5,0,3,0,4,25,252
901050504,432,15,1,15,0,3,23,489
901050505,160,10,1,3,2,15,11,202
901050506,284,26,3,14,3,12,20,362
901050601,151,5,9,6,0,4,6,181
901050602,237,12,1,9,2,0,12,273
901050603,360,11,0,1,2,1,24,399
901050604,322,12,1,0,1,3,6,345
901050605,291,23,4,4,0,0,7,329
901050606,208,5,2,1,0,1,10,227
901050607,147,5,0,2,0,0,1,155
901050608,124,6,0,3,0,0,0,133
901050609,210,2,0,2,3,1,5,223
901050610,209,4,1,6,0,0,7,227
901050611,275,7,2,2,0,1,6,293
901050612,256,14,1,10,0,0,8,289
901050613,202,24,1,67,0,0,5,299
901050614,105,5,0,0,0,0,7,117
901050615,204,3,1,1,4,1,12,226
901050616,183,1,0,2,1,0,3,190
901050617,182,5,0,2,0,0,1,190
901050618,208,7,0,0,0,0,5,220
901050619,198,9,1,2,1,0,6,217
901050620,270,8,1,3,1,1,3,287
901050621,393,6,1,0,0,0,12,412
901050622,123,6,0,0,0,2,1,132
901050623,410,19,2,7,2,4,6,450
901050624,109,2,0,6,0,1,4,122
901050625,171,12,0,17,0,1,9,210
901050701,462,26,3,10,0,3,24,528
901050702,226,5,3,7,0,2,8,251
901050703,132,3,1,5,0,1,5,147
901050704,252,8,0,1,0,0,3,264
901050705,193,10,0,1,0,0,4,208
901050706,220,5,2,1,1,0,4,233
901050707,137,9,0,0,0,0,3,149
901050708,222,11,0,1,0,0,3,237
901050709,240,3,0,3,0,0,6,252
901050710,173,7,2,3,0,0,1,186
901050711,366,25,1,1,0,0,4,397
901050712,362,19,2,1,1,1,18,404
901050713,240,36,0,1,0,1,13,291
901050714,252,43,0,1,0,0,3,299
901050715,150,57,0,18,0,0,99,324
901050716,0,0,0,41,0,0,247,288
901050717,1,0,50,16,0,0,274,341
901050718,22,8,0,196,0,5,53,284
901050801,61,1,0,0,0,3,2,67
901050802,313,15,1,3,0,1,9,342
901050803,284,10,4,1,2,1,6,308
901050804,293,9,0,3,0,0,4,309
901050805,309,10,1,2,0,0,6,328
901050806,205,5,1,2,0,0,2,215
901050807,281,17,1,3,3,0,14,319
901050808,431,16,0,3,1,0,4,455
901050809,259,13,0,3,1,0,4,280
901050810,259,1,0,1,0,0,5,266
901050811,326,21,2,3,0,0,5,357
901050812,362,8,5,0,0,1,15,391
901050813,336,12,2,7,0,1,15,373
901050814,287,17,2,1,0,0,6,313
901050815,208,10,1,0,1,0,0,220
901050816,213,13,1,3,2,0,6,238
901050817,239,6,0,2,0,2,5,254
901050901,13,0,0,0,0,0,0,13
901050902,284,28,0,7,1,1,15,336
901050903,460,13,0,4,1,0,12,490
901050904,328,12,2,1,0,1,10,354
901050905,304,11,0,5,0,0,7,327
901050906,332,20,3,7,5,0,11,378
901050907,284,11,6,6,2,3,10,322
901050908,265,10,3,1,3,0,8,290
901050909,261,25,3,2,5,2,13,311
901050910,143,13,3,1,2,0,5,167
901050911,181,1,2,3,5,1,10,203
901050912,311,19,1,0,0,0,4,335
901050913,307,15,2,7,0,4,10,345
901050914,281,14,2,1,0,1,3,302
901050915,256,24,3,9,5,0,13,310
901050916,213,2,0,0,0,0,5,220
901050917,158,11,0,16,0,1,6,192
901051001,297,4,2,4,5,0,10,322
901051002,189,2,0,0,0,0,3,194
901051003,276,6,4,1,1,0,6,294
901051004,336,4,0,2,0,0,4,346
901051005,408,27,1,23,0,1,9,469
901051006,292,27,2,7,0,0,11,339
901051007,223,6,3,3,4,0,16,255
901051008,101,4,0,1,0,0,7,113
901051009,387,32,0,2,0,0,8,429
901051010,304,23,1,12,1,2,9,352
901051011,219,6,0,1,1,2,2,231
901051012,195,13,0,1,2,0,5,216
901051013,246,5,13,2,0,0,6,272
901051014,3,1,0,0,0,0,0,4
901051015,269,6,1,6,1,1,3,287
901051016,191,7,5,1,1,1,3,209
901051017,394,19,0,1,2,0,16,432
901051018,269,21,3,2,1,0,9,305
901051019,123,9,3,12,0,0,5,152
901051020,153,6,2,5,3,0,3,172
901051021,290,16,1,0,3,1,8,319
901051022,247,1,1,1,0,0,0,250
901051023,196,7,1,2,2,0,7,215
901051024,300,18,0,3,0,0,8,329
901120101,11,0,0,0,0,0,12,23
901120102,41,3,0,0,0,26,3,73
901120103,40,7,0,0,0,4,3,54
901120104,24,2,0,0,0,2,25,53
901120105,47,6,0,0,0,4,7,64
901120106,21,7,0,0,0,5,3,36
901120107,16,1,0,2,0,11,5,35
901120108,55,2,0,0,0,1,14,72
901120109,116,16,0,3,0,58,31,224
901120110,121,33,0,8,0,133,9,304
901120111,139,20,2,4,12,128,12,317
901120112,71,26,2,4,0,235,15,353
901120113,86,5,4,15,1,266,47,424
901120114,109,25,3,13,1,200,24,375
901120115,126,9,0,8,2,126,17,288
901120116,82,7,0,4,0,159,6,258
901120201,22,1,0,0,0,10,21,54
901120202,19,7,0,0,0,0,6,32
901120203,92,22,1,1,0,3,12,131
901120204,67,13,0,0,0,3,3,86
901120205,235,14,0,6,0,8,19,282
901120206,57,25,0,2,0,5,9,98
901120207,34,2,0,0,0,3,11,50
901120208,20,5,0,0,0,0,3,28
901120209,57,6,0,0,0,2,3,68
901120210,309,95,1,33,2,4,32,476
901120211,5,0,0,0,0,0,7,12
901120212,23,6,0,0,0,1,8,38
901120213,381,28,1,3,1,7,10,431
901120214,290,12,0,0,1,7,12,322
901120215,145,11,0,5,0,1,5,167
901120216,256,13,2,4,0,2,3,280
901120301,62,3,0,0,0,0,4,69
901120302,223,6,0,1,0,22,39,291
901120303,112,13,0,6,0,9,18,158
901120304,28,6,0,1,0,0,2,37
901120305,37,3,0,0,0,2,14,56
901120306,36,0,0,1,0,2,1,40
901120307,146,5,1,8,0,9,22,191
901120308,112,9,0,3,1,6,7,138
901120401,21,8,0,1,0,2,2,34
901120402,41,0,0,0,1,2,0,44
901120403,82,5,1,0,0,3,4,95
901120404,187,11,0,3,0,25,2,228
901190101,14,0,0,0,0,0,0,14
901190102,4,1,0,0,0,0,25,30
901190103,44,0,2,0,0,23,11,80
901190201,273,10,0,3,0,0,1,287
901190202,193,2,0,1,0,1,8,205
901190203,201,0,2,11,1,1,13,229
901190204,318,14,1,0,0,2,14,349
901190205,214,3,0,4,1,1,3,226
901190206,349,7,5,12,3,2,22,400
901190207,149,7,0,1,0,0,1,158
901190208,224,5,3,2,2,0,0,236
901190209,221,11,0,1,1,0,2,236
901190210,192,32,1,0,0,0,5,230
901190211,302,23,2,8,0,1,10,346
901190212,139,11,1,1,7,0,3,162
901190213,229,5,1,5,1,0,4,245
901190214,170,25,2,2,0,1,4,204
901190215,254,18,2,5,0,4,2,285
901190216,211,16,1,0,1,0,2,231
901190217,234,14,1,3,0,0,12,264
901190301,1,0,0,0,0,0,0,1
901190302,188,31,9,9,1,12,16,266
901190303,147,17,0,13,0,2,7,186
901190304,225,5,1,2,0,0,2,235
901190305,167,14,0,3,1,4,8,197
901190306,239,10,1,0,0,3,4,257
901190307,259,14,5,2,2,1,6,289
901190308,186,19,3,2,0,2,1,213
901190309,217,9,2,8,5,1,7,249
901190310,190,17,0,3,3,1,6,220
901190311,160,5,1,0,0,1,5,172
901190312,170,23,5,2,0,3,3,206
901190313,339,21,10,5,5,4,15,399
901190314,228,24,8,14,1,41,19,335
901190315,232,3,4,19,0,1,14,273
901190316,192,14,0,1,0,0,7,214
901190317,378,26,5,2,4,1,11,427
901190318,176,2,0,1,0,3,10,192
901190319,267,23,3,9,0,0,7,309
901190401,190,14,0,4,0,0,1,209
901190402,246,5,0,0,0,1,8,260
901190403,269,3,0,0,0,1,3,276
901190404,299,9,2,9,7,1,12,339
901190405,255,20,2,1,0,1,1,280
901190406,350,22,0,2,1,3,5,383
901190407,366,15,1,3,1,0,7,393
901190408,296,8,1,4,0,0,0,309
901190409,394,8,6,19,0,4,8,439
901190410,238,30,0,1,0,0,7,276
901190411,245,12,0,1,0,1,9,268
901190412,187,15,3,4,1,2,4,216
901190413,208,20,2,1,0,0,1,232
901190414,209,15,2,3,2,1,2,234
901190415,133,3,0,2,1,1,5,145
901190416,119,3,0,5,0,1,1,129
901190417,283,14,4,5,7,2,7,322
901190418,192,14,0,8,0,0,12,226
901190419,330,38,12,2,4,0,14,400
901190420,244,22,5,4,1,1,5,282
901190421,176,23,5,2,19,0,11,236
901190501,3,0,0,0,0,0,0,3
901190502,220,7,2,2,1,0,1,233
901190503,217,9,1,0,0,2,4,233
901190504,218,31,3,4,7,4,4,271
901190505,213,14,2,1,1,0,11,242
901190506,162,23,9,1,1,0,10,206
901190507,371,30,3,3,4,0,9,420
901190508,343,13,2,10,2,6,6,382
901190509,307,14,5,14,0,1,9,350
901190510,249,24,19,10,0,0,6,308
901190511,173,10,2,9,0,0,4,198
901190512,348,15,8,82,4,2,11,470
901190513,375,28,7,32,3,2,16,463
901190514,289,22,2,7,0,0,8,328
901190515,278,33,4,1,0,0,9,325
901190516,280,27,13,9,0,3,16,348
940070101,7,4,0,0,0,0,0,11
940070201,12,3,0,0,0,0,0,15
940070301,15,4,0,0,0,0,1,20
940070401,10,2,0,0,0,5,0,17
940070501,8,0,0,0,0,0,0,8
940070502,137,31,11,6,5,15,17,222
940070503,280,34,21,37,1,124,13,510
940070504,213,26,3,5,2,17,7,273
940070505,175,51,4,30,0,88,34,382
940070601,29,0,1,0,0,0,2,32
940070701,27,0,0,0,0,0,0,27
940070801,9,2,0,0,0,5,0,16
940071001,296,25,0,12,3,0,6,342
940071002,110,12,0,11,0,0,2,135
940071003,303,13,3,4,0,1,4,328
940071004,285,11,1,0,3,0,6,306
940071005,285,16,0,1,3,0,1,306
940071006,319,10,2,2,0,0,7,340
940071007,327,4,0,1,0,0,5,337
940071008,270,7,7,0,4,4,10,302
940071009,286,19,2,0,0,0,2,309
940071010,283,14,3,18,0,0,3,321
940071011,319,8,1,4,2,0,9,343
940071012,270,5,1,2,0,0,3,281
940071013,273,18,1,1,2,1,4,300
940071101,294,29,10,2,3,0,4,342
940071102,295,18,2,0,3,0,8,326
940071103,334,28,3,6,0,0,9,380
940071104,440,31,9,27,4,1,11,523
940071105,284,28,3,3,2,0,7,327
940071106,226,30,8,2,5,1,12,284
940071107,208,21,24,8,15,11,18,305
940071108,161,10,4,1,8,0,6,190
940071109,244,12,3,2,11,0,3,275
940071110,195,13,0,0,1,0,12,221
940071111,303,14,0,3,0,0,2,322
940071112,320,19,7,1,2,0,12,361
940071113,318,17,2,5,2,0,6,350
940071201,196,26,1,4,6,0,7,240
940071202,266,24,4,2,6,0,12,314
940071203,175,19,3,1,1,2,2,203
940071204,300,9,1,6,1,0,20,337
940071205,332,2,0,0,1,0,7,342
940071206,322,14,1,2,0,0,1,340
940071207,286,15,0,3,0,0,0,304
940071208,302,8,2,3,0,0,5,320
940071209,284,26,8,11,0,1,4,334
940071210,294,25,9,2,6,0,14,350
940071211,226,22,2,0,2,0,10,262
940071212,305,25,4,6,4,0,22,366
940071213,298,30,2,1,4,0,13,348
940071301,298,2,2,3,0,0,9,314
940071302,335,11,1,6,3,1,17,374
940071303,326,22,4,5,0,1,6,364
940071304,298,17,2,7,2,0,11,337
940071305,262,67,9,21,0,0,10,369
940071306,106,51,0,59,0,0,2,218
940071307,321,35,4,37,0,0,8,405
940071308,241,45,2,54,0,1,4,347
940071309,243,32,6,1,0,0,71,353
940071310,162,2,0,3,0,0,4,171
940071311,307,19,5,8,1,0,5,345
940071312,246,18,1,8,1,1,2,277
940071313,304,19,3,1,1,0,9,337
940071314,194,12,7,6,0,0,11,230
940071401,293,20,2,2,1,0,9,327
940071402,348,8,6,6,1,0,15,384
940071403,330,5,3,6,3,0,13,360
940071404,266,20,1,15,0,0,15,317
940071405,288,5,5,9,0,0,38,345
940071406,254,11,3,1,2,0,16,287
940071407,338,25,1,5,6,2,10,387
940071408,308,19,3,2,1,0,8,341
940071409,315,11,2,1,2,1,5,337
940071410,273,7,1,0,1,0,6,288
940071411,248,16,4,2,0,0,4,274
940071412,329,39,2,69,1,18,40,498
940071413,232,60,1,21,2,3,15,334
940071414,276,15,0,0,1,0,14,306
940071415,198,11,0,2,1,0,7,219
940071416,95,3,0,1,0,0,5,104
940140101,5,0,0,0,0,0,0,5
940140102,45,15,0,1,0,1,19,81
940140103,39,53,3,8,0,12,7,122
940140201,0,1,0,0,0,0,0,1
940140202,5,0,0,0,0,0,1,6
940140301,1,0,0,0,0,0,0,1
940140302,13,3,0,0,0,0,1,17
940140401,136,12,0,9,1,2,0,160
940140402,240,33,0,10,0,3,8,294
940140403,134,19,2,2,0,0,5,162
940140404,100,13,0,5,0,0,1,119
940140405,147,8,0,3,1,0,8,167
940140406,206,27,4,4,4,1,4,250
940140407,275,29,3,17,2,0,5,331
940140408,120,17,0,2,0,0,5,144
940140409,309,12,1,0,0,0,14,336
940140410,219,27,6,9,0,0,3,264
940140411,250,8,9,0,0,0,2,269
940140412,266,34,1,3,0,0,2,306
940140413,308,22,5,10,1,0,2,348
940140414,335,24,6,7,0,0,4,376
940140415,284,27,5,2,1,0,7,326
940140416,308,30,2,0,0,0,6,346
940140501,213,13,3,13,1,0,5,248
940140502,285,38,14,3,3,1,12,356
940140503,292,37,3,0,1,1,5,339
940140504,99,15,2,2,35,1,8,162
940140505,256,45,20,6,72,5,31,435
940140506,154,52,12,4,99,2,6,329
940140507,177,15,12,4,26,6,9,249
940140508,270,28,5,4,3,0,6,316
940140509,383,52,3,1,0,0,20,459
940140510,238,23,3,7,1,0,8,280
940140511,206,13,0,2,0,0,7,228
940140601,200,4,1,6,0,0,4,215
940140602,365,1,4,3,5,1,1,380
940140603,296,6,2,5,1,0,4,314
940140604,274,16,5,0,0,0,16,311
940140605,352,27,14,3,11,4,14,425
940140606,280,29,8,3,4,0,5,329
940140607,287,20,1,1,4,0,11,324
940140608,262,12,3,0,1,1,6,285
940140609,322,15,1,0,0,0,8,346
940140610,332,40,10,4,0,0,12,398
940140611,341,28,0,3,0,1,8,381
940140612,297,21,0,2,0,0,0,320
940140701,170,14,1,8,2,0,3,198
940140702,265,16,2,7,1,2,16,309
940140703,290,32,8,8,2,0,9,349
940140704,266,20,1,3,0,1,6,297
940140705,304,21,5,3,0,0,4,337
940140706,132,27,0,16,1,2,1,179
940140707,308,29,0,135,1,0,1,474
940140708,237,17,5,2,2,0,1,264
940140709,121,10,0,0,0,0,1,132
940140710,107,7,0,0,0,0,0,114
940140711,362,27,7,7,1,1,14,419
940140712,331,31,7,3,1,0,9,382
940140713,293,22,6,2,0,1,6,330
940140714,379,36,2,3,1,0,3,424
940140801,68,5,2,0,0,4,1,80
940140802,201,22,9,1,18,1,15,267
940140803,87,13,0,1,6,0,6,113
940140804,216,14,1,0,1,0,16,248
940140805,268,36,9,3,12,2,9,339
940140806,354,39,9,5,4,0,2,413
940140807,258,18,18,10,28,0,16,348
940140808,360,21,2,2,1,0,14,400
940140809,245,21,6,9,3,0,11,295
940140810,437,32,8,8,3,1,11,500
940140811,300,18,2,1,0,0,3,324
940140812,287,19,0,1,1,0,4,312
940140813,319,21,1,2,0,0,4,347
940210101,0,0,0,0,0,0,0,0
940280101,8,0,0,0,0,0,0,8
